,max_credit,gender,education,marital_status,age,pay_status_sep,pay_status_aug,pay_status_jul,pay_status_jun,pay_status_may,pay_status_apr,bill_sep,bill_aug,bill_jul,bill_jun,bill_may,bill_apr,payment_sep,payment_aug,payments_jul,payment_jun,payment_may,payment_apr,married,carry_sep,carry_aug,carry_jul,carry_jun,carry_may,carry_apr,carry_ratio_sep,carry_ratio_aug,carry_ratio_jul,carry_ratio_jun,carry_ration_may,carry_ratio_apr,pay_status_sum
0,180000,1,2,1,44,0,0,0,0,0,0,161186,167080,170788,174764,162667,166953,10000,8000,7000,6000,7000,10000,1,151186,159080,163788,168764,155667,156953,0.8399222222222222,0.8837777777777778,0.9099333333333334,0.9375777777777777,0.8648166666666667,0.8719611111111111,0
1,130000,1,2,1,48,-2,-2,-2,-2,-2,-2,0,1240,1487,1279,749,440,1240,1487,1279,749,440,849,1,-1240,-247,208,530,309,-409,-0.009538461538461539,-0.0019,0.0016,0.004076923076923077,0.002376923076923077,-0.0031461538461538463,-12
2,60000,1,1,1,43,-1,3,2,0,0,-1,495,330,495,330,165,340,0,330,0,0,340,0,1,495,0,495,330,-175,340,0.00825,0.0,0.00825,0.0055,-0.002916666666666667,0.005666666666666667,3
3,240000,0,1,1,42,0,0,0,0,0,0,72339,91045,91027,51508,51127,0,20000,2213,1030,1023,6790,10893,1,52339,88832,89997,50485,44337,-10893,0.21807916666666666,0.3701333333333333,0.3749875,0.21035416666666668,0.1847375,-0.0453875,0
4,100000,1,2,1,28,2,0,0,0,0,2,73073,74739,70844,63924,57326,59654,3500,3003,1910,2400,3300,0,1,69573,71736,68934,61524,54026,59654,0.69573,0.71736,0.68934,0.61524,0.54026,0.59654,4
5,20000,1,1,2,24,2,-1,2,0,0,0,1015,19214,15703,9914,8200,11876,19214,0,1000,0,5000,5400,0,-18199,19214,14703,9914,3200,6476,-0.90995,0.9607,0.73515,0.4957,0.16,0.3238,3
6,60000,1,2,1,50,0,0,0,0,0,0,33290,32867,32638,29743,26909,24955,1558,1571,1344,877,875,3000,1,31732,31296,31294,28866,26034,21955,0.5288666666666667,0.5216,0.5215666666666666,0.4811,0.4339,0.36591666666666667,0
7,200000,1,2,2,32,-1,-1,2,-1,0,-1,2261,298,298,13764,5290,924,298,0,13764,0,924,6635,0,1963,298,-13466,13764,4366,-5711,0.009815,0.00149,-0.06733,0.06882,0.02183,-0.028555,-2
8,110000,0,2,1,30,0,0,-1,2,2,2,26000,9000,63853,59308,60576,42784,1500,63853,1500,2062,0,7222,1,24500,-54853,62353,57246,60576,35562,0.22272727272727272,-0.49866363636363636,0.5668454545454545,0.5204181818181818,0.5506909090909091,0.3232909090909091,5
9,150000,1,3,2,43,-2,-2,-2,-2,-2,-2,1622,12946,0,0,1761,18304,13016,0,0,1761,18306,4275,0,-11394,12946,0,-1761,-16545,14029,-0.07596,0.08630666666666667,0.0,-0.01174,-0.1103,0.09352666666666666,-12
10,400000,1,1,1,37,-2,-1,0,0,0,0,-151,27952,47213,121013,87332,106519,78130,20000,93000,30000,20000,12014,1,-78281,7952,-45787,91013,67332,94505,-0.1957025,0.01988,-0.1144675,0.2275325,0.16833,0.2362625,-3
11,220000,1,4,1,35,-1,-1,-1,-1,-1,-1,1849,326,12681,84674,35326,1026,326,12681,84674,35326,1026,3088,1,1523,-12355,-71993,49348,34300,-2062,0.006922727272727273,-0.05615909090909091,-0.3272409090909091,0.2243090909090909,0.1559090909090909,-0.009372727272727272,-6
12,180000,1,1,2,30,3,2,-1,0,0,0,1782,192,1291,1891,3914,26414,0,1291,600,2023,22500,32800,0,1782,-1099,691,-132,-18586,-6386,0.0099,-0.006105555555555556,0.003838888888888889,-0.0007333333333333333,-0.10325555555555556,-0.035477777777777775,4
13,20000,0,2,2,44,1,2,2,2,0,0,18330,17743,20346,19597,19086,16755,0,3208,0,600,453,138,0,18330,14535,20346,18997,18633,16617,0.9165,0.72675,1.0173,0.94985,0.93165,0.83085,7
14,180000,0,2,2,30,-1,-1,-1,-1,-1,-1,10000,10000,10970,12786,10300,10000,10000,10970,12786,10300,10000,11080,0,0,-970,-1816,2486,300,-1080,0.0,-0.005388888888888889,-0.010088888888888889,0.01381111111111111,0.0016666666666666668,-0.006,-6
15,320000,0,1,2,34,0,0,0,0,0,0,71944,88243,96574,104795,113156,121465,19246,11550,11688,12122,12156,2437,0,52698,76693,84886,92673,101000,119028,0.16468125,0.239665625,0.26526875,0.289603125,0.315625,0.3719625,0
16,50000,0,1,2,38,0,0,0,0,0,0,27148,27619,20997,21018,20556,20302,1655,1323,734,1058,406,0,0,25493,26296,20263,19960,20150,20302,0.50986,0.52592,0.40526,0.3992,0.403,0.40604,0
17,80000,1,2,1,53,0,0,0,0,0,0,37242,37634,38281,38993,39268,39620,2000,2000,2000,2000,1408,1300,1,35242,35634,36281,36993,37860,38320,0.440525,0.445425,0.4535125,0.4624125,0.47325,0.479,0
18,250000,1,2,1,29,0,0,0,0,0,0,180056,179349,30349,29568,30188,30786,4077,1500,1917,1097,1101,1139,1,175979,177849,28432,28471,29087,29647,0.703916,0.711396,0.113728,0.113884,0.116348,0.118588,0
19,180000,1,1,1,35,0,0,0,0,0,0,68488,47603,48705,50140,60607,67976,3603,5705,3003,10607,7976,5412,1,64885,41898,45702,39533,52631,62564,0.36047222222222225,0.23276666666666668,0.2539,0.21962777777777778,0.29239444444444446,0.34757777777777776,0
20,50000,1,3,2,23,0,0,0,0,0,2,17976,18254,16428,16986,18579,17317,1564,1589,2000,3000,0,3000,0,16412,16665,14428,13986,18579,14317,0.32824,0.3333,0.28856,0.27972,0.37158,0.28634,2
21,150000,1,2,1,34,-2,-2,-2,-2,-2,-2,0,0,0,116,0,1500,0,0,116,0,1500,0,1,0,0,-116,116,-1500,1500,0.0,0.0,-0.0007733333333333333,0.0007733333333333333,-0.01,0.01,-12
22,360000,1,2,1,51,-1,-1,-1,-1,-1,-1,19155,1473,1430,18697,659,781,1473,1430,18740,659,781,1557,1,17682,43,-17310,18038,-122,-776,0.04911666666666667,0.00011944444444444444,-0.04808333333333333,0.050105555555555556,-0.0003388888888888889,-0.0021555555555555555,-6
23,80000,1,2,2,23,0,0,0,0,0,0,80998,63184,58346,56361,55933,56936,4500,1973,3000,5000,2100,3200,0,76498,61211,55346,51361,53833,53736,0.956225,0.7651375,0.691825,0.6420125,0.6729125,0.6717,0
24,240000,1,2,2,26,0,0,-1,-1,-1,-1,14348,7500,7816,7500,7500,14497,1000,7816,7500,7500,14497,500,0,13348,-316,316,0,-6997,13997,0.05561666666666667,-0.0013166666666666667,0.0013166666666666667,0.0,-0.029154166666666665,0.058320833333333336,-4
25,50000,0,2,2,24,1,2,0,0,-1,-1,5784,3392,2182,0,2092,-2272,0,1000,0,2092,0,0,0,5784,2392,2182,-2092,2092,-2272,0.11568,0.04784,0.04364,-0.04184,0.04184,-0.04544,1
26,110000,1,2,1,35,0,0,0,0,0,0,81665,46070,34419,36829,38080,40434,2460,2000,3000,2000,3000,5000,1,79205,44070,31419,34829,35080,35434,0.7200454545454545,0.4006363636363636,0.28562727272727273,0.3166272727272727,0.3189090909090909,0.3221272727272727,0
27,20000,0,2,2,26,2,0,0,0,2,2,6078,7015,8036,9597,9294,10242,1200,1140,1700,0,1100,0,0,4878,5875,6336,9597,8194,10242,0.2439,0.29375,0.3168,0.47985,0.4097,0.5121,6
28,450000,0,1,3,37,-2,-2,-2,-2,-2,-2,324,302,5018,317,1614,324,303,5041,1,1622,325,316,0,21,-4739,5017,-1305,1289,8,4.6666666666666665e-05,-0.010531111111111111,0.011148888888888889,-0.0029,0.0028644444444444446,1.7777777777777777e-05,-12
29,130000,1,2,2,26,0,0,0,0,0,0,84133,84458,62441,48175,29874,15525,2758,2741,2175,1874,1525,0,0,81375,81717,60266,46301,28349,15525,0.6259615384615385,0.6285923076923077,0.4635846153846154,0.3561615384615385,0.21806923076923077,0.11942307692307692,0
30,290000,1,2,2,34,0,0,0,0,0,0,305781,310403,315048,314085,317631,315820,12012,12012,12012,11016,11088,12031,0,293769,298391,303036,303069,306543,303789,1.012996551724138,1.0289344827586206,1.0449517241379311,1.0450655172413794,1.057044827586207,1.047548275862069,0
31,400000,1,2,2,27,-1,-1,-1,0,-1,-1,20030,3497,6725,6016,8985,14705,3513,6742,1435,9030,14778,25730,0,16517,-3245,5290,-3014,-5793,-11025,0.0412925,-0.0081125,0.013225,-0.007535,-0.0144825,-0.0275625,-5
32,160000,1,2,2,29,0,0,0,0,0,0,36370,35996,35275,34873,35677,34942,4002,5390,6000,5000,5000,4000,0,32368,30606,29275,29873,30677,30942,0.2023,0.1912875,0.18296875,0.18670625,0.19173125,0.1933875,0
33,480000,1,2,2,31,-1,-1,-1,-1,-1,-1,1759,1759,1759,1759,1759,1759,1759,1759,1759,1759,1759,1759,0,0,0,0,0,0,0,0.0,0.0,0.0,0.0,0.0,0.0,-6
34,60000,1,2,2,24,1,-1,3,2,0,-1,0,948,948,632,316,316,948,0,0,0,316,782,0,-948,948,948,632,0,-466,-0.0158,0.0158,0.0158,0.010533333333333334,0.0,-0.0077666666666666665,4
35,50000,1,2,1,32,0,0,0,0,0,0,49547,49740,50275,20089,19964,19918,2100,2097,1289,712,713,1000,1,47447,47643,48986,19377,19251,18918,0.94894,0.95286,0.97972,0.38754,0.38502,0.37836,0
36,70000,1,2,1,24,0,0,0,0,0,-1,33602,41574,30777,30155,14298,1579,10096,3000,1005,2000,1579,2882,1,23506,38574,29772,28155,12719,-1303,0.3358,0.5510571428571429,0.4253142857142857,0.4022142857142857,0.1817,-0.018614285714285715,-1
37,20000,1,2,2,24,-1,-1,-1,2,0,0,396,1301,12056,11151,11219,18120,1301,11151,0,600,8120,1500,0,-905,-9850,12056,10551,3099,16620,-0.04525,-0.4925,0.6028,0.52755,0.15495,0.831,-1
38,50000,1,3,2,22,2,2,2,0,0,0,24729,22719,18408,19330,19561,19815,1651,0,1573,804,675,738,0,23078,22719,16835,18526,18886,19077,0.46156,0.45438,0.3367,0.37052,0.37772,0.38154,6
39,280000,1,3,1,46,0,0,0,0,0,0,100858,107768,111858,83428,73908,81908,7768,5000,10000,0,8000,0,1,93090,102768,101858,83428,65908,81908,0.3324642857142857,0.3670285714285714,0.36377857142857145,0.29795714285714286,0.23538571428571428,0.2925285714285714,0
40,20000,1,2,2,25,2,2,2,2,0,0,17496,16923,20319,19543,19534,19320,0,4000,0,391,386,249,0,17496,12923,20319,19152,19148,19071,0.8748,0.64615,1.01595,0.9576,0.9574,0.95355,8
41,220000,1,2,2,29,2,0,0,0,0,0,28992,36106,33494,29518,29569,28587,8000,3000,3000,6000,5000,1136,0,20992,33106,30494,23518,24569,27451,0.09541818181818182,0.1504818181818182,0.1386090909090909,0.1069,0.11167727272727272,0.12477727272727272,2
42,340000,0,2,1,31,0,0,0,0,0,0,63098,64417,65752,69639,80057,83713,2338,2406,5000,11610,5000,2971,1,60760,62011,60752,58029,75057,80742,0.1787058823529412,0.18238529411764706,0.17868235294117646,0.1706735294117647,0.22075588235294116,0.2374764705882353,0
43,280000,0,1,1,44,-2,-1,-1,-1,-1,0,593,1763,53669,4707,22014,3415,1777,53934,4726,22102,12,1301,1,-1184,-52171,48943,-17395,22002,2114,-0.004228571428571429,-0.186325,0.17479642857142857,-0.062125,0.07857857142857143,0.00755,-6
44,50000,0,2,2,34,0,0,2,0,0,0,46413,50056,49072,49724,19801,14301,4729,86,2198,1198,600,1000,0,41684,49970,46874,48526,19201,13301,0.83368,0.9994,0.93748,0.97052,0.38402,0.26602,2
45,20000,1,1,2,23,0,0,0,0,0,0,14605,14532,15700,16346,16837,18298,2000,2000,1000,1000,2000,2000,0,12605,12532,14700,15346,14837,16298,0.63025,0.6266,0.735,0.7673,0.74185,0.8149,0
46,390000,0,1,2,37,-2,-2,-2,-2,-2,-2,73,10925,0,0,0,0,10952,0,0,0,0,0,0,-10879,10925,0,0,0,0,-0.027894871794871795,0.028012820512820513,0.0,0.0,0.0,0.0,-12
47,20000,1,1,2,24,-1,-1,-1,-1,-1,-1,3305,2296,14059,9140,1073,500,2296,14777,9140,1073,500,0,0,1009,-12481,4919,8067,573,500,0.05045,-0.62405,0.24595,0.40335,0.02865,0.025,-6
48,50000,0,3,1,59,0,0,-2,-2,-2,-2,51400,0,0,0,0,0,0,0,0,0,0,0,1,51400,0,0,0,0,0,1.028,0.0,0.0,0.0,0.0,0.0,-8
49,150000,1,2,2,24,0,0,0,0,0,0,143212,137963,139520,99814,100810,103233,5500,5500,4500,3500,4000,4000,0,137712,132463,135020,96314,96810,99233,0.91808,0.8830866666666667,0.9001333333333333,0.6420933333333333,0.6454,0.6615533333333333,0
50,200000,0,1,2,27,-1,-1,-1,0,0,-1,630,825,1890,1260,630,630,825,1890,0,0,630,1030,0,-195,-1065,1890,1260,0,-400,-0.000975,-0.005325,0.00945,0.0063,0.0,-0.002,-4
51,90000,0,3,1,31,0,0,0,0,0,0,68476,68485,67000,45837,49959,52981,4017,4000,4000,5000,4000,4000,1,64459,64485,63000,40837,45959,48981,0.7162111111111111,0.7165,0.7,0.45374444444444445,0.5106555555555555,0.5442333333333333,0
52,40000,1,3,1,34,0,0,0,0,0,2,32052,34697,36824,38764,36411,31931,3500,3000,3000,3029,1000,2000,1,28552,31697,33824,35735,35411,29931,0.7138,0.792425,0.8456,0.893375,0.885275,0.748275,2
53,100000,1,1,2,24,0,0,0,0,0,0,76025,68016,63520,64825,65725,67183,3000,3600,3000,2500,2600,3000,0,73025,64416,60520,62325,63125,64183,0.73025,0.64416,0.6052,0.62325,0.63125,0.64183,0
54,100000,1,2,1,29,-2,-2,-2,-2,-2,-2,0,0,0,0,0,0,0,0,0,0,0,0,1,0,0,0,0,0,0,0.0,0.0,0.0,0.0,0.0,0.0,-12
55,50000,1,1,2,23,-1,-1,-1,0,-1,-1,1300,628,4050,3050,1243,865,628,4050,0,1243,865,3000,0,672,-3422,4050,1807,378,-2135,0.01344,-0.06844,0.081,0.03614,0.00756,-0.0427,-5
56,100000,0,2,2,41,-1,-1,-2,-2,-2,-2,780,0,0,0,0,0,0,0,0,0,0,0,0,780,0,0,0,0,0,0.0078,0.0,0.0,0.0,0.0,0.0,-10
57,200000,1,1,1,54,-2,-2,-2,-2,-2,-2,0,0,0,0,0,0,0,0,0,0,0,0,1,0,0,0,0,0,0,0.0,0.0,0.0,0.0,0.0,0.0,-12
58,50000,1,2,1,32,1,2,2,2,0,0,51132,49594,50292,48532,27308,27539,0,4800,0,1200,1200,1400,1,51132,44794,50292,47332,26108,26139,1.02264,0.89588,1.00584,0.94664,0.52216,0.52278,7
59,220000,1,2,2,32,-1,-1,-1,-1,-1,-1,18477,16341,11125,10000,10000,10000,16370,11125,10000,10000,10000,301,0,2107,5216,1125,0,0,9699,0.009577272727272728,0.02370909090909091,0.005113636363636364,0.0,0.0,0.04408636363636364,-6
60,240000,1,3,2,35,-1,-1,-2,-2,-2,-2,4215,0,0,0,0,0,0,0,0,0,0,0,0,4215,0,0,0,0,0,0.0175625,0.0,0.0,0.0,0.0,0.0,-10
61,500000,0,1,2,35,-2,-2,-2,-2,-2,-2,5925,11175,21176,5086,9552,14389,11194,21193,5094,9563,14403,5233,0,-5269,-10018,16082,-4477,-4851,9156,-0.010538,-0.020036,0.032164,-0.008954,-0.009702,0.018312,-12
62,50000,1,3,1,50,0,0,0,0,0,0,12164,13475,14197,15207,15509,15834,1521,1243,1253,555,575,579,1,10643,12232,12944,14652,14934,15255,0.21286,0.24464,0.25888,0.29304,0.29868,0.3051,0
63,50000,1,2,2,24,2,2,2,2,2,2,49397,50388,51450,47867,51045,51118,2100,2200,0,4300,2100,0,0,47297,48188,51450,43567,48945,51118,0.94594,0.96376,1.029,0.87134,0.9789,1.02236,12
64,100000,1,2,2,32,0,0,0,2,0,0,76112,77494,96445,92742,92644,95497,4500,25445,0,3500,6790,0,0,71612,52049,96445,89242,85854,95497,0.71612,0.52049,0.96445,0.89242,0.85854,0.95497,2
65,320000,0,1,2,29,0,0,0,0,0,0,225892,209493,170336,173806,177425,181003,9429,6189,6309,6510,6600,6395,0,216463,203304,164027,167296,170825,174608,0.676446875,0.635325,0.512584375,0.5228,0.533828125,0.54565,0
66,300000,1,4,2,24,-1,-1,-1,-1,-1,-1,2892,4009,4725,2595,2110,20984,4039,4751,2600,2110,20984,4366,0,-1147,-742,2125,485,-18874,16618,-0.0038233333333333335,-0.0024733333333333335,0.007083333333333333,0.0016166666666666666,-0.06291333333333333,0.055393333333333336,-6
67,290000,1,1,1,33,-2,-2,-2,-2,-2,-2,0,0,0,0,0,0,0,0,0,0,0,0,1,0,0,0,0,0,0,0.0,0.0,0.0,0.0,0.0,0.0,-12
68,280000,1,1,2,31,1,-2,-2,-2,-1,-1,0,0,0,0,710,7611,0,0,0,710,7611,4750,0,0,0,0,-710,-6901,2861,0.0,0.0,0.0,-0.0025357142857142857,-0.024646428571428573,0.010217857142857143,-7
69,150000,1,2,2,29,0,0,0,0,0,-1,19020,7717,9858,9188,7518,23574,1500,5000,2000,1000,33054,704,0,17520,2717,7858,8188,-25536,22870,0.1168,0.018113333333333332,0.052386666666666665,0.054586666666666665,-0.17024,0.15246666666666667,-1
70,250000,1,1,2,29,2,-1,-1,-1,-1,0,1381,1381,7014,1581,36022,34011,1381,7014,1581,36022,10000,10961,0,0,-5633,5433,-34441,26022,23050,0.0,-0.022532,0.021732,-0.137764,0.104088,0.0922,-2
71,360000,1,1,1,45,-1,-1,2,0,-1,-1,390,1170,780,390,390,390,1170,0,0,390,390,390,1,-780,1170,780,0,0,0,-0.0021666666666666666,0.00325,0.0021666666666666666,0.0,0.0,0.0,-2
72,50000,0,1,1,50,-1,2,-1,-1,-1,-1,780,390,390,390,390,780,0,390,390,390,780,0,1,780,0,0,0,-390,780,0.0156,0.0,0.0,0.0,-0.0078,0.0156,-3
73,320000,0,2,1,39,0,0,0,0,0,0,93768,91523,91579,91193,92837,95323,3317,3506,4218,5000,6080,938,1,90451,88017,87361,86193,86757,94385,0.282659375,0.275053125,0.273003125,0.269353125,0.271115625,0.294953125,0
74,80000,1,3,1,39,0,0,0,-2,-1,-1,4948,3804,0,0,1715,0,1000,0,0,1715,0,0,1,3948,3804,0,-1715,1715,0,0.04935,0.04755,0.0,-0.0214375,0.0214375,0.0,-4
75,50000,1,2,2,41,0,0,0,-2,-2,-2,45408,36025,0,0,0,0,2025,0,0,0,0,0,0,43383,36025,0,0,0,0,0.86766,0.7205,0.0,0.0,0.0,0.0,-6
76,50000,0,2,2,23,0,0,0,0,0,0,42284,31512,26097,27148,54991,28480,1800,1600,1500,1000,2400,1500,0,40484,29912,24597,26148,52591,26980,0.80968,0.59824,0.49194,0.52296,1.05182,0.5396,0
77,170000,1,2,2,38,0,0,0,0,2,2,86401,88991,91571,94045,97965,101176,3991,4071,4000,5600,5000,4000,0,82410,84920,87571,88445,92965,97176,0.48476470588235293,0.4995294117647059,0.5151235294117648,0.520264705882353,0.5468529411764705,0.5716235294117648,4
78,50000,1,1,2,22,2,2,2,2,2,2,46035,46620,47341,45527,48358,47442,2000,1800,0,4100,0,2500,0,44035,44820,47341,41427,48358,44942,0.8807,0.8964,0.94682,0.82854,0.96716,0.89884,12
79,200000,1,2,2,29,0,0,2,0,0,0,69412,69878,64222,50518,44892,76088,4012,2008,3008,9056,36100,22500,0,65400,67870,61214,41462,8792,53588,0.327,0.33935,0.30607,0.20731,0.04396,0.26794,2
80,60000,1,2,2,24,0,0,0,0,0,0,50840,49592,44412,45402,35704,36524,2100,1847,1837,1139,1254,1387,0,48740,47745,42575,44263,34450,35137,0.8123333333333334,0.79575,0.7095833333333333,0.7377166666666667,0.5741666666666667,0.5856166666666667,0
81,340000,0,1,1,37,-1,-1,-1,-1,-1,-1,8480,21524,12247,651,12105,7661,21631,12308,654,12164,7699,13379,1,-13151,9216,11593,-11513,4406,-5718,-0.038679411764705886,0.027105882352941178,0.03409705882352941,-0.033861764705882355,0.012958823529411764,-0.01681764705882353,-6
82,250000,0,1,2,27,-1,-1,-1,-1,-1,0,73,2244,3119,1860,10094,4896,2265,3119,1943,10094,2896,5074,0,-2192,-875,1176,-8234,7198,-178,-0.008768,-0.0035,0.004704,-0.032936,0.028792,-0.000712,-5
83,300000,1,2,1,40,0,0,0,0,0,0,11704,10196,8900,7099,5437,3958,1139,1322,1000,2000,1000,1000,1,10565,8874,7900,5099,4437,2958,0.03521666666666667,0.02958,0.026333333333333334,0.016996666666666667,0.01479,0.00986,0
84,30000,1,2,1,30,1,5,4,3,2,2,28534,27805,27090,26361,26831,27552,0,0,0,1200,1300,985,1,28534,27805,27090,25161,25531,26567,0.9511333333333334,0.9268333333333333,0.903,0.8387,0.8510333333333333,0.8855666666666666,17
85,20000,1,3,2,53,-1,-1,-2,-2,-1,-1,4400,-220,-220,-610,390,0,0,0,0,1390,0,780,0,4400,-220,-220,-2000,390,-780,0.22,-0.011,-0.011,-0.1,0.0195,-0.039,-8
86,170000,0,3,2,30,0,-1,0,0,0,0,10392,168088,168955,161351,126198,124746,168096,6409,7335,4448,4519,5003,0,-157704,161679,161620,156903,121679,119743,-0.9276705882352941,0.9510529411764705,0.9507058823529412,0.9229588235294117,0.7157588235294118,0.7043705882352941,-1
87,440000,1,2,2,27,0,0,0,0,0,0,197019,182336,182617,166031,148157,142034,6040,12538,5047,10522,6082,10018,0,190979,169798,177570,155509,142075,132016,0.4340431818181818,0.38590454545454544,0.4035681818181818,0.35342954545454547,0.32289772727272725,0.30003636363636366,0
88,180000,1,1,2,29,0,0,0,0,0,0,123154,126078,78070,50730,48039,47665,5200,3045,3500,2700,2720,2000,0,117954,123033,74570,48030,45319,45665,0.6553,0.6835166666666667,0.4142777777777778,0.2668333333333333,0.25177222222222223,0.25369444444444444,0
89,80000,0,2,2,24,1,2,2,2,0,0,178541,174189,183197,177641,149806,141706,0,11900,6500,6500,5800,6500,0,178541,162289,176697,171141,144006,135206,2.2317625,2.0286125,2.2087125,2.1392625,1.800075,1.690075,7
90,10000,0,2,1,26,3,2,2,7,7,6,2400,2400,2400,2400,2400,1800,0,0,0,0,0,0,1,2400,2400,2400,2400,2400,1800,0.24,0.24,0.24,0.24,0.24,0.18,27
91,80000,1,2,2,29,-2,-2,-2,-2,-2,-2,0,0,0,0,0,0,0,0,0,0,0,0,0,0,0,0,0,0,0,0.0,0.0,0.0,0.0,0.0,0.0,-12
92,70000,0,3,2,28,0,0,0,0,0,0,71199,49042,47087,28596,4465,3204,2507,3024,2122,0,0,48459,0,68692,46018,44965,28596,4465,-45255,0.9813142857142857,0.6574,0.6423571428571428,0.4085142857142857,0.06378571428571428,-0.6465,0
93,60000,1,1,1,43,2,2,2,2,2,2,46806,47758,48669,49559,50608,51426,2000,2000,2000,2000,1806,2300,1,44806,45758,46669,47559,48802,49126,0.7467666666666667,0.7626333333333334,0.7778166666666667,0.79265,0.8133666666666667,0.8187666666666666,12
94,20000,1,2,1,37,0,0,0,0,0,-2,17312,17762,18814,19614,0,0,1500,1500,1000,0,0,0,1,15812,16262,17814,19614,0,0,0.7906,0.8131,0.8907,0.9807,0.0,0.0,-2
95,310000,0,2,1,35,0,0,0,0,0,0,7589,9463,12296,15083,17840,20376,2000,3000,3000,3000,3000,3003,1,5589,6463,9296,12083,14840,17373,0.018029032258064515,0.020848387096774192,0.029987096774193547,0.038977419354838706,0.047870967741935486,0.056041935483870965,0
96,50000,0,2,2,25,2,2,0,0,0,-2,44630,44802,40686,7710,0,0,1200,1200,1000,0,0,0,0,43430,43602,39686,7710,0,0,0.8686,0.87204,0.79372,0.1542,0.0,0.0,2
97,60000,0,2,2,36,-1,-1,0,0,2,-1,39212,45987,42778,25163,7784,12332,45994,20052,20007,7,12332,500,0,-6782,25935,22771,25156,-4548,11832,-0.11303333333333333,0.43225,0.37951666666666667,0.4192666666666667,-0.0758,0.1972,-1
98,380000,1,1,2,27,-2,-2,-2,-2,-2,-2,0,292,7352,3401,1042,4000,292,7352,3401,1042,4000,5000,0,-292,-7060,3951,2359,-2958,-1000,-0.0007684210526315789,-0.018578947368421053,0.01039736842105263,0.006207894736842105,-0.007784210526315789,-0.002631578947368421,-12
99,360000,0,1,2,43,-1,-1,-1,-1,-1,-1,59,4465,300,966,1730,0,4465,300,966,1730,0,969,0,-4406,4165,-666,-764,1730,-969,-0.01223888888888889,0.011569444444444445,-0.00185,-0.0021222222222222224,0.004805555555555556,-0.002691666666666667,-6
100,250000,0,1,1,40,0,-1,-1,-1,-1,2,307321,4696,5579,8537,2500,2500,4730,5607,8634,2500,0,0,1,302591,-911,-3055,6037,2500,2500,1.210364,-0.003644,-0.01222,0.024148,0.01,0.01,-2
101,60000,1,1,2,26,1,-2,-1,-1,0,0,0,0,539,37970,39354,40048,0,539,37970,2000,1500,1481,0,0,-539,-37431,35970,37854,38567,0.0,-0.008983333333333333,-0.62385,0.5995,0.6309,0.6427833333333334,-3
102,200000,1,1,1,39,-1,0,-1,0,0,0,8432,6977,6727,6864,5253,3388,3746,6737,2013,10,20,10901,1,4686,240,4714,6854,5233,-7513,0.02343,0.0012,0.02357,0.03427,0.026165,-0.037565,-2
103,390000,1,2,2,30,0,0,0,-1,-1,0,35169,17147,3350,4710,80474,80330,1070,1226,4710,83756,3100,3100,0,34099,15921,-1360,-79046,77374,77230,0.08743333333333334,0.04082307692307692,-0.0034871794871794873,-0.20268205128205127,0.1983948717948718,0.19802564102564102,-2
104,110000,1,1,2,30,-1,-1,-1,-1,-2,-2,1064,2001,3796,0,0,0,2007,3796,0,0,0,0,0,-943,-1795,3796,0,0,0,-0.008572727272727274,-0.01631818181818182,0.034509090909090906,0.0,0.0,0.0,-8
105,220000,0,1,2,38,0,0,0,0,0,0,159322,164176,167028,170480,173818,177556,7500,7000,6500,6000,6000,10000,0,151822,157176,160528,164480,167818,167556,0.6901,0.7144363636363636,0.7296727272727273,0.7476363636363637,0.7628090909090909,0.7616181818181819,0
106,450000,0,1,2,28,-1,0,0,0,-1,-1,9845,11991,17111,19585,9756,3282,3000,10000,3000,10000,3300,326,0,6845,1991,14111,9585,6456,2956,0.015211111111111111,0.004424444444444444,0.031357777777777776,0.0213,0.014346666666666667,0.006568888888888889,-3
107,80000,1,2,1,39,0,0,0,0,0,0,51644,53177,52446,49999,41411,42328,3000,2037,2000,1499,2000,1623,1,48644,51140,50446,48500,39411,40705,0.60805,0.63925,0.630575,0.60625,0.4926375,0.5088125,0
108,230000,1,1,2,31,-2,-2,-2,-2,-2,-2,-7,6785,0,147,0,0,6792,0,147,0,0,176,0,-6799,6785,-147,147,0,-176,-0.02956086956521739,0.0295,-0.0006391304347826087,0.0006391304347826087,0.0,-0.0007652173913043479,-12
109,500000,1,1,1,44,0,-1,-1,0,0,0,329570,71921,367979,294969,189612,128459,72001,368199,6486,234,90,167116,1,257569,-296278,361493,294735,189522,-38657,0.515138,-0.592556,0.722986,0.58947,0.379044,-0.077314,-2
110,180000,0,2,1,37,0,0,0,0,0,0,102937,104598,85805,87462,89162,91609,5000,4100,4010,4000,4000,4000,1,97937,100498,81795,83462,85162,87609,0.5440944444444444,0.5583222222222223,0.4544166666666667,0.4636777777777778,0.4731222222222222,0.4867166666666667,0
111,90000,0,2,2,28,2,0,0,0,0,0,33382,35526,37513,38637,44088,35705,3000,3000,3000,10000,3000,2000,0,30382,32526,34513,28637,41088,33705,0.33757777777777775,0.3614,0.38347777777777775,0.3181888888888889,0.45653333333333335,0.3745,2
112,50000,1,2,2,33,0,0,0,0,0,0,12498,16264,17918,16072,17041,19028,4000,2000,1000,2000,2396,1000,0,8498,14264,16918,14072,14645,18028,0.16996,0.28528,0.33836,0.28144,0.2929,0.36056,0
113,210000,1,1,2,31,-1,-1,-1,-1,0,0,12618,6313,16488,12900,20108,18378,6344,16560,13024,12541,7091,11414,0,6274,-10247,3464,359,13017,6964,0.029876190476190476,-0.04879523809523809,0.016495238095238094,0.0017095238095238094,0.06198571428571428,0.03316190476190476,-4
114,260000,1,2,1,46,0,0,0,2,2,2,16170,18256,19556,18136,24018,21490,3000,2934,0,8000,0,2000,1,13170,15322,19556,10136,24018,19490,0.05065384615384615,0.05893076923076923,0.07521538461538461,0.03898461538461538,0.09237692307692308,0.07496153846153847,6
115,320000,0,3,2,52,0,0,0,0,0,0,31858,33562,35119,36886,38756,40543,5000,5000,5000,5000,5000,5000,0,26858,28562,30119,31886,33756,35543,0.08393125,0.08925625,0.094121875,0.09964375,0.1054875,0.111071875,0
116,180000,1,1,2,29,-1,-1,-1,-1,-2,-2,1010,3070,307,0,0,0,3394,307,0,0,0,0,0,-2384,2763,307,0,0,0,-0.013244444444444444,0.01535,0.0017055555555555556,0.0,0.0,0.0,-8
117,260000,1,2,1,37,0,0,0,0,0,0,182249,181433,180660,179052,177072,175285,6107,6501,6005,5805,5909,6106,1,176142,174932,174655,173247,171163,169179,0.6774692307692308,0.6728153846153846,0.67175,0.6663346153846154,0.6583192307692308,0.6506884615384615,0
118,20000,0,2,2,27,0,0,0,0,0,0,15526,33140,17589,18945,36552,18797,1300,1300,1650,850,1500,700,0,14226,31840,15939,18095,35052,18097,0.7113,1.592,0.79695,0.90475,1.7526,0.90485,0
119,150000,1,1,1,31,-1,-1,-2,-2,-2,-2,12420,0,0,0,0,0,0,0,0,0,0,0,1,12420,0,0,0,0,0,0.0828,0.0,0.0,0.0,0.0,0.0,-10
120,210000,0,1,1,47,-1,-1,-1,-1,-1,-1,8417,15271,12803,13984,9958,13066,15271,12831,13996,9958,13066,6151,1,-6854,2440,-1193,4026,-3108,6915,-0.03263809523809524,0.011619047619047619,-0.005680952380952381,0.019171428571428572,-0.0148,0.032928571428571425,-6
121,50000,0,2,2,27,0,0,0,0,0,0,49321,47912,39421,40165,41198,43766,1700,2000,1700,1700,3400,1000,0,47621,45912,37721,38465,37798,42766,0.95242,0.91824,0.75442,0.7693,0.75596,0.85532,0
122,280000,1,1,1,36,0,0,0,0,0,0,157424,161596,166680,170691,14988,16776,6000,6500,6000,1000,2000,2012,1,151424,155096,160680,169691,12988,14764,0.5408,0.5539142857142857,0.5738571428571428,0.6060392857142857,0.04638571428571429,0.05272857142857143,0
123,200000,1,2,1,41,-2,-2,-1,-1,-1,2,-60,-60,1590,8188,428,278,0,1650,8188,428,0,5500,1,-60,-1710,-6598,7760,428,-5222,-0.0003,-0.00855,-0.03299,0.0388,0.00214,-0.02611,-5
124,50000,0,2,1,40,0,0,0,0,0,0,50536,9853,11353,12143,11753,11922,1200,4000,2000,2000,1000,1000,1,49336,5853,9353,10143,10753,10922,0.98672,0.11706,0.18706,0.20286,0.21506,0.21844,0
125,210000,1,2,2,33,0,0,0,0,0,0,212601,177946,119362,117766,68791,66167,6000,4500,5000,3000,3000,3000,0,206601,173446,114362,114766,65791,63167,0.9838142857142858,0.8259333333333333,0.5445809523809524,0.5465047619047619,0.3132904761904762,0.3007952380952381,0
126,60000,1,2,1,43,0,0,0,0,0,0,57033,58994,59732,36914,37684,38613,2880,2473,1322,1366,1554,1369,1,54153,56521,58410,35548,36130,37244,0.90255,0.9420166666666666,0.9735,0.5924666666666667,0.6021666666666666,0.6207333333333334,0
127,200000,0,1,1,63,-1,-1,-1,-1,-1,-1,316,316,316,316,316,316,316,316,316,316,316,316,1,0,0,0,0,0,0,0.0,0.0,0.0,0.0,0.0,0.0,-6
128,230000,1,2,1,42,-2,-2,-2,-2,-2,-1,7906,2131,5733,4292,4694,4709,2138,5756,4303,4711,4741,6037,1,5768,-3625,1430,-419,-47,-1328,0.025078260869565216,-0.01576086956521739,0.0062173913043478265,-0.0018217391304347825,-0.00020434782608695653,-0.005773913043478261,-11
129,20000,0,4,2,22,2,0,0,0,0,0,18565,17204,17285,18085,11205,5982,0,1200,1000,500,1000,0,0,18565,16004,16285,17585,10205,5982,0.92825,0.8002,0.81425,0.87925,0.51025,0.2991,2
130,50000,1,2,1,24,0,0,0,0,0,0,48928,32646,31428,24880,26098,26886,2000,3505,2000,8000,4000,3650,1,46928,29141,29428,16880,22098,23236,0.93856,0.58282,0.58856,0.3376,0.44196,0.46472,0
131,50000,0,3,1,44,-1,-1,-1,-1,-1,-1,1261,1261,0,1261,1261,1261,1261,0,2522,1261,1261,1432,1,0,1261,-2522,0,0,-171,0.0,0.02522,-0.05044,0.0,0.0,-0.00342,-6
132,50000,0,3,2,26,0,0,0,-2,-2,-2,50419,40200,0,0,0,0,1000,0,0,0,0,0,0,49419,40200,0,0,0,0,0.98838,0.804,0.0,0.0,0.0,0.0,-6
133,230000,0,2,1,36,0,0,0,0,0,0,19505,20715,19750,19506,19255,17479,3000,3000,3000,3000,3000,3000,1,16505,17715,16750,16506,16255,14479,0.07176086956521739,0.07702173913043478,0.07282608695652174,0.07176521739130434,0.07067391304347827,0.06295217391304347,0
134,50000,1,2,2,31,0,0,0,0,0,0,51036,50718,48853,48739,9372,9736,1762,2314,1200,1000,1000,500,0,49274,48404,47653,47739,8372,9236,0.98548,0.96808,0.95306,0.95478,0.16744,0.18472,0
135,180000,0,2,2,43,0,0,0,0,0,0,164222,169073,171820,160018,164717,151235,7500,5900,6000,7000,7000,5000,0,156722,163173,165820,153018,157717,146235,0.8706777777777778,0.9065166666666666,0.9212222222222223,0.8501,0.8762055555555556,0.8124166666666667,0
136,50000,1,2,2,31,2,2,2,2,2,2,30619,31634,32317,32787,33416,34116,1800,1500,1300,1300,1400,1500,0,28819,30134,31017,31487,32016,32616,0.57638,0.60268,0.62034,0.62974,0.64032,0.65232,12
137,30000,1,2,1,54,-1,-1,-1,-1,-1,-1,3334,3366,890,2662,1542,-2695,3366,890,2662,1542,0,6000,1,-32,2476,-1772,1120,1542,-8695,-0.0010666666666666667,0.08253333333333333,-0.05906666666666667,0.037333333333333336,0.0514,-0.28983333333333333,-6
138,300000,1,2,2,28,0,0,2,2,2,2,275855,286812,280337,318248,316147,303666,15000,7000,50000,12000,0,13000,0,260855,279812,230337,306248,316147,290666,0.8695166666666667,0.9327066666666667,0.76779,1.0208266666666668,1.0538233333333333,0.9688866666666667,8
139,30000,1,2,2,24,-1,0,0,0,0,0,20069,21148,22185,22551,23223,24837,1700,1700,1000,1000,2000,1400,0,18369,19448,21185,21551,21223,23437,0.6123,0.6482666666666667,0.7061666666666667,0.7183666666666667,0.7074333333333334,0.7812333333333333,-1
140,50000,1,1,2,29,1,-2,-2,-2,-2,-2,0,0,0,0,0,0,0,0,0,0,0,0,0,0,0,0,0,0,0,0.0,0.0,0.0,0.0,0.0,0.0,-9
141,130000,0,2,1,39,0,0,-1,0,-1,-1,1240,0,1138,1138,2478,-3040,0,1138,0,2500,0,0,1,1240,-1138,1138,-1362,2478,-3040,0.009538461538461539,-0.008753846153846154,0.008753846153846154,-0.010476923076923076,0.019061538461538463,-0.023384615384615386,-3
142,70000,0,2,2,27,0,0,0,0,0,0,17058,59481,50890,50981,54122,58227,52896,2047,1861,4000,5000,3044,0,-35838,57434,49029,46981,49122,55183,-0.5119714285714285,0.8204857142857143,0.7004142857142858,0.6711571428571429,0.7017428571428571,0.7883285714285714,0
143,250000,1,1,2,40,-1,-1,-1,-1,-1,-1,3264,2395,2986,24971,500,2162,2395,2991,25185,500,2162,0,0,869,-596,-22199,24471,-1662,2162,0.003476,-0.002384,-0.088796,0.097884,-0.006648,0.008648,-6
144,60000,1,2,1,29,0,0,0,0,0,0,62325,59359,30604,22204,19895,19199,2864,1300,1000,803,1107,1000,1,59461,58059,29604,21401,18788,18199,0.9910166666666667,0.96765,0.4934,0.35668333333333335,0.3131333333333333,0.3033166666666667,0
145,140000,0,2,1,40,0,0,0,0,0,0,139282,138095,140725,139401,103929,101148,4945,5254,4861,3649,3653,3700,1,134337,132841,135864,135752,100276,97448,0.95955,0.9488642857142857,0.9704571428571429,0.9696571428571429,0.7162571428571428,0.6960571428571428,0
146,200000,0,1,1,43,0,0,0,0,0,0,144678,140804,136437,135253,134629,134309,5090,5014,5009,4844,5002,4902,1,139588,135790,131428,130409,129627,129407,0.69794,0.67895,0.65714,0.652045,0.648135,0.647035,0
147,140000,0,2,2,30,2,0,0,0,0,0,138421,137456,139977,136207,50464,49430,5000,6003,4771,2103,2000,43557,0,133421,131453,135206,134104,48464,5873,0.9530071428571428,0.93895,0.9657571428571429,0.9578857142857143,0.3461714285714286,0.04195,2
148,150000,1,2,2,30,1,-2,-2,-2,-1,2,0,0,0,0,268,118,0,0,0,268,0,7800,0,0,0,0,-268,268,-7682,0.0,0.0,0.0,-0.0017866666666666667,0.0017866666666666667,-0.05121333333333333,-4
149,240000,0,2,1,54,0,0,2,0,0,0,16135,249258,243589,204754,201426,198736,234000,30,7046,7023,10005,8014,1,-217865,249228,236543,197731,191421,190722,-0.9077708333333333,1.03845,0.9855958333333333,0.8238791666666667,0.7975875,0.794675,2
150,20000,0,3,2,49,0,0,0,-1,0,-1,19363,19609,-391,19413,12223,2110,1200,160,20394,347,2110,12996,0,18163,19449,-20785,19066,10113,-10886,0.90815,0.97245,-1.03925,0.9533,0.50565,-0.5443,-2
151,60000,0,2,2,31,0,0,0,0,-1,0,53954,57469,37861,60993,2343,6707,5000,5000,25500,3000,6000,5000,0,48954,52469,12361,57993,-3657,1707,0.8159,0.8744833333333333,0.20601666666666665,0.96655,-0.06095,0.02845,-1
152,20000,1,2,2,25,0,0,0,0,0,0,19223,18206,19195,38040,20009,20138,1293,1397,836,1653,565,206,0,17930,16809,18359,36387,19444,19932,0.8965,0.84045,0.91795,1.81935,0.9722,0.9966,0
153,40000,0,2,1,38,2,2,2,2,2,2,33152,33623,34773,33917,36704,40404,1300,2000,0,3500,4471,0,1,31852,31623,34773,30417,32233,40404,0.7963,0.790575,0.869325,0.760425,0.805825,1.0101,12
154,30000,0,2,1,44,1,3,2,2,2,2,23171,22523,21863,23296,22783,24310,0,0,1800,0,1910,780,1,23171,22523,20063,23296,20873,23530,0.7723666666666666,0.7507666666666667,0.6687666666666666,0.7765333333333333,0.6957666666666666,0.7843333333333333,12
155,20000,1,2,2,22,0,0,0,0,0,0,18062,18374,19222,18014,18627,15811,1700,1500,1000,1000,1000,1000,0,16362,16874,18222,17014,17627,14811,0.8181,0.8437,0.9111,0.8507,0.88135,0.74055,0
156,120000,1,2,2,23,0,0,0,0,0,0,38609,41992,36607,38828,38325,39222,5000,4000,4017,3000,3000,3000,0,33609,37992,32590,35828,35325,36222,0.280075,0.3166,0.27158333333333334,0.29856666666666665,0.294375,0.30185,0
157,50000,1,3,2,23,-2,-2,-2,-2,-2,-2,8647,4872,-5,2809,0,0,4890,0,2814,0,0,0,0,3757,4872,-2819,2809,0,0,0.07514,0.09744,-0.05638,0.05618,0.0,0.0,-12
158,50000,1,2,1,45,0,0,0,0,0,0,39944,41180,41870,8469,8411,8361,2124,2037,1130,295,302,296,1,37820,39143,40740,8174,8109,8065,0.7564,0.78286,0.8148,0.16348,0.16218,0.1613,0
159,230000,1,1,2,28,-1,0,0,0,0,0,48144,51966,44477,39998,23278,27775,12000,2353,5000,0,8000,643,0,36144,49613,39477,39998,15278,27132,0.15714782608695652,0.2157086956521739,0.1716391304347826,0.17390434782608696,0.06642608695652175,0.11796521739130435,-1
160,60000,1,3,1,63,0,0,0,0,0,0,56285,56894,57006,28198,23888,24083,5000,2156,3017,2009,3000,3000,1,51285,54738,53989,26189,20888,21083,0.85475,0.9123,0.8998166666666667,0.43648333333333333,0.34813333333333335,0.3513833333333333,0
161,200000,1,1,2,30,-1,-1,-1,-1,-1,-1,4800,2040,5961,1829,1652,584,2040,5961,1829,1652,584,5430,0,2760,-3921,4132,177,1068,-4846,0.0138,-0.019605,0.02066,0.000885,0.00534,-0.02423,-6
162,100000,1,3,1,39,0,0,0,0,0,0,97944,99580,92297,184134,70400,0,4296,4068,2037,1408,0,0,1,93648,95512,90260,182726,70400,0,0.93648,0.95512,0.9026,1.82726,0.704,0.0,0
163,60000,0,3,2,52,0,0,0,0,0,0,22460,23592,24665,26305,23756,25353,1500,1500,2000,1500,2000,2000,0,20960,22092,22665,24805,21756,23353,0.34933333333333333,0.3682,0.37775,0.41341666666666665,0.3626,0.38921666666666666,0
164,400000,1,2,1,38,-1,0,-1,-1,0,-1,3697,3600,1354,5322,5103,2077,1000,1354,5322,6,2386,9085,1,2697,2246,-3968,5316,2717,-7008,0.0067425,0.005615,-0.00992,0.01329,0.0067925,-0.01752,-4
165,150000,1,2,1,30,-1,-1,2,-1,-1,-1,696,1392,696,696,873,1392,1392,0,696,873,1392,696,1,-696,1392,0,-177,-519,696,-0.00464,0.00928,0.0,-0.00118,-0.00346,0.00464,-3
166,70000,1,1,1,28,0,0,0,0,0,-2,20596,24911,28346,12170,-1686,-3594,5000,4000,12,0,0,0,1,15596,20911,28334,12170,-1686,-3594,0.2228,0.29872857142857145,0.40477142857142856,0.17385714285714285,-0.024085714285714287,-0.05134285714285714,-2
167,210000,1,2,2,30,-1,0,0,0,0,0,1654,33257,34395,35321,36249,37047,32000,2000,1500,1500,1400,1600,0,-30346,31257,32895,33821,34849,35447,-0.1445047619047619,0.14884285714285714,0.15664285714285714,0.16105238095238095,0.16594761904761904,0.16879523809523808,-1
168,390000,0,1,2,41,-1,-1,-1,-1,-1,-1,6782,1466,3273,6965,4893,7777,1466,3273,6965,4893,7777,7271,0,5316,-1807,-3692,2072,-2884,506,0.013630769230769231,-0.004633333333333333,-0.009466666666666667,0.005312820512820513,-0.007394871794871795,0.0012974358974358975,-6
169,140000,1,2,1,30,0,0,0,0,0,0,21593,17636,17800,14869,12895,12833,2000,2000,2000,1000,1000,600,1,19593,15636,15800,13869,11895,12233,0.13995,0.11168571428571429,0.11285714285714285,0.09906428571428572,0.08496428571428571,0.08737857142857143,0
170,290000,1,1,1,50,0,0,0,0,0,0,165563,128747,120469,78892,81561,83687,7000,10009,5000,5000,5000,10000,1,158563,118738,115469,73892,76561,73687,0.5467689655172414,0.40944137931034486,0.3981689655172414,0.2548,0.2640034482758621,0.25409310344827585,0
171,80000,1,2,2,25,1,-1,-1,-1,-2,-1,0,9000,380,0,0,363,9000,380,0,0,363,0,0,-9000,8620,380,0,-363,363,-0.1125,0.10775,0.00475,0.0,-0.0045375,0.0045375,-5
172,350000,1,2,1,43,-2,-2,-2,-2,-2,-1,2124,3027,2448,4590,0,430,3048,2460,4616,0,430,430,1,-924,567,-2168,4590,-430,0,-0.00264,0.00162,-0.006194285714285715,0.013114285714285714,-0.0012285714285714285,0.0,-11
173,100000,1,2,1,26,0,0,0,0,0,0,7086,7644,8197,9203,3815,5493,1500,1500,2000,1000,2493,2443,1,5586,6144,6197,8203,1322,3050,0.05586,0.06144,0.06197,0.08203,0.01322,0.0305,0
174,50000,1,1,1,35,1,2,2,2,0,0,47438,46400,49276,48286,47915,48386,0,3700,0,2000,6000,0,1,47438,42700,49276,46286,41915,48386,0.94876,0.854,0.98552,0.92572,0.8383,0.96772,7
175,20000,1,3,3,44,0,0,2,2,0,0,18126,20771,20434,19874,19546,0,3599,1200,1000,400,0,0,0,14527,19571,19434,19474,19546,0,0.72635,0.97855,0.9717,0.9737,0.9773,0.0,4
176,10000,0,2,2,23,0,0,0,0,0,2,8109,9219,10200,9694,9684,9872,1400,1300,500,1000,500,0,0,6709,7919,9700,8694,9184,9872,0.6709,0.7919,0.97,0.8694,0.9184,0.9872,2
177,70000,1,2,1,27,1,2,0,0,2,2,48098,47922,51806,55625,57072,58269,881,4700,4700,2500,2300,2300,1,47217,43222,47106,53125,54772,55969,0.6745285714285715,0.6174571428571428,0.6729428571428572,0.7589285714285714,0.7824571428571429,0.7995571428571429,7
178,240000,0,3,2,45,1,2,0,0,0,0,221341,213264,207403,201331,195040,188968,7000,7500,7300,7000,7000,5869,0,214341,205764,200103,194331,188040,183099,0.8930875,0.85735,0.8337625,0.8097125,0.7835,0.7629125,3
179,360000,0,2,2,37,-2,-2,-2,-2,-2,-2,880,22311,-447,-6146,13461,0,22311,26,0,25461,0,0,0,-21431,22285,-447,-31607,13461,0,-0.05953055555555556,0.06190277777777778,-0.0012416666666666667,-0.08779722222222222,0.03739166666666666,0.0,-12
180,20000,1,2,2,46,-1,-1,-1,-1,-2,-2,390,0,780,0,0,0,0,780,0,0,0,0,0,390,-780,780,0,0,0,0.0195,-0.039,0.039,0.0,0.0,0.0,-8
181,110000,1,1,2,26,0,0,0,0,0,0,58716,50943,46942,47935,49083,49603,2500,2100,2000,2000,2500,2000,0,56216,48843,44942,45935,46583,47603,0.5110545454545454,0.4440272727272727,0.40856363636363635,0.41759090909090907,0.4234818181818182,0.43275454545454545,0
182,270000,1,1,2,32,0,0,0,0,0,0,48114,42573,55350,92141,57961,45282,20091,30128,60183,2071,2045,2791,0,28023,12445,-4833,90070,55916,42491,0.10378888888888889,0.046092592592592595,-0.0179,0.3335925925925926,0.2070962962962963,0.15737407407407408,0
183,140000,1,2,1,58,2,2,2,2,2,2,68859,70428,71902,72924,72335,75508,3300,3200,2800,1200,4500,3000,1,65559,67228,69102,71724,67835,72508,0.46827857142857143,0.4802,0.4935857142857143,0.5123142857142857,0.4845357142857143,0.5179142857142857,12
184,170000,0,1,1,38,1,-2,-2,-2,-2,-2,0,0,0,0,0,0,0,0,0,0,0,0,1,0,0,0,0,0,0,0.0,0.0,0.0,0.0,0.0,0.0,-9
185,50000,0,2,2,28,1,2,2,2,0,0,9500,7913,9572,9281,8835,9038,0,1800,0,400,350,400,0,9500,6113,9572,8881,8485,8638,0.19,0.12226,0.19144,0.17762,0.1697,0.17276,7
186,60000,1,3,2,45,-1,-1,-1,-1,-1,-1,1876,1876,1876,1876,1876,1876,1876,1876,1876,1876,1876,1876,0,0,0,0,0,0,0,0.0,0.0,0.0,0.0,0.0,0.0,-6
187,70000,1,2,2,22,0,0,0,0,0,-1,68247,68263,22551,16008,0,13180,2120,1010,328,0,13180,2000,0,66127,67253,22223,16008,-13180,11180,0.9446714285714286,0.9607571428571429,0.31747142857142857,0.2286857142857143,-0.18828571428571428,0.15971428571428573,-1
188,160000,1,2,2,45,1,-2,-2,-2,-2,-1,0,0,0,0,0,388,0,0,0,0,388,3099,0,0,0,0,0,-388,-2711,0.0,0.0,0.0,0.0,-0.002425,-0.01694375,-8
189,80000,0,1,2,33,0,0,0,0,0,0,59991,63371,65616,36159,36712,38194,5000,4000,2500,2500,2000,1000,0,54991,59371,63116,33659,34712,37194,0.6873875,0.7421375,0.78895,0.4207375,0.4339,0.464925,0
190,50000,0,2,1,33,2,0,-1,-1,-1,0,42923,42803,1473,390,1573,390,2330,1473,390,1573,0,780,1,40593,41330,1083,-1183,1573,-390,0.81186,0.8266,0.02166,-0.02366,0.03146,-0.0078,-1
191,350000,1,2,2,28,1,2,0,0,0,0,358895,346575,345088,341811,265953,93300,0,14579,13557,12000,5000,11000,0,358895,331996,331531,329811,260953,82300,1.0254142857142856,0.94856,0.9472314285714286,0.9423171428571429,0.74558,0.23514285714285715,3
192,110000,1,2,2,40,0,0,0,0,0,0,96155,96752,98884,98501,34250,35874,5000,5000,3000,3000,3000,3000,0,91155,91752,95884,95501,31250,32874,0.8286818181818182,0.8341090909090909,0.8716727272727273,0.8681909090909091,0.2840909090909091,0.29885454545454543,0
193,70000,1,2,2,30,0,0,0,2,0,0,10149,11454,9638,8761,8572,9274,2000,2000,0,1000,1000,4000,0,8149,9454,9638,7761,7572,5274,0.11641428571428572,0.13505714285714285,0.13768571428571427,0.11087142857142857,0.10817142857142857,0.07534285714285714,2
194,50000,1,2,2,24,0,0,2,2,0,0,46393,50022,50895,48598,47668,45400,4700,2000,0,2200,2000,2000,0,41693,48022,50895,46398,45668,43400,0.83386,0.96044,1.0179,0.92796,0.91336,0.868,4
195,200000,0,1,1,47,1,2,2,0,0,0,198663,201996,194396,166515,163673,145683,8013,13,8684,5500,7437,4600,1,190650,201983,185712,161015,156236,141083,0.95325,1.009915,0.92856,0.805075,0.78118,0.705415,5
196,70000,1,1,2,34,1,3,2,0,0,0,70971,71272,69405,34045,34995,36025,2000,0,1220,1500,1725,0,0,68971,71272,68185,32545,33270,36025,0.9853,1.0181714285714285,0.9740714285714286,0.4649285714285714,0.4752857142857143,0.5146428571428572,6
197,160000,1,2,2,51,-1,-1,-1,-1,-1,-1,6136,5932,4353,3746,5487,2702,5932,4353,3835,6934,3370,2276,0,204,1579,518,-3188,2117,426,0.001275,0.00986875,0.0032375,-0.019925,0.01323125,0.0026625,-6
198,200000,1,1,2,27,1,-2,-2,-2,-1,0,0,0,0,0,3012,3021,0,0,0,3012,9,363,0,0,0,0,-3012,3003,2658,0.0,0.0,0.0,-0.01506,0.015015,0.01329,-6
199,140000,1,1,1,48,-2,-2,-2,-2,-1,-1,5349,2210,5472,0,544,0,2216,5472,0,544,0,0,1,3133,-3262,5472,-544,544,0,0.022378571428571428,-0.0233,0.039085714285714286,-0.0038857142857142857,0.0038857142857142857,0.0,-10
200,100000,1,2,1,34,0,0,0,0,0,0,14815,10108,8022,9733,17284,8540,2010,1149,3094,1003,1004,406,1,12805,8959,4928,8730,16280,8134,0.12805,0.08959,0.04928,0.0873,0.1628,0.08134,0
201,200000,0,1,1,53,2,2,2,2,2,2,138180,140774,142460,144098,147124,149531,6300,5500,5500,5500,5000,5000,1,131880,135274,136960,138598,142124,144531,0.6594,0.67637,0.6848,0.69299,0.71062,0.722655,12
202,180000,1,2,2,35,-2,-2,-1,-1,-1,-1,827,669,785,1809,2067,0,675,785,1809,2067,0,0,0,152,-116,-1024,-258,2067,0,0.0008444444444444444,-0.0006444444444444444,-0.005688888888888889,-0.0014333333333333333,0.011483333333333333,0.0,-8
203,280000,1,2,2,33,1,-2,-2,-2,-2,-1,0,0,0,0,0,35833,0,0,0,0,35833,1500,0,0,0,0,0,-35833,34333,0.0,0.0,0.0,0.0,-0.127975,0.12261785714285714,-8
204,80000,0,2,2,30,0,0,2,-1,-1,-2,53627,64913,19476,61302,0,0,33000,56,62877,0,41150,81000,0,20627,64857,-43401,61302,-41150,-81000,0.2578375,0.8107125,-0.5425125,0.766275,-0.514375,-1.0125,-2
205,230000,1,1,2,41,-1,-1,-1,-1,0,0,12731,6684,10834,28540,56660,46213,7000,15000,29000,30000,0,5000,0,5731,-8316,-18166,-1460,56660,41213,0.024917391304347825,-0.036156521739130434,-0.07898260869565217,-0.006347826086956522,0.24634782608695652,0.17918695652173913,-4
206,80000,0,2,1,32,0,0,0,0,0,0,81249,81117,81140,80567,59560,40390,3000,3300,2602,1800,1432,1520,1,78249,77817,78538,78767,58128,38870,0.9781125,0.9727125,0.981725,0.9845875,0.7266,0.485875,0
207,50000,1,1,2,28,0,0,0,0,0,0,21514,22563,23585,23894,24549,24990,1700,1700,1000,1039,1000,1000,0,19814,20863,22585,22855,23549,23990,0.39628,0.41726,0.4517,0.4571,0.47098,0.4798,0
208,150000,1,4,1,47,0,0,0,0,0,0,89327,90666,91721,93063,92758,93876,4539,4218,4204,3296,3408,3416,1,84788,86448,87517,89767,89350,90460,0.5652533333333334,0.57632,0.5834466666666667,0.5984466666666667,0.5956666666666667,0.6030666666666666,0
209,20000,1,2,2,44,0,0,0,0,0,0,18578,19928,18677,18503,17231,15410,2000,2000,2000,1100,1586,506,0,16578,17928,16677,17403,15645,14904,0.8289,0.8964,0.83385,0.87015,0.78225,0.7452,0
210,200000,1,2,2,28,0,0,0,0,0,0,59373,55040,54414,53504,53670,45539,6002,3008,2006,2045,1346,1196,0,53371,52032,52408,51459,52324,44343,0.266855,0.26016,0.26204,0.257295,0.26162,0.221715,0
211,110000,1,1,2,29,0,0,0,0,0,0,105102,107388,106805,107608,108643,109689,5289,3875,3830,4000,4000,5000,0,99813,103513,102975,103608,104643,104689,0.9073909090909091,0.9410272727272727,0.9361363636363637,0.9418909090909091,0.9513,0.9517181818181818,0
212,70000,0,2,1,47,0,0,0,0,0,0,53239,54351,56480,57253,59150,0,2000,3000,2500,3000,0,0,1,51239,51351,53980,54253,59150,0,0.7319857142857142,0.7335857142857143,0.7711428571428571,0.7750428571428571,0.845,0.0,0
213,280000,0,1,1,44,1,-2,-2,-2,-2,-1,-136,-496,-856,-1216,-1576,4266,360,360,360,317,6252,8,1,-496,-856,-1216,-1533,-7828,4258,-0.0017714285714285714,-0.0030571428571428572,-0.004342857142857143,-0.005475,-0.027957142857142857,0.015207142857142857,-8
214,400000,0,2,1,35,0,0,0,0,-1,0,212647,148816,129580,50790,49106,40591,6000,9353,10000,49106,2000,2000,1,206647,139463,119580,1684,47106,38591,0.5166175,0.3486575,0.29895,0.00421,0.117765,0.0964775,-1
215,30000,1,2,1,29,0,0,0,0,0,-1,28620,28276,28841,28547,11581,17943,1453,1700,1000,232,17943,0,1,27167,26576,27841,28315,-6362,17943,0.9055666666666666,0.8858666666666667,0.9280333333333334,0.9438333333333333,-0.21206666666666665,0.5981,-1
216,180000,1,2,1,41,0,0,0,0,0,0,99925,102359,96462,96846,95549,94131,5024,4300,3500,4000,4000,3650,1,94901,98059,92962,92846,91549,90481,0.5272277777777777,0.5447722222222222,0.5164555555555556,0.5158111111111111,0.5086055555555555,0.5026722222222222,0
217,20000,0,2,1,56,3,2,2,2,2,2,17740,17166,19148,18542,20122,19400,0,2273,0,1882,0,0,1,17740,14893,19148,16660,20122,19400,0.887,0.74465,0.9574,0.833,1.0061,0.97,13
218,160000,1,1,1,33,-2,-2,-2,-2,-2,-2,14150,8106,12431,12145,13391,7957,8106,12431,12145,13391,7957,1905,1,6044,-4325,286,-1246,5434,6052,0.037775,-0.02703125,0.0017875,-0.0077875,0.0339625,0.037825,-12
219,250000,0,3,2,31,0,0,0,0,0,0,73215,70284,70375,65085,54986,50848,7009,5023,5069,10037,5184,15011,0,66206,65261,65306,55048,49802,35837,0.264824,0.261044,0.261224,0.220192,0.199208,0.143348,0
220,260000,1,2,2,37,-1,-1,-1,-1,-1,-1,188,188,189,192,188,0,188,189,192,188,0,526,0,0,-1,-3,4,188,-526,0.0,-3.846153846153846e-06,-1.1538461538461538e-05,1.5384615384615384e-05,0.0007230769230769231,-0.002023076923076923,-6
221,150000,0,1,1,35,2,0,0,0,0,0,165441,160292,153981,129725,103050,54447,7300,6100,5100,4200,1900,1600,1,158141,154192,148881,125525,101150,52847,1.0542733333333334,1.0279466666666666,0.99254,0.8368333333333333,0.6743333333333333,0.3523133333333333,2
222,60000,0,1,2,27,-2,-2,-2,-2,-1,-1,11862,1856,-14,4839,9567,11407,1861,0,4853,9567,2000,0,0,10001,1856,-4867,-4728,7567,11407,0.16668333333333332,0.030933333333333334,-0.08111666666666667,-0.0788,0.12611666666666665,0.19011666666666666,-10
223,80000,1,3,2,32,0,0,0,0,0,0,77385,79038,80899,79387,81593,80254,2900,3200,3000,3500,3100,6200,0,74485,75838,77899,75887,78493,74054,0.9310625,0.947975,0.9737375,0.9485875,0.9811625,0.925675,0
224,30000,1,1,1,41,0,0,0,0,0,-2,15636,4542,4075,3668,0,0,2000,1000,1000,1000,1800,0,1,13636,3542,3075,2668,-1800,0,0.45453333333333334,0.11806666666666667,0.1025,0.08893333333333334,-0.06,0.0,-2
225,500000,1,1,1,33,-2,-2,-2,-2,-2,-2,363,2089,4822,48741,92978,0,2089,4822,48741,92978,0,39037,1,-1726,-2733,-43919,-44237,92978,-39037,-0.003452,-0.005466,-0.087838,-0.088474,0.185956,-0.078074,-12
226,150000,1,1,1,48,-2,-2,-2,-2,-2,-2,6773,1731,21886,447,3458,898,1731,21888,447,3458,898,2001,1,5042,-20157,21439,-3011,2560,-1103,0.033613333333333335,-0.13438,0.14292666666666667,-0.020073333333333332,0.017066666666666667,-0.007353333333333333,-12
227,100000,0,2,1,46,2,0,0,0,0,0,100000,99774,102237,98452,99423,101548,4500,5000,4500,3800,3900,4000,1,95500,94774,97737,94652,95523,97548,0.955,0.94774,0.97737,0.94652,0.95523,0.97548,2
228,60000,1,2,2,27,0,0,0,2,2,2,27921,29954,33166,33528,32690,34661,2500,3700,1200,0,2500,2500,0,25421,26254,31966,33528,30190,32161,0.42368333333333336,0.43756666666666666,0.5327666666666667,0.5588,0.5031666666666667,0.5360166666666667,6
229,50000,0,2,2,24,0,0,0,0,0,0,50603,50116,48063,43787,9226,9628,2500,2505,2531,530,2000,1000,0,48103,47611,45532,43257,7226,8628,0.96206,0.95222,0.91064,0.86514,0.14452,0.17256,0
230,150000,1,1,1,38,-1,-1,-1,-1,-1,-1,110,564,13347,13155,10610,8394,567,13504,13221,10663,8436,2468,1,-457,-12940,126,2492,2174,5926,-0.0030466666666666667,-0.08626666666666667,0.00084,0.016613333333333334,0.014493333333333334,0.03950666666666667,-6
231,120000,1,2,1,45,-1,-1,-1,-1,-1,-1,380,3175,380,380,2402,696,3175,380,380,2402,696,1093,1,-2795,2795,0,-2022,1706,-397,-0.023291666666666665,0.023291666666666665,0.0,-0.01685,0.014216666666666667,-0.0033083333333333333,-6
232,100000,1,1,2,30,0,0,-2,-1,0,0,41150,0,0,74550,75731,75975,0,0,74550,3000,3000,3500,0,41150,0,-74550,71550,72731,72475,0.4115,0.0,-0.7455,0.7155,0.72731,0.72475,-3
233,70000,1,3,2,23,0,0,0,-1,0,0,14816,8237,-2601,69823,30446,29585,1000,695,73820,1042,1054,1024,0,13816,7542,-76421,68781,29392,28561,0.19737142857142856,0.10774285714285714,-1.0917285714285714,0.9825857142857143,0.4198857142857143,0.4080142857142857,-1
234,50000,0,1,2,23,0,0,0,-1,-1,0,11306,6657,3565,3820,1275,1275,1069,1240,3840,1275,0,0,0,10237,5417,-275,2545,1275,1275,0.20474,0.10834,-0.0055,0.0509,0.0255,0.0255,-2
235,30000,0,1,2,24,-1,-1,-1,-1,-1,-1,8217,3000,0,504,279,254,5000,0,504,300,500,1000,0,3217,3000,-504,204,-221,-746,0.10723333333333333,0.1,-0.0168,0.0068,-0.007366666666666666,-0.024866666666666665,-6
236,200000,1,2,2,32,0,0,0,0,-1,0,24429,13060,13683,-3942,123250,125926,1500,1000,0,128000,4600,5000,0,22929,12060,13683,-131942,118650,120926,0.114645,0.0603,0.068415,-0.65971,0.59325,0.60463,-1
237,70000,1,1,2,29,0,0,2,2,0,0,47310,51047,51727,50594,51823,54093,4500,1813,0,2046,3300,900,0,42810,49234,51727,48548,48523,53193,0.6115714285714285,0.7033428571428572,0.7389571428571429,0.6935428571428571,0.6931857142857143,0.7599,4
238,260000,1,2,1,31,-1,-1,0,0,-1,-1,5841,23194,62361,67057,17024,18659,23194,50000,11500,17024,18659,38923,1,-17353,-26806,50861,50033,-1635,-20264,-0.0667423076923077,-0.1031,0.19561923076923077,0.1924346153846154,-0.006288461538461539,-0.07793846153846154,-4
239,250000,0,1,1,34,0,0,0,0,0,0,6035,11782,7241,7277,4972,2609,1131,4000,3000,99,1000,6000,1,4904,7782,4241,7178,3972,-3391,0.019616,0.031128,0.016964,0.028712,0.015888,-0.013564,0
240,80000,1,2,2,26,0,0,0,0,0,0,35220,38215,38598,40560,40968,42321,4000,5390,3000,1453,2000,1677,0,31220,32825,35598,39107,38968,40644,0.39025,0.4103125,0.444975,0.4888375,0.4871,0.50805,0
241,150000,0,1,2,33,0,0,0,0,0,0,21724,23168,23320,24085,24149,3323,2100,1200,965,64,509,8399,0,19624,21968,22355,24021,23640,-5076,0.13082666666666667,0.14645333333333332,0.14903333333333332,0.16014,0.1576,-0.03384,0
242,200000,1,1,2,29,0,0,0,0,0,0,7523,8445,9090,3270,774,0,3000,1000,0,700,0,0,0,4523,7445,9090,2570,774,0,0.022615,0.037225,0.04545,0.01285,0.00387,0.0,0
243,50000,0,3,2,29,1,-1,-1,-1,-1,-1,0,1899,832,0,1662,4537,1899,832,0,1662,4537,2943,0,-1899,1067,832,-1662,-2875,1594,-0.03798,0.02134,0.01664,-0.03324,-0.0575,0.03188,-4
244,140000,1,3,1,46,0,0,0,0,0,0,68075,69972,71805,73613,75426,77169,3000,3000,3000,3000,3000,5000,1,65075,66972,68805,70613,72426,72169,0.46482142857142855,0.47837142857142856,0.4914642857142857,0.5043785714285715,0.5173285714285715,0.5154928571428572,0
245,230000,0,1,1,59,-1,0,0,0,0,0,208459,206331,203813,201331,198999,191671,7536,7277,7100,7120,6844,6945,1,200923,199054,196713,194211,192155,184726,0.8735782608695652,0.8654521739130435,0.8552739130434782,0.844395652173913,0.8354565217391304,0.8031565217391304,-1
246,320000,1,1,2,32,-2,-2,-2,-2,-2,-2,3916,2872,4704,3382,2575,8097,2886,4732,3398,2588,8137,2474,0,1030,-1860,1306,794,-5562,5623,0.00321875,-0.0058125,0.00408125,0.00248125,-0.01738125,0.017571875,-12
247,20000,1,2,2,22,1,-1,-1,-2,-2,-2,3843,396,0,0,0,0,2000,0,0,0,0,0,0,1843,396,0,0,0,0,0.09215,0.0198,0.0,0.0,0.0,0.0,-7
248,180000,0,1,2,26,0,0,-2,-2,-2,-2,8516,0,0,0,0,0,0,0,0,0,0,0,0,8516,0,0,0,0,0,0.04731111111111111,0.0,0.0,0.0,0.0,0.0,-8
249,200000,1,1,2,36,-2,-2,-2,-2,-1,-1,0,0,0,932,2469,0,0,0,932,2487,0,0,0,0,0,-932,-1555,2469,0,0.0,0.0,-0.00466,-0.007775,0.012345,0.0,-10
250,120000,1,1,1,51,0,0,0,0,0,2,120290,116082,118405,99081,106300,104433,6000,6000,4000,9000,0,5000,1,114290,110082,114405,90081,106300,99433,0.9524166666666667,0.91735,0.953375,0.750675,0.8858333333333334,0.8286083333333333,2
251,100000,0,2,1,52,0,0,0,0,0,0,55120,56636,58215,16809,24482,21849,2403,2875,1010,10844,1074,580,1,52717,53761,57205,5965,23408,21269,0.52717,0.53761,0.57205,0.05965,0.23408,0.21269,0
252,140000,1,2,2,24,0,0,0,0,0,0,135432,136312,131559,111859,98815,97443,6500,4733,4015,4000,4000,3800,0,128932,131579,127544,107859,94815,93643,0.9209428571428572,0.93985,0.9110285714285714,0.7704214285714286,0.67725,0.6688785714285714,0
253,350000,1,1,2,31,0,0,0,0,0,0,314747,322981,326921,210500,201775,171242,15000,12127,9557,8000,6500,7000,0,299747,310854,317364,202500,195275,164242,0.85642,0.8881542857142857,0.9067542857142857,0.5785714285714286,0.5579285714285714,0.46926285714285715,0
254,230000,1,1,1,30,2,0,0,0,0,0,63064,62725,61465,57637,58172,57560,2800,2158,2610,2022,2064,2038,1,60264,60567,58855,55615,56108,55522,0.2620173913043478,0.26333478260869564,0.2558913043478261,0.24180434782608695,0.24394782608695653,0.2414,2
255,80000,1,1,2,24,-1,0,0,0,0,0,75356,78236,77700,58025,59527,60778,5000,4176,4000,3000,2141,3000,0,70356,74060,73700,55025,57386,57778,0.87945,0.92575,0.92125,0.6878125,0.717325,0.722225,-1
256,150000,0,4,2,32,0,0,0,-1,0,0,159919,68686,161192,150464,143375,146411,4019,146896,157436,4600,4709,5600,0,155900,-78210,3756,145864,138666,140811,1.0393333333333334,-0.5214,0.02504,0.9724266666666667,0.92444,0.93874,-1
257,230000,1,1,2,29,0,0,0,0,0,0,63184,64667,65888,66645,67865,69231,3100,3000,2300,2300,2500,2300,0,60084,61667,63588,64345,65365,66931,0.26123478260869565,0.2681173913043478,0.2764695652173913,0.2797608695652174,0.284195652173913,0.291004347826087,0
258,210000,0,1,2,40,-1,-1,-1,-1,-1,-1,325,325,325,325,325,325,325,325,325,325,325,325,0,0,0,0,0,0,0,0.0,0.0,0.0,0.0,0.0,0.0,-6
259,250000,0,1,1,48,0,-1,-1,-1,0,-1,205323,5317,4898,19351,4858,6973,10021,5033,19619,4874,7050,12073,1,195302,284,-14721,14477,-2192,-5100,0.781208,0.001136,-0.058884,0.057908,-0.008768,-0.0204,-4
260,30000,1,1,1,24,-1,-1,-1,-1,-1,-1,9280,2643,3415,2250,2486,844,2643,3415,2250,2486,844,0,1,6637,-772,1165,-236,1642,844,0.22123333333333334,-0.025733333333333334,0.03883333333333333,-0.007866666666666666,0.054733333333333335,0.028133333333333333,-6
261,70000,1,2,2,24,0,0,2,2,2,2,41485,44697,47229,47956,47056,49565,4200,3600,1800,0,3308,2500,0,37285,41097,45429,47956,43748,47065,0.5326428571428572,0.5871,0.6489857142857143,0.6850857142857143,0.6249714285714286,0.6723571428571429,8
262,20000,0,2,2,34,0,0,0,2,0,0,17676,17650,18740,18373,18768,19315,2000,2500,1000,1000,1000,2000,0,15676,15150,17740,17373,17768,17315,0.7838,0.7575,0.887,0.86865,0.8884,0.86575,2
263,170000,1,2,1,29,0,0,0,0,0,0,79091,62575,63317,63903,43505,43995,2235,2493,2585,1683,1901,2111,1,76856,60082,60732,62220,41604,41884,0.4520941176470588,0.3534235294117647,0.3572470588235294,0.366,0.2447294117647059,0.2463764705882353,0
264,50000,1,3,2,50,-2,-2,-2,-1,0,0,48781,50283,51400,9463,9661,9854,2283,2400,9463,350,353,365,0,46498,47883,41937,9113,9308,9489,0.92996,0.95766,0.83874,0.18226,0.18616,0.18978,-7
265,30000,0,1,1,33,0,0,0,0,0,0,28700,28639,30171,29322,28572,0,1800,2300,1508,1000,0,0,1,26900,26339,28663,28322,28572,0,0.8966666666666666,0.8779666666666667,0.9554333333333334,0.9440666666666667,0.9524,0.0,0
266,110000,0,1,1,46,0,0,0,0,0,0,106111,108698,105666,57940,59247,59594,5015,4081,2101,2202,2204,2100,1,101096,104617,103565,55738,57043,57494,0.9190545454545455,0.9510636363636363,0.9415,0.5067090909090909,0.5185727272727273,0.5226727272727273,0
267,270000,0,2,2,31,1,2,2,2,2,0,16616,16911,14692,13907,10660,10683,2500,0,1000,0,2000,1000,0,14116,16911,13692,13907,8660,9683,0.052281481481481484,0.06263333333333333,0.05071111111111111,0.051507407407407405,0.032074074074074074,0.035862962962962965,9
268,50000,1,2,2,23,-1,-1,-1,-1,-1,-1,900,2757,4893,390,390,1670,3147,4893,390,390,1670,1890,0,-2247,-2136,4503,0,-1280,-220,-0.04494,-0.04272,0.09006,0.0,-0.0256,-0.0044,-6
269,240000,0,2,1,47,0,0,0,0,-1,-1,205495,236484,243567,44351,193283,21682,34700,11005,8006,202000,8505,377000,1,170795,225479,235561,-157649,184778,-355318,0.7116458333333333,0.9394958333333333,0.9815041666666666,-0.6568708333333333,0.7699083333333333,-1.4804916666666668,-2
270,20000,0,2,2,27,1,2,0,0,0,2,18649,18066,19040,19446,20759,20241,0,1594,1000,1606,0,300,0,18649,16472,18040,17840,20759,19941,0.93245,0.8236,0.902,0.892,1.03795,0.99705,5
271,620000,0,2,2,29,0,0,0,0,0,0,524191,524555,445543,443199,451040,431316,19306,15669,16011,16000,15500,17002,0,504885,508886,429532,427199,435540,414314,0.8143306451612903,0.820783870967742,0.6927935483870967,0.6890306451612903,0.7024838709677419,0.6682483870967741,0
272,130000,1,2,2,37,2,0,0,0,0,0,129677,131798,98083,92317,87375,87634,5940,4700,4433,3100,3300,3200,0,123737,127098,93650,89217,84075,84434,0.9518230769230769,0.9776769230769231,0.7203846153846154,0.6862846153846154,0.6467307692307692,0.6494923076923077,2
273,230000,0,2,2,50,1,2,0,0,0,0,23674,23027,24185,25238,29803,34312,0,2000,1435,5000,5000,6000,0,23674,21027,22750,20238,24803,28312,0.1029304347826087,0.09142173913043478,0.09891304347826087,0.0879913043478261,0.1078391304347826,0.12309565217391304,3
274,120000,1,2,1,27,0,0,-1,-1,-2,-2,50620,15000,100,0,0,0,1000,100,0,0,0,0,1,49620,14900,100,0,0,0,0.4135,0.12416666666666666,0.0008333333333333334,0.0,0.0,0.0,-6
275,180000,1,1,1,47,-1,-1,-1,-1,0,-1,807,4246,2727,5507,1382,538,4246,2727,5507,0,538,304,1,-3439,1519,-2780,5507,844,234,-0.019105555555555556,0.008438888888888888,-0.015444444444444445,0.030594444444444445,0.004688888888888889,0.0013,-5
276,340000,1,2,2,34,0,0,0,0,-1,-1,16462,12927,10814,7880,2338,0,1310,3011,5000,2338,0,0,0,15152,9916,5814,5542,2338,0,0.044564705882352944,0.02916470588235294,0.0171,0.0163,0.006876470588235294,0.0,-2
277,50000,0,2,2,29,1,2,0,0,0,0,49612,48546,49157,49890,48941,49940,0,1900,1333,0,999,0,0,49612,46646,47824,49890,47942,49940,0.99224,0.93292,0.95648,0.9978,0.95884,0.9988,3
278,150000,1,2,1,53,-1,-1,-1,-1,-1,-1,2337,5335,508,9634,3822,1769,5336,509,9636,3822,1779,1017,1,-2999,4826,-9128,5812,2043,752,-0.01999333333333333,0.03217333333333333,-0.060853333333333336,0.038746666666666665,0.01362,0.005013333333333333,-6
279,140000,1,2,2,26,0,0,0,0,0,0,182424,115115,120176,101065,64570,51521,10207,9120,3000,2117,2000,2000,0,172217,105995,117176,98948,62570,49521,1.2301214285714286,0.7571071428571429,0.8369714285714286,0.7067714285714286,0.44692857142857145,0.3537214285714286,0
280,390000,1,2,1,34,0,-1,-1,-1,-2,-2,1162,759,695,-448,-1228,-1228,759,699,115,712,0,235,1,403,60,580,-1160,-1228,-1463,0.0010333333333333334,0.00015384615384615385,0.0014871794871794872,-0.0029743589743589744,-0.003148717948717949,-0.0037512820512820514,-7
281,20000,0,3,2,47,-1,0,0,-2,-2,-1,3897,4774,-10,-10,-10,3990,1004,0,0,0,4000,2000,0,2893,4774,-10,-10,-4010,1990,0.14465,0.2387,-0.0005,-0.0005,-0.2005,0.0995,-6
282,80000,1,2,2,31,0,0,2,2,0,0,75953,81055,81587,78103,78335,78678,7000,3000,0,3000,3100,5900,0,68953,78055,81587,75103,75235,72778,0.8619125,0.9756875,1.0198375,0.9387875,0.9404375,0.909725,4
283,400000,1,1,1,35,-2,-2,-2,-2,-2,-1,10043,17883,9322,15693,5588,10161,18057,9368,15771,5616,10173,10077,1,-8014,8515,-6449,10077,-4585,84,-0.020035,0.0212875,-0.0161225,0.0251925,-0.0114625,0.00021,-11
284,340000,0,1,1,52,-2,-2,-2,-2,-2,-2,30832,33652,35192,30000,10766,33887,33670,35212,30000,10766,33905,30200,1,-2838,-1560,5192,19234,-23139,3687,-0.008347058823529412,-0.004588235294117647,0.015270588235294117,0.056570588235294116,-0.06805588235294117,0.010844117647058824,-12
285,50000,1,4,1,28,0,0,0,0,0,-2,9014,9608,12025,16025,0,0,3000,3000,4000,0,0,0,1,6014,6608,8025,16025,0,0,0.12028,0.13216,0.1605,0.3205,0.0,0.0,-2
286,20000,0,2,2,27,1,6,5,4,4,3,19388,18807,18235,18654,18073,17501,0,0,1000,0,0,0,0,19388,18807,17235,18654,18073,17501,0.9694,0.94035,0.86175,0.9327,0.90365,0.87505,23
287,210000,1,2,2,34,-1,-1,-1,-1,-1,-1,8547,2987,4571,3265,8623,5907,2996,4584,3274,8648,5924,15748,0,5551,-1597,1297,-5383,2699,-9841,0.026433333333333333,-0.007604761904761905,0.006176190476190477,-0.025633333333333334,0.012852380952380952,-0.046861904761904764,-6
288,20000,0,2,1,27,0,0,2,0,0,0,17062,19248,18181,18156,19102,17363,2850,0,514,2000,1000,1570,1,14212,19248,17667,16156,18102,15793,0.7106,0.9624,0.88335,0.8078,0.9051,0.78965,2
289,650000,1,3,2,39,0,0,-1,-1,-2,-1,5865,0,1904,-61,-261,13050,0,1904,0,0,13311,64731,0,5865,-1904,1904,-61,-13572,-51681,0.009023076923076924,-0.002929230769230769,0.002929230769230769,-9.384615384615384e-05,-0.02088,-0.07950923076923076,-5
290,450000,0,2,1,44,-1,-1,-1,-1,-1,-1,3004,5938,3700,14327,14890,6687,5971,3712,14347,14903,6707,25963,1,-2967,2226,-10647,-576,8183,-19276,-0.006593333333333333,0.004946666666666667,-0.02366,-0.00128,0.018184444444444444,-0.04283555555555556,-6
291,20000,1,1,2,29,-1,-1,-1,-1,-1,-1,342,792,677,-1,213,856,792,677,0,214,856,0,0,-450,115,677,-215,-643,856,-0.0225,0.00575,0.03385,-0.01075,-0.03215,0.0428,-6
292,470000,1,1,1,37,-2,-2,-2,-2,-2,-1,0,0,0,0,0,924,0,0,0,0,924,32673,1,0,0,0,0,-924,-31749,0.0,0.0,0.0,0.0,-0.0019659574468085107,-0.06755106382978723,-11
293,60000,1,2,2,27,0,0,0,0,0,0,41546,45025,38840,31965,30297,29814,5845,2000,1812,1037,1218,1085,0,35701,43025,37028,30928,29079,28729,0.5950166666666666,0.7170833333333333,0.6171333333333333,0.5154666666666666,0.48465,0.47881666666666667,0
294,50000,1,2,1,34,0,0,0,-1,-1,2,10745,8473,4390,19206,20486,15252,1200,1000,19206,1500,0,345,1,9545,7473,-14816,17706,20486,14907,0.1909,0.14946,-0.29632,0.35412,0.40972,0.29814,0
295,180000,1,3,2,33,1,-1,2,-1,-1,-2,0,199,199,580,0,0,199,0,580,0,0,0,0,-199,199,-381,580,0,0,-0.0011055555555555556,0.0011055555555555556,-0.002116666666666667,0.0032222222222222222,0.0,0.0,-2
296,300000,1,2,1,40,1,-2,-2,-2,-1,-1,0,0,0,0,280,0,0,0,0,280,0,0,1,0,0,0,-280,280,0,0.0,0.0,0.0,-0.0009333333333333333,0.0009333333333333333,0.0,-7
297,20000,0,2,1,33,0,0,0,-2,-2,-2,2508,3448,-202,-202,950,0,1000,202,0,1152,0,1000,1,1508,3246,-202,-1354,950,-1000,0.0754,0.1623,-0.0101,-0.0677,0.0475,-0.05,-6
298,290000,1,2,2,43,-1,0,0,0,0,0,170373,168738,103299,104583,106447,104045,5007,3500,3500,4000,4000,5000,0,165366,165238,99799,100583,102447,99045,0.5702275862068965,0.5697862068965517,0.3441344827586207,0.34683793103448274,0.35326551724137933,0.3415344827586207,-1
299,50000,0,1,2,23,1,-2,-2,-2,-2,-1,0,0,0,0,0,19553,0,0,0,0,19553,389,0,0,0,0,0,-19553,19164,0.0,0.0,0.0,0.0,-0.39106,0.38328,-8
300,170000,1,1,2,25,0,0,0,-1,0,0,8046,6130,3653,32511,24814,25293,1085,1000,32517,1023,10000,5000,0,6961,5130,-28864,31488,14814,20293,0.04094705882352941,0.030176470588235294,-0.16978823529411766,0.1852235294117647,0.08714117647058824,0.11937058823529412,-1
301,230000,1,2,2,28,0,0,2,2,2,2,185399,198941,201358,204067,200720,212403,18150,7200,7500,0,15079,8000,0,167249,191741,193858,204067,185641,204403,0.7271695652173913,0.8336565217391304,0.8428608695652174,0.8872478260869565,0.8071347826086956,0.8887086956521739,8
302,130000,1,3,2,39,0,0,0,2,0,0,133825,134495,133745,130814,130758,123468,7500,10000,0,4500,4500,4179,0,126325,124495,133745,126314,126258,119289,0.9717307692307692,0.9576538461538462,1.0288076923076923,0.9716461538461538,0.9712153846153846,0.9176076923076923,2
303,230000,1,2,1,40,0,0,0,0,0,0,44948,45198,46244,47595,38367,35098,1728,3000,3040,3012,3000,3000,1,43220,42198,43204,44583,35367,32098,0.18791304347826088,0.1834695652173913,0.18784347826086956,0.1938391304347826,0.1537695652173913,0.13955652173913044,0
304,210000,0,2,2,33,0,0,0,0,0,0,155847,156084,177865,89227,90027,93076,6000,5896,4800,3500,5000,4000,0,149847,150188,173065,85727,85027,89076,0.7135571428571429,0.7151809523809524,0.8241190476190476,0.40822380952380954,0.4048904761904762,0.4241714285714286,0
305,450000,1,2,1,42,0,0,0,0,0,0,7669,13267,18748,24711,33111,50885,7272,8764,9823,11123,20274,5374,1,397,4503,8925,13588,12837,45511,0.0008822222222222222,0.010006666666666667,0.019833333333333335,0.030195555555555555,0.028526666666666665,0.10113555555555556,0
306,170000,0,3,1,31,2,0,0,0,0,0,170485,229805,167524,185414,121092,117320,8000,8000,5000,5000,4500,5000,1,162485,221805,162524,180414,116592,112320,0.9557941176470588,1.304735294117647,0.9560235294117647,1.0612588235294118,0.6858352941176471,0.6607058823529411,2
307,170000,0,1,2,27,0,0,2,2,2,2,133149,138769,145050,146641,149603,157601,11936,13314,5801,5800,11000,1000,0,121213,125455,139249,140841,138603,156601,0.7130176470588235,0.7379705882352942,0.8191117647058823,0.8284764705882353,0.8153117647058824,0.9211823529411765,8
308,80000,1,2,2,24,-2,-2,-1,-1,-1,-1,1138,800,179,1755,0,1190,804,179,1755,0,1190,0,0,334,621,-1576,1755,-1190,1190,0.004175,0.0077625,-0.0197,0.0219375,-0.014875,0.014875,-8
309,70000,0,1,2,29,1,2,0,0,0,0,71267,67401,63239,23163,41106,42021,5,2910,1000,20000,1600,2000,0,71262,64491,62239,3163,39506,40021,1.0180285714285715,0.9213,0.8891285714285714,0.04518571428571429,0.5643714285714285,0.5717285714285715,3
310,220000,0,1,1,37,-1,-1,-1,0,-1,-1,8821,17039,7113,9574,1727,4201,20059,7540,9571,1739,4918,0,1,-11238,9499,-2458,7835,-3191,4201,-0.05108181818181818,0.043177272727272724,-0.011172727272727273,0.03561363636363636,-0.014504545454545454,0.019095454545454544,-5
311,50000,1,2,1,51,0,0,2,2,3,2,44664,48028,46985,50484,50404,50241,4110,0,4600,1000,2000,0,1,40554,48028,42385,49484,48404,50241,0.81108,0.96056,0.8477,0.98968,0.96808,1.00482,9
312,30000,1,2,1,31,1,2,0,0,2,0,20494,19867,21045,24681,23985,25099,0,1500,4000,0,1500,6000,1,20494,18367,17045,24681,22485,19099,0.6831333333333334,0.6122333333333333,0.5681666666666667,0.8227,0.7495,0.6366333333333334,5
313,110000,1,1,2,29,-1,-1,-1,-1,-1,-1,316,31895,316,316,316,31775,31895,316,316,316,31775,1152,0,-31579,31579,0,0,-31459,30623,-0.28708181818181816,0.28708181818181816,0.0,0.0,-0.2859909090909091,0.2783909090909091,-6
314,80000,1,2,1,44,0,0,0,0,0,0,47102,24470,25614,21053,18531,19051,1473,1617,856,672,828,910,1,45629,22853,24758,20381,17703,18141,0.5703625,0.2856625,0.309475,0.2547625,0.2212875,0.2267625,0
315,340000,1,1,1,36,0,0,0,0,0,0,185268,326074,276519,251815,218706,165666,160444,10143,7190,6283,5208,4177,1,24824,315931,269329,245532,213498,161489,0.07301176470588236,0.9292088235294118,0.7921441176470588,0.7221529411764706,0.627935294117647,0.47496764705882355,0
316,140000,0,2,2,25,2,0,0,0,0,0,142697,137269,133767,120287,117183,119575,5010,6377,5604,4160,8239,0,0,137687,130892,128163,116127,108944,119575,0.9834785714285714,0.9349428571428572,0.91545,0.8294785714285714,0.7781714285714286,0.8541071428571428,2
317,20000,0,2,1,53,0,0,2,2,-2,-1,19646,20077,19462,0,0,150,3000,30,0,0,150,850,1,16646,20047,19462,0,-150,-700,0.8323,1.00235,0.9731,0.0,-0.0075,-0.035,1
318,20000,1,2,3,30,1,2,2,2,0,0,17836,17246,19381,18772,19145,19545,0,2921,0,685,708,700,0,17836,14325,19381,18087,18437,18845,0.8918,0.71625,0.96905,0.90435,0.92185,0.94225,7
319,240000,0,2,1,33,1,2,2,0,0,2,172618,174842,141471,39578,46489,45632,6765,0,2000,7592,0,140000,1,165853,174842,139471,31986,46489,-94368,0.6910541666666666,0.7285083333333333,0.5811291666666667,0.133275,0.19370416666666668,-0.3932,7
320,180000,1,3,2,27,-1,-1,-1,-1,-1,-1,3578,3898,0,715,4079,0,3898,0,715,6942,0,213,0,-320,3898,-715,-6227,4079,-213,-0.0017777777777777779,0.021655555555555556,-0.0039722222222222225,-0.03459444444444444,0.02266111111111111,-0.0011833333333333333,-6
321,370000,0,1,2,31,0,0,0,0,0,0,35605,39837,41576,44178,47838,54341,5000,3000,5000,5000,8000,10000,0,30605,36837,36576,39178,39838,44341,0.08271621621621622,0.09955945945945946,0.09885405405405405,0.10588648648648649,0.10767027027027028,0.11984054054054054,0
322,260000,1,1,1,31,0,0,-1,0,0,0,33142,34048,55117,57782,184810,171006,2000,56714,4100,160000,7000,7000,1,31142,-22666,51017,-102218,177810,164006,0.11977692307692307,-0.08717692307692308,0.19621923076923076,-0.39314615384615387,0.6838846153846154,0.6307923076923077,-1
323,170000,1,1,2,32,-1,-1,-1,-1,-1,-1,13880,6367,9351,22222,20437,8744,6593,9361,22222,20437,8744,3620,0,7287,-2994,-12871,1785,11693,5124,0.042864705882352944,-0.017611764705882355,-0.07571176470588235,0.0105,0.06878235294117648,0.030141176470588234,-6
324,20000,1,2,2,28,2,2,0,0,0,0,24611,18920,13124,18859,19828,36666,0,1200,7500,1015,15000,0,0,24611,17720,5624,17844,4828,36666,1.23055,0.886,0.2812,0.8922,0.2414,1.8333,4
325,50000,0,1,2,48,0,0,0,-1,0,0,56672,53540,53321,49263,29063,26644,2500,1066,50045,992,1000,1000,0,54172,52474,3276,48271,28063,25644,1.08344,1.04948,0.06552,0.96542,0.56126,0.51288,-1
326,90000,0,3,1,45,0,0,0,0,0,0,13366,14394,16044,16080,16569,16744,1250,1900,600,747,599,775,1,12116,12494,15444,15333,15970,15969,0.13462222222222223,0.13882222222222224,0.1716,0.17036666666666667,0.17744444444444443,0.17743333333333333,0
327,250000,1,2,2,31,-2,-2,-2,-2,-1,2,1242,0,0,0,3394,3244,0,0,0,3394,0,37895,0,1242,0,0,-3394,3394,-34651,0.004968,0.0,0.0,-0.013576,0.013576,-0.138604,-7
328,200000,1,2,2,28,1,2,2,2,2,2,171468,167214,180484,176111,184620,189518,0,16000,0,13000,8000,0,0,171468,151214,180484,163111,176620,189518,0.85734,0.75607,0.90242,0.815555,0.8831,0.94759,11
329,400000,0,1,1,44,-1,-1,-1,-1,-1,-1,4482,-10,1903,850,808,775,0,1913,850,808,775,380,1,4482,-1923,1053,42,33,395,0.011205,-0.0048075,0.0026325,0.000105,8.25e-05,0.0009875,-6
330,270000,1,2,1,27,1,2,0,0,0,0,253072,247521,253024,258109,243331,247504,0,11000,11000,8900,9000,9200,1,253072,236521,242024,249209,234331,238304,0.9373037037037037,0.8760037037037037,0.8963851851851852,0.9229962962962963,0.8678925925925925,0.8826074074074074,3
331,180000,1,3,1,37,0,0,0,0,0,0,165369,125084,119946,114977,88757,84936,4402,4971,4750,2997,3133,3180,1,160967,120113,115196,111980,85624,81756,0.8942611111111111,0.6672944444444444,0.6399777777777778,0.6221111111111111,0.4756888888888889,0.4542,0
332,140000,1,1,2,27,-1,-1,-2,-2,-2,-2,390,0,0,0,0,0,0,0,0,0,0,2943,0,390,0,0,0,0,-2943,0.002785714285714286,0.0,0.0,0.0,0.0,-0.021021428571428573,-10
333,150000,1,3,1,57,-1,-1,-1,-1,-1,-1,5483,9136,17348,6456,12256,8156,9136,17348,6456,12256,8156,5256,1,-3653,-8212,10892,-5800,4100,2900,-0.024353333333333334,-0.054746666666666666,0.07261333333333334,-0.03866666666666667,0.027333333333333334,0.019333333333333334,-6
334,230000,0,1,2,34,-1,-1,0,0,0,0,23396,25723,49223,66006,47412,29290,25748,30029,27417,1016,640,260,0,-2352,-4306,21806,64990,46772,29030,-0.010226086956521739,-0.018721739130434782,0.09480869565217391,0.28256521739130436,0.20335652173913044,0.12621739130434784,-2
335,360000,1,1,2,28,0,0,-2,-1,0,-1,5446,-8,-8,4635,3875,1034,0,0,4643,1019,1039,984,0,5446,-8,-4651,3616,2836,50,0.015127777777777778,-2.2222222222222223e-05,-0.012919444444444445,0.010044444444444444,0.007877777777777777,0.0001388888888888889,-4
336,50000,1,2,1,41,0,0,0,0,0,0,25395,26421,27741,27982,28589,29157,1440,1760,1001,1057,1063,5699,1,23955,24661,26740,26925,27526,23458,0.4791,0.49322,0.5348,0.5385,0.55052,0.46916,0
337,230000,0,1,2,33,0,0,0,0,0,0,57171,56150,57074,50670,50652,51267,2100,2300,2000,2000,2000,2000,0,55071,53850,55074,48670,48652,49267,0.2394391304347826,0.2341304347826087,0.23945217391304346,0.2116086956521739,0.2115304347826087,0.21420434782608697,0
338,30000,0,2,2,22,3,2,2,2,2,3,26061,25349,27826,27080,30525,29764,0,3200,0,3900,0,0,0,26061,22149,27826,23180,30525,29764,0.8687,0.7383,0.9275333333333333,0.7726666666666666,1.0175,0.9921333333333333,14
339,300000,1,2,2,27,0,0,0,0,0,-1,15024,12128,9775,7347,4026,4851,1200,1164,1069,81,4851,3333,0,13824,10964,8706,7266,-825,1518,0.04608,0.036546666666666665,0.02902,0.02422,-0.00275,0.00506,-1
340,240000,0,3,2,40,0,0,0,0,0,0,245311,237034,242807,226872,233115,239229,8491,9600,8896,10690,223765,9395,0,236820,227434,233911,216182,9350,229834,0.98675,0.9476416666666667,0.9746291666666667,0.9007583333333333,0.03895833333333333,0.9576416666666666,0
341,230000,1,2,2,30,0,0,0,0,0,0,149775,107052,231164,120523,117102,116718,10000,130223,9953,4014,3307,4100,0,139775,-23171,221211,116509,113795,112618,0.6077173913043479,-0.10074347826086956,0.9617869565217392,0.5065608695652174,0.49476086956521736,0.48964347826086957,0
342,80000,0,1,2,25,-2,-2,-2,-2,-2,-2,0,0,0,0,0,150,0,0,0,30000,150,657,0,0,0,0,-30000,-150,-507,0.0,0.0,0.0,-0.375,-0.001875,-0.0063375,-12
343,20000,0,3,2,26,0,0,-2,-2,-2,-2,16320,0,0,0,0,0,0,0,0,0,0,0,0,16320,0,0,0,0,0,0.816,0.0,0.0,0.0,0.0,0.0,-8
344,190000,1,1,2,38,0,0,0,0,0,0,77720,79417,81326,81650,83354,85163,3774,3799,2874,2970,3138,3054,0,73946,75618,78452,78680,80216,82109,0.38918947368421053,0.3979894736842105,0.4129052631578947,0.41410526315789475,0.4221894736842105,0.43215263157894734,0
345,170000,0,2,2,41,-2,-2,-2,-2,-1,-1,6175,7404,7829,2218,3972,3643,7417,7862,2218,4866,3643,2732,0,-1242,-458,5611,-2648,329,911,-0.007305882352941177,-0.0026941176470588234,0.03300588235294118,-0.015576470588235294,0.001935294117647059,0.005358823529411765,-10
346,50000,1,1,2,28,0,0,0,0,0,0,48782,47708,49846,49303,29722,29624,2100,3600,2146,1004,1100,1294,0,46682,44108,47700,48299,28622,28330,0.93364,0.88216,0.954,0.96598,0.57244,0.5666,0
347,30000,1,3,1,32,0,-1,-1,-1,0,-1,28701,26108,17595,24715,22136,22738,27078,17648,25008,509,22806,10035,1,1623,8460,-7413,24206,-670,12703,0.0541,0.282,-0.2471,0.8068666666666666,-0.022333333333333334,0.42343333333333333,-4
348,550000,0,2,2,33,-2,-2,-2,-2,-2,-2,-509,-1925,4532,13069,5071,8276,15,10014,20000,10000,10000,7548,0,-524,-11939,-15468,3069,-4929,728,-0.0009527272727272727,-0.021707272727272728,-0.028123636363636365,0.00558,-0.008961818181818182,0.0013236363636363636,-12
349,70000,1,1,2,25,2,0,0,0,0,0,5730,7625,9484,11317,13125,14742,2000,2000,2000,2000,2000,2000,0,3730,5625,7484,9317,11125,12742,0.053285714285714283,0.08035714285714286,0.10691428571428571,0.1331,0.15892857142857142,0.18202857142857143,2
350,180000,1,2,1,46,1,-2,-2,-2,-2,-2,0,0,0,0,0,0,0,0,0,0,0,0,1,0,0,0,0,0,0,0.0,0.0,0.0,0.0,0.0,0.0,-9
351,370000,1,2,1,47,-2,-2,-2,-2,-2,-2,1289,2408,395,12074,744,4040,2432,397,12133,747,4060,3059,1,-1143,2011,-11738,11327,-3316,981,-0.003089189189189189,0.0054351351351351355,-0.03172432432432432,0.030613513513513515,-0.008962162162162161,0.0026513513513513514,-12
352,360000,1,1,2,26,0,0,0,0,0,-1,23411,27796,30400,33100,180000,196,4796,3400,3100,146900,196,2963,0,18615,24396,27300,-113800,179804,-2767,0.051708333333333335,0.06776666666666667,0.07583333333333334,-0.3161111111111111,0.49945555555555554,-0.0076861111111111114,-1
353,20000,0,3,2,24,4,3,2,0,0,0,20569,19927,16371,17291,18001,18706,0,0,1500,1000,1000,836,0,20569,19927,14871,16291,17001,17870,1.02845,0.99635,0.74355,0.81455,0.85005,0.8935,9
354,290000,1,2,1,34,0,0,0,0,0,0,16196,17220,18231,18593,18986,19967,1292,1303,665,692,1300,636,1,14904,15917,17566,17901,17686,19331,0.05139310344827586,0.05488620689655172,0.06057241379310345,0.06172758620689655,0.06098620689655172,0.06665862068965517,0
355,140000,1,2,2,36,0,0,2,2,0,0,134783,142708,143475,136331,135778,135910,12800,5000,0,5100,5000,5000,0,121983,137708,143475,131231,130778,130910,0.8713071428571428,0.9836285714285714,1.0248214285714285,0.9373642857142858,0.9341285714285714,0.9350714285714286,4
356,280000,1,2,1,64,0,0,2,0,0,0,22715,37818,35497,30164,7164,7164,15506,17,3364,0,0,0,1,7209,37801,32133,30164,7164,7164,0.025746428571428573,0.13500357142857142,0.11476071428571429,0.10772857142857142,0.025585714285714285,0.025585714285714285,2
357,50000,1,1,2,25,0,0,2,2,2,2,25008,27790,27059,29505,29824,29209,3200,0,2900,1100,0,2400,0,21808,27790,24159,28405,29824,26809,0.43616,0.5558,0.48318,0.5681,0.59648,0.53618,8
358,50000,1,2,2,24,0,0,0,0,0,0,50649,50607,49903,41083,29635,30261,1905,1801,1468,1043,1085,1193,0,48744,48806,48435,40040,28550,29068,0.97488,0.97612,0.9687,0.8008,0.571,0.58136,0
359,150000,1,3,2,58,2,0,0,0,0,0,152767,152319,120458,98302,69424,70906,6251,5000,3903,2500,2600,2600,0,146516,147319,116555,95802,66824,68306,0.9767733333333334,0.9821266666666667,0.7770333333333334,0.63868,0.44549333333333335,0.45537333333333335,2
360,20000,0,1,2,24,0,-1,-1,-1,-1,-1,3395,2296,396,396,8972,3984,2296,396,396,8972,3984,396,0,1099,1900,0,-8576,4988,3588,0.05495,0.095,0.0,-0.4288,0.2494,0.1794,-5
361,360000,0,4,1,34,0,-1,-1,-1,0,-1,30447,9428,11704,19036,41147,53733,10052,11767,20036,22207,54981,2227,1,20395,-2339,-8332,-3171,-13834,51506,0.05665277777777778,-0.006497222222222222,-0.023144444444444443,-0.008808333333333333,-0.038427777777777776,0.1430722222222222,-4
362,230000,1,1,1,32,-2,-2,-2,-2,-2,-2,700,1428,600,0,0,0,1428,600,0,0,0,0,1,-728,828,600,0,0,0,-0.003165217391304348,0.0036,0.0026086956521739132,0.0,0.0,0.0,-12
363,410000,0,2,2,30,-2,-2,-2,-2,-2,-2,7011,9173,7259,8430,5130,5064,9222,8036,8542,5155,5089,18270,0,-2211,1137,-1283,3275,41,-13206,-0.005392682926829268,0.0027731707317073173,-0.0031292682926829267,0.00798780487804878,0.0001,-0.03220975609756097,-12
364,120000,1,1,2,26,0,0,0,0,0,0,43629,56933,54724,32400,9207,5828,25000,45000,5151,2000,5000,9115,0,18629,11933,49573,30400,4207,-3287,0.15524166666666667,0.09944166666666666,0.41310833333333336,0.25333333333333335,0.03505833333333333,-0.02739166666666667,0
365,20000,0,2,2,27,1,-2,-2,-2,-2,-2,0,0,0,0,0,0,0,0,0,0,0,0,0,0,0,0,0,0,0,0.0,0.0,0.0,0.0,0.0,0.0,-9
366,50000,1,1,2,24,0,0,0,0,0,0,40246,41679,41688,32806,18609,19793,2128,3000,6000,1000,1500,705,0,38118,38679,35688,31806,17109,19088,0.76236,0.77358,0.71376,0.63612,0.34218,0.38176,0
367,50000,1,2,1,50,0,0,0,0,0,0,21956,20439,20691,17081,16234,16330,2000,1306,1206,1000,697,532,1,19956,19133,19485,16081,15537,15798,0.39912,0.38266,0.3897,0.32162,0.31074,0.31596,0
368,240000,1,1,1,43,-1,-1,-1,-1,-1,-1,7994,20487,27770,22920,4779,7640,20487,27783,22920,4952,7640,14003,1,-12493,-7296,4850,17968,-2861,-6363,-0.052054166666666665,-0.0304,0.02020833333333333,0.07486666666666666,-0.011920833333333334,-0.0265125,-6
369,30000,1,2,2,44,-2,-2,-2,-2,-2,-2,0,1330,2988,0,30000,0,1330,2988,0,30000,0,1219,0,-1330,-1658,2988,-30000,30000,-1219,-0.044333333333333336,-0.055266666666666665,0.0996,-1.0,1.0,-0.040633333333333334,-12
370,140000,0,2,2,41,0,0,0,0,0,0,144904,143827,141805,26141,7373,81185,10000,10000,5000,6000,76000,3000,0,134904,133827,136805,20141,-68627,78185,0.9636,0.9559071428571428,0.9771785714285715,0.14386428571428572,-0.49019285714285715,0.5584642857142857,0
371,20000,0,3,2,23,1,2,2,3,2,2,9126,8835,11088,10618,10304,11232,0,2400,0,0,1100,0,0,9126,6435,11088,10618,9204,11232,0.4563,0.32175,0.5544,0.5309,0.4602,0.5616,12
372,170000,1,1,2,28,1,-2,-2,-2,-2,-2,0,0,0,0,0,0,0,0,0,0,0,0,0,0,0,0,0,0,0,0.0,0.0,0.0,0.0,0.0,0.0,-9
373,50000,0,2,1,43,0,0,0,0,0,0,39722,40759,43096,44151,3361,3593,1700,3000,2350,1000,286,1000,1,38022,37759,40746,43151,3075,2593,0.76044,0.75518,0.81492,0.86302,0.0615,0.05186,0
374,90000,1,2,2,53,0,0,0,-2,-2,-1,30045,30000,0,0,0,439,1000,0,0,0,439,20959,0,29045,30000,0,0,-439,-20520,0.32272222222222224,0.3333333333333333,0.0,0.0,-0.004877777777777778,-0.228,-5
375,20000,1,1,1,32,2,2,2,2,2,2,11337,14372,11411,11653,7833,7945,6000,0,744,0,620,0,1,5337,14372,10667,11653,7213,7945,0.26685,0.7186,0.53335,0.58265,0.36065,0.39725,12
376,180000,1,2,1,39,2,2,2,2,2,0,177113,180628,176137,183007,179505,105229,7800,0,11700,0,3775,7000,1,169313,180628,164437,183007,175730,98229,0.9406277777777777,1.0034888888888889,0.9135388888888889,1.0167055555555555,0.9762777777777778,0.5457166666666666,10
377,30000,1,3,1,38,0,0,0,0,0,0,24505,25592,26628,27678,28084,30068,1800,1750,1800,1165,2600,1200,1,22705,23842,24828,26513,25484,28868,0.7568333333333334,0.7947333333333333,0.8276,0.8837666666666667,0.8494666666666667,0.9622666666666667,0
378,90000,0,2,1,50,0,0,0,0,0,0,85241,86576,86914,28698,29722,29400,3600,2196,1027,1486,588,352,1,81641,84380,85887,27212,29134,29048,0.9071222222222223,0.9375555555555556,0.9543,0.30235555555555554,0.3237111111111111,0.3227555555555556,0
379,90000,1,1,2,27,0,0,0,0,0,0,56754,58835,59461,60974,62339,63648,3000,2200,2500,2500,2500,2600,0,53754,56635,56961,58474,59839,61048,0.5972666666666666,0.6292777777777778,0.6329,0.6497111111111111,0.6648777777777778,0.6783111111111111,0
380,560000,0,1,2,40,0,0,0,0,0,0,487816,471138,454471,432132,285868,291140,15933,17065,14878,8505,9027,8527,0,471883,454073,439593,423627,276841,282613,0.8426482142857142,0.8108446428571429,0.7849875,0.7564767857142857,0.49435892857142855,0.5046660714285714,0
381,250000,1,2,1,40,0,0,0,0,-1,2,44930,137101,90801,0,1069,919,120041,4435,0,1069,0,67619,1,-75111,132666,90801,-1069,1069,-66700,-0.300444,0.530664,0.363204,-0.004276,0.004276,-0.2668,1
382,50000,1,1,2,23,-1,-1,2,-1,-1,-1,8225,2763,2545,1170,2480,8047,5308,0,1170,2480,8047,4428,0,2917,2763,1375,-1310,-5567,3619,0.05834,0.05526,0.0275,-0.0262,-0.11134,0.07238,-3
383,160000,1,3,1,34,-2,-2,-2,-2,-2,-2,717,594,1217,697,650,691,597,1223,700,653,691,17,1,120,-629,517,44,-41,674,0.00075,-0.00393125,0.00323125,0.000275,-0.00025625,0.0042125,-12
384,230000,1,2,1,28,-1,-1,0,0,0,0,1736,67982,72938,54105,18744,5148,68000,7064,4106,5075,1000,4080,1,-66264,60918,68832,49030,17744,1068,-0.28810434782608696,0.26486086956521737,0.2992695652173913,0.21317391304347827,0.07714782608695653,0.004643478260869565,-2
385,60000,0,2,2,51,0,0,0,0,0,0,27293,27898,28574,29059,29244,29462,1450,1516,1391,966,997,948,0,25843,26382,27183,28093,28247,28514,0.4307166666666667,0.4397,0.45305,0.46821666666666667,0.47078333333333333,0.47523333333333334,0
386,200000,1,1,1,48,-1,-1,-1,-1,-1,-1,657,0,2080,3567,0,1731,0,2080,3567,0,1731,1081,1,657,-2080,-1487,3567,-1731,650,0.003285,-0.0104,-0.007435,0.017835,-0.008655,0.00325,-6
387,150000,1,2,1,44,0,0,0,0,0,0,49716,50198,50543,50774,51074,50425,2000,1845,1772,1768,1808,1764,1,47716,48353,48771,49006,49266,48661,0.31810666666666665,0.3223533333333333,0.32514,0.32670666666666665,0.32844,0.3244066666666667,0
388,30000,1,3,2,50,-1,-1,2,-1,-1,-2,178,1860,940,1110,0,0,1860,0,1110,0,0,0,0,-1682,1860,-170,1110,0,0,-0.05606666666666667,0.062,-0.005666666666666667,0.037,0.0,0.0,-4
389,410000,1,1,1,44,-2,-2,-2,-2,-2,-2,-1,1733,-2506,-2506,-2506,-2506,1734,2506,0,0,0,0,1,-1735,-773,-2506,-2506,-2506,-2506,-0.004231707317073171,-0.0018853658536585366,-0.00611219512195122,-0.00611219512195122,-0.00611219512195122,-0.00611219512195122,-12
390,210000,1,3,1,40,0,0,0,0,0,0,201169,210942,214523,138786,140918,144099,16286,10011,5000,6000,6000,6000,1,184883,200931,209523,132786,134918,138099,0.8803952380952381,0.9568142857142857,0.9977285714285714,0.6323142857142857,0.6424666666666666,0.6576142857142857,0
391,20000,0,3,2,24,1,-2,-2,-2,-2,-2,-1400,-1400,-1400,-1000,-1000,0,0,0,1000,0,1000,0,0,-1400,-1400,-2400,-1000,-2000,0,-0.07,-0.07,-0.12,-0.05,-0.1,0.0,-9
392,150000,1,3,1,42,-1,-1,-1,-1,-1,0,11070,5947,6152,7306,18726,13839,6151,6427,7306,18738,0,7154,1,4919,-480,-1154,-11432,18726,6685,0.032793333333333334,-0.0032,-0.007693333333333333,-0.07621333333333333,0.12484,0.044566666666666664,-5
393,110000,1,1,2,25,1,2,2,0,0,0,60491,61874,56386,44181,35538,25417,3000,31,3000,1500,2000,1000,0,57491,61843,53386,42681,33538,24417,0.5226454545454545,0.5622090909090909,0.4853272727272727,0.3880090909090909,0.3048909090909091,0.22197272727272727,5
394,50000,0,2,2,25,0,0,2,2,4,3,28651,41897,43032,47242,46212,45205,14200,2100,5215,0,0,0,0,14451,39797,37817,47242,46212,45205,0.28902,0.79594,0.75634,0.94484,0.92424,0.9041,11
395,170000,0,1,1,53,0,0,0,0,0,0,17862,17927,18800,17647,18015,12930,1323,1196,544,563,629,361,1,16539,16731,18256,17084,17386,12569,0.09728823529411765,0.09841764705882353,0.10738823529411765,0.10049411764705882,0.10227058823529411,0.07393529411764706,0
396,260000,1,4,2,42,-1,-1,-1,-1,-1,-1,399,2101,577,0,200,0,2101,577,0,200,0,664,0,-1702,1524,577,-200,200,-664,-0.0065461538461538465,0.005861538461538461,0.0022192307692307693,-0.0007692307692307692,0.0007692307692307692,-0.002553846153846154,-6
397,60000,1,1,2,24,0,0,0,0,0,0,35138,35776,34783,32158,28991,28434,1553,2000,1508,1080,1003,1000,0,33585,33776,33275,31078,27988,27434,0.55975,0.5629333333333333,0.5545833333333333,0.5179666666666667,0.46646666666666664,0.4572333333333333,0
398,150000,0,2,1,37,0,0,0,0,0,0,147891,149402,148152,150781,146446,149658,5004,4957,4208,4201,4837,3500,1,142887,144445,143944,146580,141609,146158,0.95258,0.9629666666666666,0.9596266666666666,0.9772,0.94406,0.9743866666666666,0
399,140000,1,2,2,32,-1,-1,-1,-2,-1,-1,3003,3134,0,0,1186,0,3134,0,0,1186,0,1047,0,-131,3134,0,-1186,1186,-1047,-0.0009357142857142857,0.022385714285714287,0.0,-0.00847142857142857,0.00847142857142857,-0.007478571428571428,-7
400,20000,1,2,1,21,-1,0,0,0,2,0,17617,17540,25816,12957,9602,9357,1489,2302,2400,0,2000,3000,1,16128,15238,23416,12957,7602,6357,0.8064,0.7619,1.1708,0.64785,0.3801,0.31785,1
401,180000,1,2,1,36,2,2,2,2,2,0,172360,176867,179020,180773,128078,119632,9000,6600,7000,0,4500,4410,1,163360,170267,172020,180773,123578,115222,0.9075555555555556,0.9459277777777778,0.9556666666666667,1.0042944444444444,0.6865444444444444,0.6401222222222223,10
402,300000,1,2,2,47,0,0,0,0,0,0,225542,212958,195533,98158,66438,68863,7055,5536,5052,1794,5000,2000,0,218487,207422,190481,96364,61438,66863,0.72829,0.6914066666666666,0.6349366666666667,0.32121333333333335,0.20479333333333333,0.22287666666666667,0
403,180000,1,4,2,47,0,0,0,0,0,0,167915,163279,166994,150812,123957,55778,6028,7758,5188,4570,1876,1701,0,161887,155521,161806,146242,122081,54077,0.8993722222222222,0.8640055555555556,0.8989222222222222,0.8124555555555556,0.6782277777777778,0.3004277777777778,0
404,80000,0,2,1,31,0,0,0,0,0,0,78356,70664,62223,26400,27201,27363,2600,2036,1500,1201,1500,2000,1,75756,68628,60723,25199,25701,25363,0.94695,0.85785,0.7590375,0.3149875,0.3212625,0.3170375,0
405,160000,1,1,2,28,0,0,0,0,0,0,40854,41849,42889,43904,44777,45866,1676,1716,1731,1604,1812,1667,0,39178,40133,41158,42300,42965,44199,0.2448625,0.25083125,0.2572375,0.264375,0.26853125,0.27624375,0
406,80000,0,2,2,31,0,0,0,0,0,0,42188,40033,31106,28890,28613,49036,1577,1511,1415,1138,22000,1746,0,40611,38522,29691,27752,6613,47290,0.5076375,0.481525,0.3711375,0.3469,0.0826625,0.591125,0
407,50000,1,3,1,43,1,2,2,2,2,0,15214,14673,17621,17839,17257,17826,0,3200,800,0,1000,3800,1,15214,11473,16821,17839,16257,14026,0.30428,0.22946,0.33642,0.35678,0.32514,0.28052,9
408,360000,1,2,2,47,-2,-2,-2,-2,-2,-2,3899,6571,7486,24472,5935,4999,7148,8063,25217,6487,5000,0,0,-3249,-1492,-17731,17985,935,4999,-0.009025,-0.0041444444444444445,-0.04925277777777778,0.049958333333333334,0.002597222222222222,0.013886111111111111,-12
409,50000,1,1,2,23,0,0,0,0,0,-1,49061,47209,47471,21571,19005,772,2138,1400,431,380,772,8,0,46923,45809,47040,21191,18233,764,0.93846,0.91618,0.9408,0.42382,0.36466,0.01528,-1
410,140000,1,2,2,29,0,0,0,0,0,0,46605,35797,36615,28354,18093,6723,2281,1683,929,1000,134,0,0,44324,34114,35686,27354,17959,6723,0.3166,0.24367142857142857,0.2549,0.19538571428571427,0.12827857142857144,0.04802142857142857,0
411,180000,1,2,1,34,0,0,0,0,0,0,143301,146333,147042,127814,130331,132845,7000,5000,5000,4900,5000,5100,1,136301,141333,142042,122914,125331,127745,0.7572277777777778,0.7851833333333333,0.7891222222222222,0.6828555555555555,0.6962833333333334,0.7096944444444444,0
412,100000,1,3,1,29,1,-2,-2,-1,-1,-1,0,0,0,338,9448,1183,0,0,4838,9448,4183,1485,1,0,0,-4838,-9110,5265,-302,0.0,0.0,-0.04838,-0.0911,0.05265,-0.00302,-6
413,50000,0,2,1,35,0,0,0,0,0,0,22188,20501,22161,24784,26750,29632,2000,2000,3000,2700,3500,1000,1,20188,18501,19161,22084,23250,28632,0.40376,0.37002,0.38322,0.44168,0.465,0.57264,0
414,50000,0,1,2,30,4,3,2,2,2,2,37570,36705,37215,37718,38584,37829,0,1400,1400,1601,0,2500,0,37570,35305,35815,36117,38584,35329,0.7514,0.7061,0.7163,0.72234,0.77168,0.70658,15
415,500000,0,3,1,39,0,0,0,0,0,0,41597,50849,54927,57972,60224,71198,10000,4927,3972,3224,11980,5765,1,31597,45922,50955,54748,48244,65433,0.063194,0.091844,0.10191,0.109496,0.096488,0.130866,0
416,360000,0,1,2,35,-1,-1,-2,-2,-2,-2,2220,0,0,0,0,0,0,0,0,0,0,0,0,2220,0,0,0,0,0,0.006166666666666667,0.0,0.0,0.0,0.0,0.0,-10
417,150000,1,1,2,32,-1,-1,0,0,0,-1,1663,14045,13155,15183,11498,2392,14045,1030,5183,0,2392,7007,0,-12382,13015,7972,15183,9106,-4615,-0.08254666666666667,0.08676666666666667,0.05314666666666667,0.10122,0.060706666666666666,-0.030766666666666668,-3
418,80000,0,1,1,25,0,0,2,2,0,0,48470,52374,52889,51520,50741,50322,4700,2000,0,1800,1850,1800,1,43770,50374,52889,49720,48891,48522,0.547125,0.629675,0.6611125,0.6215,0.6111375,0.606525,4
419,110000,0,2,2,51,0,0,0,0,0,0,110950,69564,51264,51584,49601,50485,2500,2500,1800,1800,2000,2000,0,108450,67064,49464,49784,47601,48485,0.985909090909091,0.6096727272727273,0.4496727272727273,0.4525818181818182,0.43273636363636364,0.44077272727272726,0
420,210000,0,2,2,27,0,0,0,0,0,0,30365,29858,30713,27644,26236,26312,1606,2000,1200,1200,1000,1000,0,28759,27858,29513,26444,25236,25312,0.13694761904761904,0.13265714285714286,0.14053809523809524,0.12592380952380952,0.12017142857142857,0.12053333333333334,0
421,200000,1,2,1,35,1,-2,-2,-2,-2,-1,0,0,0,0,0,688,0,0,0,0,688,0,1,0,0,0,0,-688,688,0.0,0.0,0.0,0.0,-0.00344,0.00344,-8
422,80000,1,2,2,45,0,0,-2,-2,-2,-2,83150,-8000,0,0,0,0,0,8000,0,0,0,0,0,83150,-16000,0,0,0,0,1.039375,-0.2,0.0,0.0,0.0,0.0,-8
423,80000,1,2,1,24,-1,0,0,-1,-1,-2,1462,2472,0,492,0,0,1502,0,492,0,0,0,1,-40,2472,-492,492,0,0,-0.0005,0.0309,-0.00615,0.00615,0.0,0.0,-5
424,50000,0,2,2,36,0,0,0,0,-1,0,5916,6172,4123,680,978,978,1212,1200,0,978,0,0,0,4704,4972,4123,-298,978,978,0.09408,0.09944,0.08246,-0.00596,0.01956,0.01956,-1
425,20000,1,2,1,45,0,0,2,0,0,0,25102,27906,26153,26745,26359,25974,3550,0,2400,1000,1000,8000,1,21552,27906,23753,25745,25359,17974,1.0776,1.3953,1.18765,1.28725,1.26795,0.8987,2
426,120000,0,1,2,32,0,0,0,0,2,0,120792,87675,122177,120667,47880,49629,20137,50053,29377,0,30000,984,0,100655,37622,92800,120667,17880,48645,0.8387916666666667,0.31351666666666667,0.7733333333333333,1.0055583333333333,0.149,0.405375,2
427,20000,1,2,2,23,0,0,0,0,0,-1,17772,19058,19681,19507,14656,756,1877,1500,500,0,756,23750,0,15895,17558,19181,19507,13900,-22994,0.79475,0.8779,0.95905,0.97535,0.695,-1.1497,-1
428,20000,1,2,1,46,1,2,2,-1,0,-1,4426,2735,-211,1863,390,390,0,0,2253,0,390,1735,1,4426,2735,-2464,1863,0,-1345,0.2213,0.13675,-0.1232,0.09315,0.0,-0.06725,3
429,500000,1,1,2,29,0,0,0,0,2,2,201500,196051,161342,154127,149472,139130,10000,7031,10100,5663,0,4448,0,191500,189020,151242,148464,149472,134682,0.383,0.37804,0.302484,0.296928,0.298944,0.269364,4
430,500000,1,1,1,36,-2,-2,-2,-2,-2,-2,9241,10786,12376,12660,8000,20514,10786,12390,12692,8016,20514,16625,1,-1545,-1604,-316,4644,-12514,3889,-0.00309,-0.003208,-0.000632,0.009288,-0.025028,0.007778,-12
431,50000,1,2,1,25,0,0,0,0,0,0,59010,57593,56203,54794,53509,52021,2039,2015,2000,2100,2000,2100,1,56971,55578,54203,52694,51509,49921,1.13942,1.11156,1.08406,1.05388,1.03018,0.99842,0
432,500000,0,2,2,32,0,0,0,2,0,0,126599,132527,138945,142235,144959,148697,8000,8500,7000,7000,6000,15000,0,118599,124027,131945,135235,138959,133697,0.237198,0.248054,0.26389,0.27047,0.277918,0.267394,2
433,400000,0,1,2,37,-1,-1,-1,-1,-1,-1,1783,1251,629,0,303,219,1251,629,0,303,219,1640,0,532,622,629,-303,84,-1421,0.00133,0.001555,0.0015725,-0.0007575,0.00021,-0.0035525,-6
434,140000,0,1,2,32,0,0,0,0,2,0,90590,97047,102468,114718,111387,116399,8000,7000,15500,0,7000,7000,0,82590,90047,86968,114718,104387,109399,0.5899285714285715,0.6431928571428571,0.6212,0.8194142857142858,0.7456214285714285,0.7814214285714286,2
435,140000,0,2,2,24,-1,-1,-1,-1,-1,0,16343,1462,4326,6380,48866,23797,1462,4326,6398,48866,3500,2000,0,14881,-2864,-2072,-42486,45366,21797,0.10629285714285715,-0.020457142857142858,-0.0148,-0.30347142857142856,0.32404285714285713,0.15569285714285713,-5
436,80000,1,3,1,43,2,2,3,3,2,3,68152,71459,73690,71908,76294,74788,5000,4000,0,5700,0,0,1,63152,67459,73690,66208,76294,74788,0.7894,0.8432375,0.921125,0.8276,0.953675,0.93485,15
437,140000,1,2,1,37,0,0,0,0,0,0,127693,26633,28180,29702,31223,35683,2000,2000,2000,2000,5000,2000,1,125693,24633,26180,27702,26223,33683,0.8978071428571428,0.17595,0.187,0.19787142857142856,0.18730714285714287,0.24059285714285714,0
438,180000,0,2,2,28,0,0,0,0,0,0,139097,131157,128342,122345,109228,101428,5699,4300,4023,3785,3684,4000,0,133398,126857,124319,118560,105544,97428,0.7411,0.7047611111111111,0.6906611111111111,0.6586666666666666,0.5863555555555555,0.5412666666666667,0
439,80000,1,3,1,28,0,0,0,0,0,0,63900,65343,66171,58683,43421,44267,3000,2470,2228,1516,2000,1556,1,60900,62873,63943,57167,41421,42711,0.76125,0.7859125,0.7992875,0.7145875,0.5177625,0.5338875,0
440,360000,0,2,1,30,3,2,2,2,2,2,2500,2500,2500,2500,2500,0,0,0,0,0,0,0,1,2500,2500,2500,2500,2500,0,0.006944444444444444,0.006944444444444444,0.006944444444444444,0.006944444444444444,0.006944444444444444,0.0,13
441,350000,1,1,1,33,-2,-2,-2,-2,-2,-2,6016,4322,5568,9571,6370,9674,4348,5596,9632,6402,9722,24086,1,1668,-1274,-4064,3169,-3352,-14412,0.0047657142857142855,-0.00364,-0.011611428571428571,0.009054285714285714,-0.009577142857142857,-0.04117714285714286,-12
442,180000,1,2,2,35,0,0,0,-2,-2,-2,119333,123150,0,0,0,0,6000,0,0,0,0,0,0,113333,123150,0,0,0,0,0.6296277777777778,0.6841666666666667,0.0,0.0,0.0,0.0,-6
443,130000,0,1,2,27,-1,-1,0,-1,-1,-1,1439,3548,1958,1462,2573,2402,3555,1010,1466,2581,2509,3013,0,-2116,2538,492,-1119,64,-611,-0.016276923076923078,0.019523076923076924,0.0037846153846153845,-0.008607692307692308,0.0004923076923076923,-0.0047,-5
444,360000,0,1,1,44,-1,-1,-1,-1,-1,-1,18295,3199,6131,7662,19423,28351,3204,6195,7664,19423,28351,3250,1,15091,-2996,-1533,-11761,-8928,25101,0.04191944444444445,-0.008322222222222222,-0.004258333333333334,-0.032669444444444445,-0.0248,0.069725,-6
445,160000,0,2,2,26,-2,-2,-2,-2,-2,-2,1987,0,99500,-500,-500,-500,0,99500,0,0,0,0,0,1987,-99500,99500,-500,-500,-500,0.01241875,-0.621875,0.621875,-0.003125,-0.003125,-0.003125,-12
446,280000,1,2,2,27,1,-2,-2,-1,-1,-1,0,0,0,479,2463,1457,0,0,479,2477,1467,574,0,0,0,-479,-1998,996,883,0.0,0.0,-0.0017107142857142857,-0.007135714285714286,0.0035571428571428572,0.0031535714285714288,-6
447,20000,0,2,2,34,0,0,0,0,0,0,18351,17706,18831,18334,17280,15582,1304,1429,1608,346,312,318,0,17047,16277,17223,17988,16968,15264,0.85235,0.81385,0.86115,0.8994,0.8484,0.7632,0
448,170000,1,1,2,32,1,-2,-2,-2,-1,-1,0,0,0,0,500,500,0,0,0,500,500,500,0,0,0,0,-500,0,0,0.0,0.0,0.0,-0.0029411764705882353,0.0,0.0,-7
449,50000,1,2,2,32,1,-1,0,0,-1,-1,30382,45888,48599,-250,12122,3685,54608,7060,112,32132,11304,52681,0,-24226,38828,48487,-32382,818,-48996,-0.48452,0.77656,0.96974,-0.64764,0.01636,-0.97992,-2
450,60000,1,1,2,28,1,2,0,0,0,0,10540,10232,11237,11427,20973,31857,0,1483,673,10000,11540,7000,0,10540,8749,10564,1427,9433,24857,0.17566666666666667,0.14581666666666668,0.17606666666666668,0.023783333333333333,0.15721666666666667,0.41428333333333334,3
451,50000,1,2,1,30,-1,-1,-2,-2,-2,-2,1500,0,0,0,0,0,0,0,0,0,0,0,1,1500,0,0,0,0,0,0.03,0.0,0.0,0.0,0.0,0.0,-10
452,100000,0,1,2,41,0,0,0,0,0,0,31452,32453,33490,34926,35771,36366,1527,1564,2000,1426,1320,1333,0,29925,30889,31490,33500,34451,35033,0.29925,0.30889,0.3149,0.335,0.34451,0.35033,0
453,230000,1,1,2,28,0,0,0,0,0,0,45405,41630,38940,37150,36306,33563,2500,3013,4000,5006,3000,3000,0,42905,38617,34940,32144,33306,30563,0.18654347826086956,0.1679,0.15191304347826087,0.13975652173913045,0.1448086956521739,0.13288260869565216,0
454,10000,0,2,2,23,0,0,0,0,0,0,7545,7510,8583,9156,9727,8706,1500,1588,1274,1235,303,300,0,6045,5922,7309,7921,9424,8406,0.6045,0.5922,0.7309,0.7921,0.9424,0.8406,0
455,360000,1,1,2,30,-2,-2,-2,-2,-2,-2,2500,0,0,0,0,0,0,0,0,0,0,0,0,2500,0,0,0,0,0,0.006944444444444444,0.0,0.0,0.0,0.0,0.0,-12
456,60000,1,2,2,24,1,-2,-2,-2,-1,-1,0,0,0,0,150,560,0,0,0,150,560,1170,0,0,0,0,-150,-410,-610,0.0,0.0,0.0,-0.0025,-0.006833333333333334,-0.010166666666666666,-7
457,170000,1,1,2,28,-1,-1,-1,-1,-1,-1,3497,17920,2863,0,949,0,17920,2863,0,949,0,1069,0,-14423,15057,2863,-949,949,-1069,-0.08484117647058824,0.08857058823529412,0.016841176470588234,-0.005582352941176471,0.005582352941176471,-0.006288235294117647,-6
458,50000,0,3,1,49,0,0,0,2,0,0,10644,12163,14147,13626,15194,16929,2000,2500,0,2000,2000,2000,1,8644,9663,14147,11626,13194,14929,0.17288,0.19326,0.28294,0.23252,0.26388,0.29858,2
459,100000,1,2,1,52,2,2,2,2,0,0,94935,98462,100978,96606,92062,90228,6018,5000,0,6040,4000,15000,1,88917,93462,100978,90566,88062,75228,0.88917,0.93462,1.00978,0.90566,0.88062,0.75228,8
460,60000,1,1,2,32,1,2,-1,-1,-1,-1,31634,5720,18026,0,279,-101,0,18026,0,279,0,56839,0,31634,-12306,18026,-279,279,-56940,0.5272333333333333,-0.2051,0.30043333333333333,-0.00465,0.00465,-0.949,-1
461,290000,1,2,1,32,0,0,0,0,0,0,169108,170419,142264,101952,103174,105464,7118,5800,3792,4010,4276,3655,1,161990,164619,138472,97942,98898,101809,0.5585862068965517,0.5676517241379311,0.4774896551724138,0.3377310344827586,0.34102758620689655,0.3510655172413793,0
462,340000,1,1,2,40,0,-1,0,-1,-1,2,68616,6691,10961,8722,4776,2812,7355,10012,8740,4776,0,6000,0,61261,-3321,2221,3946,4776,-3188,0.1801794117647059,-0.00976764705882353,0.006532352941176471,0.011605882352941176,0.014047058823529412,-0.009376470588235293,-1
463,50000,0,2,3,48,2,2,2,2,2,0,42850,42850,45741,45694,45645,46457,1000,3900,1000,1000,1700,4500,0,41850,38950,44741,44694,43945,41957,0.837,0.779,0.89482,0.89388,0.8789,0.83914,10
464,20000,0,3,2,39,0,-1,0,-1,-1,-1,6530,8389,10090,3450,13030,9507,8389,5000,3450,13030,9507,19794,0,-1859,3389,6640,-9580,3523,-10287,-0.09295,0.16945,0.332,-0.479,0.17615,-0.51435,-4
465,50000,1,2,1,37,-1,-1,-1,-1,-2,-1,7465,2790,1323,156,-177,2406,2790,1323,156,2,2583,1581,1,4675,1467,1167,154,-2760,825,0.0935,0.02934,0.02334,0.00308,-0.0552,0.0165,-7
466,70000,1,1,2,27,0,0,0,0,0,0,70844,64697,65455,66247,65230,66685,3000,2400,3000,2400,2500,2500,0,67844,62297,62455,63847,62730,64185,0.9692,0.8899571428571429,0.8922142857142857,0.9121,0.8961428571428571,0.9169285714285714,0
467,140000,0,2,2,33,-2,-2,-2,-2,-2,-2,0,935,1490,0,3938,0,935,1490,0,3938,1160,0,0,-935,-555,1490,-3938,2778,0,-0.006678571428571429,-0.0039642857142857145,0.010642857142857143,-0.02812857142857143,0.01984285714285714,0.0,-12
468,380000,0,1,1,53,1,-1,-1,-1,-1,-1,0,767,4090,9471,1993,1164,767,4090,9476,1993,1164,3514,1,-767,-3323,-5386,7478,829,-2350,-0.002018421052631579,-0.008744736842105263,-0.014173684210526316,0.019678947368421053,0.002181578947368421,-0.0061842105263157894,-4
469,20000,0,2,2,27,3,2,0,0,0,-2,20771,19935,3110,2140,0,0,0,1000,100,2000,0,0,0,20771,18935,3010,140,0,0,1.03855,0.94675,0.1505,0.007,0.0,0.0,3
470,240000,1,2,1,31,-1,-1,-1,-1,-1,-1,184,0,2500,12500,749,2829,0,2500,12500,749,2829,2900,1,184,-2500,-10000,11751,-2080,-71,0.0007666666666666667,-0.010416666666666666,-0.041666666666666664,0.0489625,-0.008666666666666666,-0.00029583333333333333,-6
471,140000,1,3,1,50,-1,2,-1,-1,-1,-1,845,845,1690,0,1690,0,0,1690,0,1690,0,845,1,845,-845,1690,-1690,1690,-845,0.006035714285714286,-0.006035714285714286,0.012071428571428571,-0.012071428571428571,0.012071428571428571,-0.006035714285714286,-3
472,100000,0,2,1,42,0,0,0,0,2,0,56256,57685,58156,61103,59358,60060,3000,2688,5163,0,2358,2472,1,53256,54997,52993,61103,57000,57588,0.53256,0.54997,0.52993,0.61103,0.57,0.57588,2
473,30000,1,2,2,38,0,0,0,0,2,0,22070,23075,24124,27012,26279,26831,1676,1725,3613,0,975,980,0,20394,21350,20511,27012,25304,25851,0.6798,0.7116666666666667,0.6837,0.9004,0.8434666666666667,0.8617,2
474,140000,1,1,2,31,0,0,0,2,2,2,41314,42377,43923,43051,44109,43253,1732,2278,3000,1892,0,1572,0,39582,40099,40923,41159,44109,41681,0.28272857142857144,0.28642142857142855,0.2923071428571429,0.29399285714285717,0.31506428571428574,0.2977214285714286,6
475,180000,1,3,1,47,-1,-1,-1,-1,-1,-1,316,316,316,316,316,316,316,316,316,316,316,316,1,0,0,0,0,0,0,0.0,0.0,0.0,0.0,0.0,0.0,-6
476,180000,1,1,1,26,-1,-1,-1,-1,-1,-1,4745,5865,6059,5537,17366,16971,5865,6091,5537,17366,16971,2785,1,-1120,-226,522,-11829,395,14186,-0.006222222222222222,-0.0012555555555555555,0.0029,-0.06571666666666667,0.0021944444444444446,0.07881111111111111,-6
477,120000,1,1,2,34,0,0,0,0,0,0,67253,31954,16991,18730,21076,24134,1954,1991,3730,9076,4134,497,0,65299,29963,13261,9654,16942,23637,0.5441583333333333,0.24969166666666667,0.11050833333333333,0.08045,0.14118333333333333,0.196975,0
478,180000,1,1,2,33,2,-1,-1,-1,-1,-1,416,416,416,416,150,982,416,416,416,150,982,416,0,0,0,0,266,-832,566,0.0,0.0,0.0,0.0014777777777777777,-0.004622222222222222,0.0031444444444444445,-3
479,230000,1,2,2,27,0,0,0,0,0,0,73521,75691,77867,80957,83695,86184,4000,4000,5000,5000,4000,8000,0,69521,71691,72867,75957,79695,78184,0.30226521739130435,0.3117,0.3168130434782609,0.3302478260869565,0.3465,0.3399304347826087,0
480,60000,1,2,1,23,0,0,0,0,2,2,59408,58844,43427,30408,30632,30021,2230,2000,4300,1000,0,2000,1,57178,56844,39127,29408,30632,28021,0.9529666666666666,0.9474,0.6521166666666667,0.4901333333333333,0.5105333333333333,0.4670166666666667,4
481,30000,0,2,1,38,0,0,0,0,0,0,17085,19702,22978,23078,24994,25330,5000,5200,3078,5000,3000,5000,1,12085,14502,19900,18078,21994,20330,0.4028333333333333,0.4834,0.6633333333333333,0.6026,0.7331333333333333,0.6776666666666666,0
482,90000,1,2,1,47,-1,-1,-1,-1,-1,-1,1887,43542,12148,880,10880,880,43542,12148,880,10880,880,1080,1,-41655,31394,11268,-10000,10000,-200,-0.4628333333333333,0.3488222222222222,0.1252,-0.1111111111111111,0.1111111111111111,-0.0022222222222222222,-6
483,210000,1,3,1,40,0,0,0,0,0,0,160292,144217,123657,112910,97400,9806,3720,3229,3165,1979,9806,390,1,156572,140988,120492,110931,87594,9416,0.7455809523809523,0.6713714285714286,0.5737714285714286,0.5282428571428571,0.4171142857142857,0.04483809523809524,0
484,180000,1,1,2,29,0,0,0,0,0,0,35619,22745,12200,9531,10131,0,1745,1200,1531,3500,0,0,0,33874,21545,10669,6031,10131,0,0.18818888888888888,0.11969444444444445,0.05927222222222222,0.03350555555555555,0.05628333333333333,0.0,0
485,210000,0,1,2,29,-2,-2,-2,-2,-2,-2,0,0,1865,-3,-3,3677,0,1865,0,0,3680,0,0,0,-1865,1865,-3,-3683,3677,0.0,-0.008880952380952382,0.008880952380952382,-1.4285714285714285e-05,-0.017538095238095238,0.017509523809523808,-12
486,60000,1,2,2,23,0,0,0,2,0,0,22241,22719,25585,24053,17154,19316,2000,4000,0,2000,3000,0,0,20241,18719,25585,22053,14154,19316,0.33735,0.31198333333333333,0.42641666666666667,0.36755,0.2359,0.32193333333333335,2
487,260000,0,1,1,30,-1,-1,-1,0,0,-1,1131,291,582,291,0,291,291,582,0,0,130291,651,1,840,-291,582,291,-130291,-360,0.0032307692307692306,-0.0011192307692307693,0.0022384615384615386,0.0011192307692307693,-0.5011192307692308,-0.0013846153846153845,-4
488,70000,1,2,1,47,0,0,0,0,0,-2,136809,118811,52953,53696,11790,12045,3158,10000,2446,11790,430,423,1,133651,108811,50507,41906,11360,11622,1.9093,1.5544428571428572,0.7215285714285714,0.5986571428571429,0.16228571428571428,0.16602857142857144,-2
489,40000,0,1,1,47,2,2,2,2,2,2,10555,11084,12605,13102,12595,14386,1000,2000,1000,0,2000,0,1,9555,9084,11605,13102,10595,14386,0.238875,0.2271,0.290125,0.32755,0.264875,0.35965,12
490,440000,1,2,2,28,1,2,2,0,0,0,209176,215231,204369,186201,183518,148169,11000,54,7530,7648,6310,3312,0,198176,215177,196839,178553,177208,144857,0.4504,0.48903863636363637,0.44736136363636364,0.4058022727272727,0.4027454545454546,0.32922045454545457,5
491,290000,1,1,2,31,0,0,0,0,0,-1,44193,15950,15315,14199,9681,162,1380,1212,284,5000,162,380,0,42813,14738,15031,9199,9519,-218,0.14763103448275863,0.05082068965517241,0.05183103448275862,0.03172068965517241,0.03282413793103448,-0.0007517241379310345,-1
492,100000,1,2,1,47,-1,-1,-1,-1,-1,-2,6666,6666,0,6270,-396,-396,6666,0,6270,0,0,0,1,0,6666,-6270,6270,-396,-396,0.0,0.06666,-0.0627,0.0627,-0.00396,-0.00396,-7
493,80000,0,1,2,27,0,0,0,0,0,0,74640,72565,63342,51529,41484,34097,20024,10000,4000,2000,3000,2500,0,54616,62565,59342,49529,38484,31597,0.6827,0.7820625,0.741775,0.6191125,0.48105,0.3949625,0
494,100000,1,3,1,35,1,2,2,2,2,2,97002,102698,97997,103384,97266,101492,8200,0,8000,0,8600,0,1,88802,102698,89997,103384,88666,101492,0.88802,1.02698,0.89997,1.03384,0.88666,1.01492,11
495,130000,0,2,1,44,0,0,0,-1,-1,-2,139892,131365,9910,12909,0,0,6179,1969,131000,0,0,1700,1,133713,129396,-121090,12909,0,-1700,1.0285615384615385,0.9953538461538461,-0.9314615384615385,0.0993,0.0,-0.013076923076923076,-4
496,370000,0,2,1,38,2,0,0,0,0,0,376014,377594,355120,315740,322540,319195,16000,13217,12000,12000,12000,15000,1,360014,364377,343120,303740,310540,304195,0.9730108108108108,0.9848027027027026,0.9273513513513514,0.8209189189189189,0.8392972972972973,0.8221486486486487,2
497,50000,1,2,1,47,0,0,0,0,0,0,50732,50713,45549,40043,39844,39599,2000,2106,1600,1606,1581,2000,1,48732,48607,43949,38437,38263,37599,0.97464,0.97214,0.87898,0.76874,0.76526,0.75198,0
498,200000,0,1,1,36,0,0,2,2,2,0,2346,4802,4579,5840,5603,6352,2500,0,1500,0,1000,1000,1,-154,4802,3079,5840,4603,5352,-0.00077,0.02401,0.015395,0.0292,0.023015,0.02676,6
499,420000,1,1,1,39,0,0,0,0,0,0,298753,304964,312224,315822,275393,278745,13000,14000,11230,10000,8091,6965,1,285753,290964,300994,305822,267302,271780,0.6803642857142858,0.6927714285714286,0.7166523809523809,0.728147619047619,0.6364333333333333,0.6470952380952381,0
500,310000,0,1,2,36,-2,-2,-2,-2,-2,-1,17611,24122,26242,21026,18121,7842,10000,4000,0,0,7842,24003,0,7611,20122,26242,21026,10279,-16161,0.024551612903225807,0.06490967741935484,0.0846516129032258,0.0678258064516129,0.03315806451612903,-0.05213225806451613,-11
501,50000,0,2,2,23,0,0,-2,-2,-1,2,51550,0,0,0,15239,14853,0,0,0,15239,0,540,0,51550,0,0,-15239,15239,14313,1.031,0.0,0.0,-0.30478,0.30478,0.28626,-3
502,220000,0,1,1,45,-1,-1,-1,-1,-1,-1,3455,11997,5874,416,416,416,12001,5874,416,416,416,416,1,-8546,6123,5458,0,0,0,-0.038845454545454544,0.027831818181818183,0.02480909090909091,0.0,0.0,0.0,-6
503,100000,0,1,2,32,0,0,0,0,0,0,26127,26608,24689,25699,26809,25836,2000,2000,1700,1500,1500,1700,0,24127,24608,22989,24199,25309,24136,0.24127,0.24608,0.22989,0.24199,0.25309,0.24136,0
504,240000,1,3,1,35,0,0,0,0,0,0,238166,236686,186613,189470,119525,121178,8522,9100,8244,5000,5000,4011,1,229644,227586,178369,184470,114525,117167,0.95685,0.948275,0.7432041666666667,0.768625,0.4771875,0.48819583333333333,0
505,160000,1,3,1,44,0,-1,-1,2,2,2,6061,1594,2904,2313,2753,2191,2000,3037,0,1000,0,5000,1,4061,-1443,2904,1313,2753,-2809,0.02538125,-0.00901875,0.01815,0.00820625,0.01720625,-0.01755625,4
506,100000,1,2,1,48,2,2,2,0,0,0,44050,44508,42925,45596,46022,46785,1800,0,3548,1668,1677,1668,1,42250,44508,39377,43928,44345,45117,0.4225,0.44508,0.39377,0.43928,0.44345,0.45117,6
507,150000,1,1,2,35,-1,2,2,2,2,2,15349,12834,25740,20995,21353,14453,0,15600,0,758,0,2580,0,15349,-2766,25740,20237,21353,11873,0.10232666666666666,-0.01844,0.1716,0.13491333333333333,0.14235333333333333,0.07915333333333334,9
508,50000,1,2,1,37,2,2,2,0,0,0,40994,43594,38222,13026,13268,13497,5500,0,580,600,600,600,1,35494,43594,37642,12426,12668,12897,0.70988,0.87188,0.75284,0.24852,0.25336,0.25794,6
509,250000,0,2,1,32,-1,-1,-2,-1,0,0,79319,0,0,174749,171541,175042,0,0,174749,0,3501,146794,1,79319,0,-174749,174749,168040,28248,0.317276,0.0,-0.698996,0.698996,0.67216,0.112992,-5
510,100000,1,1,2,33,-2,-2,-2,-2,-2,-2,3417,7366,12146,752,5931,7855,7400,12146,752,5931,7855,3966,0,-3983,-4780,11394,-5179,-1924,3889,-0.03983,-0.0478,0.11394,-0.05179,-0.01924,0.03889,-12
511,180000,0,1,2,29,-1,-1,-1,-1,-1,-1,1124,18213,4390,1016,4745,0,18213,4390,1016,4745,0,0,0,-17089,13823,3374,-3729,4745,0,-0.09493888888888889,0.07679444444444444,0.018744444444444446,-0.020716666666666668,0.02636111111111111,0.0,-6
512,210000,1,3,1,54,0,0,0,0,0,0,94343,96278,98213,99763,99793,101879,3500,3500,4500,3600,3694,3728,1,90843,92778,93713,96163,96099,98151,0.4325857142857143,0.4418,0.44625238095238096,0.4579190476190476,0.4576142857142857,0.4673857142857143,0
513,90000,0,2,2,29,0,0,0,-2,-2,-2,70559,51550,0,0,0,0,3000,0,0,0,0,0,0,67559,51550,0,0,0,0,0.7506555555555555,0.5727777777777778,0.0,0.0,0.0,0.0,-6
514,140000,1,2,1,55,0,0,0,0,0,0,108038,110216,84516,72391,61298,62193,4200,2822,2336,2588,2250,2491,1,103838,107394,82180,69803,59048,59702,0.7417,0.7671,0.587,0.4985928571428571,0.4217714285714286,0.4264428571428571,0
515,380000,0,1,2,30,0,0,0,0,0,0,192132,148842,177842,120027,97256,108213,10123,50434,7132,11068,20050,35925,0,182009,98408,170710,108959,77206,72288,0.47897105263157896,0.25896842105263157,0.44923684210526316,0.2867342105263158,0.2031736842105263,0.19023157894736842,0
516,20000,0,3,1,52,2,2,2,2,-2,-2,8145,10474,10000,0,0,0,2474,0,0,0,0,0,1,5671,10474,10000,0,0,0,0.28355,0.5237,0.5,0.0,0.0,0.0,4
517,50000,0,1,2,32,0,0,0,2,0,0,13185,5070,6815,6068,7798,8511,1255,2000,0,2000,1000,500,0,11930,3070,6815,4068,6798,8011,0.2386,0.0614,0.1363,0.08136,0.13596,0.16022,2
518,80000,0,3,2,24,1,-1,-1,-1,-1,-1,0,832,416,416,416,416,1248,416,416,416,416,416,0,-1248,416,0,0,0,0,-0.0156,0.0052,0.0,0.0,0.0,0.0,-4
519,50000,0,2,2,25,0,0,-1,-1,-1,0,11014,11092,692,1184,24119,24027,1402,694,1186,34029,1002,1023,0,9612,10398,-494,-32845,23117,23004,0.19224,0.20796,-0.00988,-0.6569,0.46234,0.46008,-3
520,50000,1,2,2,22,0,0,0,0,0,0,18471,19483,19431,19307,19361,19738,1329,1307,683,857,856,834,0,17142,18176,18748,18450,18505,18904,0.34284,0.36352,0.37496,0.369,0.3701,0.37808,0
521,70000,1,1,2,25,0,0,0,0,0,0,71106,67954,68976,49145,49688,47780,3292,3290,1706,1759,1729,1717,0,67814,64664,67270,47386,47959,46063,0.9687714285714286,0.9237714285714286,0.961,0.6769428571428572,0.6851285714285714,0.6580428571428572,0
522,260000,1,3,1,52,1,2,0,0,0,0,9979,9371,18488,27022,28402,800,0,10000,11264,1580,2,1098,1,9979,-629,7224,25442,28400,-298,0.03838076923076923,-0.0024192307692307694,0.027784615384615383,0.09785384615384615,0.10923076923076923,-0.0011461538461538462,3
523,190000,0,2,1,32,1,2,2,2,2,0,13041,13936,13415,14590,14216,14823,1400,0,1400,0,1000,1000,1,11641,13936,12015,14590,13216,13823,0.061268421052631576,0.07334736842105263,0.06323684210526316,0.07678947368421053,0.06955789473684211,0.07275263157894737,9
524,720000,1,1,1,45,0,0,0,0,0,0,125529,112933,105582,104501,83504,79411,8019,8043,10092,3020,2591,10081,1,117510,104890,95490,101481,80913,69330,0.16320833333333334,0.14568055555555556,0.132625,0.14094583333333333,0.11237916666666667,0.09629166666666666,0
525,240000,1,1,2,29,2,0,0,2,0,0,32870,34015,38257,37607,40924,43546,2000,5000,0,4000,3000,10000,0,30870,29015,38257,33607,37924,33546,0.128625,0.12089583333333333,0.15940416666666668,0.14002916666666668,0.15801666666666667,0.139775,4
526,70000,1,2,2,26,0,0,2,0,0,0,28986,30609,31301,31980,32813,33614,2400,1500,1500,1500,1500,1500,0,26586,29109,29801,30480,31313,32114,0.3798,0.4158428571428571,0.42572857142857146,0.43542857142857144,0.4473285714285714,0.45877142857142855,2
527,330000,0,1,2,32,-2,-2,-2,-1,-1,-1,28106,1323,-363,137,4094,607,2701,363,513,4107,607,0,0,25405,960,-876,-3970,3487,607,0.07698484848484849,0.002909090909090909,-0.0026545454545454546,-0.01203030303030303,0.010566666666666667,0.0018393939393939393,-9
528,200000,0,2,1,33,-1,-1,-1,-1,-1,-1,3353,5341,5966,3348,5051,7128,5341,5966,3348,5061,7128,4722,1,-1988,-625,2618,-1713,-2077,2406,-0.00994,-0.003125,0.01309,-0.008565,-0.010385,0.01203,-6
529,280000,0,2,2,27,-2,-2,-2,-2,-2,-2,1566,2872,1572,2437,1572,1572,2891,1586,2444,1586,1579,1579,0,-1325,1286,-872,851,-7,-7,-0.0047321428571428575,0.0045928571428571425,-0.0031142857142857144,0.0030392857142857144,-2.5e-05,-2.5e-05,-12
530,80000,0,2,2,25,-2,-2,-2,-2,-2,-2,302,-62,1958,-101,15932,950,0,2020,0,16033,11220,0,0,302,-2082,1958,-16134,4712,950,0.003775,-0.026025,0.024475,-0.201675,0.0589,0.011875,-12
531,100000,1,2,2,26,0,0,-2,-2,-2,-1,9614,0,0,0,0,16708,0,0,0,0,16708,2000,0,9614,0,0,0,-16708,14708,0.09614,0.0,0.0,0.0,-0.16708,0.14708,-7
532,200000,1,1,2,25,0,0,0,0,0,-2,183516,179534,134572,61450,-200,-200,6700,7000,3000,0,0,0,0,176816,172534,131572,61450,-200,-200,0.88408,0.86267,0.65786,0.30725,-0.001,-0.001,-2
533,200000,1,4,1,39,-2,-2,-2,-2,-2,-2,500,0,0,0,0,0,0,0,0,0,0,0,1,500,0,0,0,0,0,0.0025,0.0,0.0,0.0,0.0,0.0,-12
534,50000,0,2,1,48,0,0,0,0,0,0,44338,43048,35639,18753,19091,19548,3629,3332,2000,2000,2000,2500,1,40709,39716,33639,16753,17091,17048,0.81418,0.79432,0.67278,0.33506,0.34182,0.34096,0
535,20000,0,2,2,30,0,-1,0,0,0,0,12755,832,2800,1231,1052,0,832,1000,900,500,0,0,0,11923,-168,1900,731,1052,0,0.59615,-0.0084,0.095,0.03655,0.0526,0.0,-1
536,100000,1,2,2,26,-1,-1,-1,-1,-1,-1,780,0,390,390,390,380,0,390,390,390,380,400,0,780,-390,0,0,10,-20,0.0078,-0.0039,0.0,0.0,0.0001,-0.0002,-6
537,50000,1,2,1,46,2,3,3,2,0,0,64350,63192,57205,54371,19946,17406,5000,0,0,613,573,593,1,59350,63192,57205,53758,19373,16813,1.187,1.26384,1.1441,1.07516,0.38746,0.33626,10
538,350000,1,1,2,44,1,2,2,2,2,-1,8651,8890,1772,1957,1807,11811,1871,7,1807,0,11811,5628,0,6780,8883,-35,1957,-10004,6183,0.01937142857142857,0.02538,-0.0001,0.005591428571428572,-0.028582857142857142,0.017665714285714285,8
539,210000,0,1,1,42,-1,-1,-1,-1,-1,-1,1729,1262,6867,2271,1054,1197,1315,6867,2271,1054,1197,701,1,414,-5605,4596,1217,-143,496,0.0019714285714285715,-0.02669047619047619,0.021885714285714286,0.0057952380952380955,-0.0006809523809523809,0.002361904761904762,-6
540,360000,0,1,1,39,0,0,-2,-2,-2,-2,12768,0,0,0,0,0,0,0,0,0,0,0,1,12768,0,0,0,0,0,0.03546666666666667,0.0,0.0,0.0,0.0,0.0,-8
541,680000,1,1,1,42,0,0,0,0,0,0,189514,188883,190076,181957,182226,177731,8000,9000,7000,7000,7000,7000,1,181514,179883,183076,174957,175226,170731,0.26693235294117645,0.26453382352941174,0.2692294117647059,0.25728970588235295,0.25768529411764707,0.251075,0
542,200000,0,2,1,33,0,0,0,2,-1,-1,57579,50612,10537,5552,2506,9443,5250,10023,27,2614,9454,5019,1,52329,40589,10510,2938,-6948,4424,0.261645,0.202945,0.05255,0.01469,-0.03474,0.02212,0
543,200000,0,1,2,27,-2,-2,-2,-2,-2,-2,2436,3458,758,-2,750,26903,5963,760,0,752,26983,599,0,-3527,2698,758,-754,-26233,26304,-0.017635,0.01349,0.00379,-0.00377,-0.131165,0.13152,-12
544,80000,1,1,2,30,0,0,0,0,0,0,44999,45843,46879,47799,48876,49909,2100,2100,2000,2000,2000,4500,0,42899,43743,44879,45799,46876,45409,0.5362375,0.5467875,0.5609875,0.5724875,0.58595,0.5676125,0
545,60000,1,2,1,27,0,0,0,0,0,0,54900,55948,55188,55960,56564,57464,1971,2000,2003,2003,2070,2140,1,52929,53948,53185,53957,54494,55324,0.88215,0.8991333333333333,0.8864166666666666,0.8992833333333333,0.9082333333333333,0.9220666666666667,0
546,240000,0,2,2,29,0,0,0,0,0,0,210522,224877,208870,107964,227939,232618,20000,8403,4978,220000,8638,8584,0,190522,216474,203892,-112036,219301,224034,0.7938416666666667,0.901975,0.84955,-0.46681666666666666,0.9137541666666666,0.933475,0
547,160000,0,2,2,32,0,0,0,0,0,0,22506,24135,25418,28196,29961,49404,2000,2000,3000,2000,20000,2000,0,20506,22135,22418,26196,9961,47404,0.1281625,0.13834375,0.1401125,0.163725,0.06225625,0.296275,0
548,260000,1,2,2,27,0,0,0,-1,-1,0,25419,19045,19270,11915,114479,24511,3000,3017,11915,114479,2000,2500,0,22419,16028,7355,-102564,112479,22011,0.08622692307692308,0.061646153846153844,0.02828846153846154,-0.39447692307692306,0.43261153846153844,0.08465769230769231,-2
549,120000,0,1,2,31,-1,-1,-1,-1,-1,-2,15665,2647,10293,3600,0,0,2647,10363,3600,0,0,0,0,13018,-7716,6693,3600,0,0,0.10848333333333333,-0.0643,0.055775,0.03,0.0,0.0,-7
550,500000,0,1,2,48,1,-2,-1,-1,0,0,-471,-471,157,20697,23906,23906,0,785,20697,3766,0,2040,0,-471,-1256,-20540,16931,23906,21866,-0.000942,-0.002512,-0.04108,0.033862,0.047812,0.043732,-3
551,150000,1,1,1,46,0,0,0,0,0,0,135748,136681,140019,143237,140658,143344,5000,5000,5000,5000,5000,5000,1,130748,131681,135019,138237,135658,138344,0.8716533333333333,0.8778733333333333,0.9001266666666666,0.92158,0.9043866666666667,0.9222933333333333,0
552,80000,1,1,2,23,1,2,0,0,2,2,80461,78259,66068,50748,51490,50626,37,2122,3600,1600,18,1800,0,80424,76137,62468,49148,51472,48826,1.0053,0.9517125,0.78085,0.61435,0.6434,0.610325,7
553,20000,0,3,2,59,2,2,2,0,0,0,5119,5546,6302,7193,8075,8938,1500,1000,1000,1000,1000,1000,0,3619,4546,5302,6193,7075,7938,0.18095,0.2273,0.2651,0.30965,0.35375,0.3969,6
554,420000,1,2,1,34,0,0,0,0,0,-1,158471,44131,32423,18824,0,21082,1644,1436,1000,0,21082,228548,1,156827,42695,31423,18824,-21082,-207466,0.37339761904761903,0.1016547619047619,0.07481666666666667,0.04481904761904762,-0.0501952380952381,-0.49396666666666667,-1
555,30000,0,1,1,37,0,0,0,0,0,0,29104,30606,30416,28165,28654,29083,2000,2000,2003,2000,1000,402,1,27104,28606,28413,26165,27654,28681,0.9034666666666666,0.9535333333333333,0.9471,0.8721666666666666,0.9218,0.9560333333333333,0
556,90000,1,1,2,27,0,0,-2,-2,-2,-2,7624,0,0,0,0,0,0,0,0,0,0,0,0,7624,0,0,0,0,0,0.08471111111111111,0.0,0.0,0.0,0.0,0.0,-8
557,170000,1,1,2,29,0,0,0,-1,0,0,115194,111991,22499,25015,34343,53403,10000,10000,25015,10000,20000,20000,0,105194,101991,-2516,15015,14343,33403,0.6187882352941176,0.5999470588235294,-0.0148,0.0883235294117647,0.08437058823529411,0.19648823529411766,-1
558,220000,0,2,1,28,0,0,0,0,0,0,38074,43083,47051,65321,83882,72812,6000,5000,20012,23099,10029,30019,1,32074,38083,27039,42222,73853,42793,0.14579090909090908,0.17310454545454546,0.12290454545454546,0.19191818181818182,0.3356954545454545,0.19451363636363636,0
559,200000,1,2,1,32,-2,-2,-2,-2,-2,-2,899,-1,-1,228,1374,380,0,0,229,1380,381,3880,1,899,-1,-230,-1152,993,-3500,0.004495,-5e-06,-0.00115,-0.00576,0.004965,-0.0175,-12
560,210000,1,2,1,30,0,0,0,0,0,0,158805,159093,153056,140518,70901,72539,5404,6230,5696,2328,2567,2531,1,153401,152863,147360,138190,68334,70008,0.7304809523809523,0.7279190476190476,0.7017142857142857,0.658047619047619,0.3254,0.3333714285714286,0
561,390000,0,1,1,35,-1,-1,0,0,0,0,14673,83728,67892,65246,68949,52724,83728,2637,2576,5000,2724,2000,1,-69055,81091,65316,60246,66225,50724,-0.17706410256410257,0.20792564102564104,0.16747692307692308,0.15447692307692307,0.1698076923076923,0.13006153846153845,-2
562,230000,0,2,1,34,0,0,0,0,0,0,131887,133440,134272,136281,138687,118873,5005,5007,5000,5008,5000,4005,1,126882,128433,129272,131273,133687,114868,0.5516608695652174,0.5584043478260869,0.5620521739130435,0.5707521739130434,0.5812478260869566,0.49942608695652174,0
563,410000,0,1,2,27,0,-1,-1,0,-1,-1,7189,15646,15678,40512,17884,34251,16090,16076,40203,17974,34518,369,0,-8901,-430,-24525,22538,-16634,33882,-0.021709756097560977,-0.0010487804878048781,-0.059817073170731705,0.054970731707317075,-0.04057073170731707,0.0826390243902439,-4
564,500000,1,1,2,37,0,0,0,0,0,0,43643,46586,48832,49568,46939,49147,4000,3000,2000,2000,3000,7000,0,39643,43586,46832,47568,43939,42147,0.079286,0.087172,0.093664,0.095136,0.087878,0.084294,0
565,120000,0,1,2,28,0,0,0,0,-1,-1,117303,15504,15748,15480,998,980,1256,1500,2000,998,980,0,0,116047,14004,13748,14482,18,980,0.9670583333333334,0.1167,0.11456666666666666,0.12068333333333334,0.00015,0.008166666666666666,-2
566,80000,1,1,2,23,0,0,0,0,-2,-2,71487,55641,24987,-600,-600,-600,2157,1500,0,0,0,0,0,69330,54141,24987,-600,-600,-600,0.866625,0.6767625,0.3123375,-0.0075,-0.0075,-0.0075,-4
567,240000,1,1,1,39,1,-2,-2,-2,-2,-2,0,0,0,0,0,0,0,0,0,0,0,0,1,0,0,0,0,0,0,0.0,0.0,0.0,0.0,0.0,0.0,-9
568,10000,1,2,2,49,1,2,0,0,0,0,8184,5011,5728,4255,2782,1309,0,1000,0,0,0,0,0,8184,4011,5728,4255,2782,1309,0.8184,0.4011,0.5728,0.4255,0.2782,0.1309,3
569,20000,1,3,1,35,-1,2,2,2,2,0,17056,18803,18055,20578,19813,20197,2500,0,3000,0,1001,1700,1,14556,18803,15055,20578,18812,18497,0.7278,0.94015,0.75275,1.0289,0.9406,0.92485,7
570,50000,0,2,2,33,0,0,0,0,0,2,24060,17474,18297,20114,13235,12482,1400,1183,2000,1200,0,610,0,22660,16291,16297,18914,13235,11872,0.4532,0.32582,0.32594,0.37828,0.2647,0.23744,2
571,30000,0,2,1,38,0,0,0,0,0,0,29723,30428,26558,27265,27953,28456,2000,2000,1500,1500,1500,1500,1,27723,28428,25058,25765,26453,26956,0.9241,0.9476,0.8352666666666667,0.8588333333333333,0.8817666666666667,0.8985333333333333,0
572,200000,0,1,2,27,-1,-1,-1,0,0,0,3592,3622,7990,10392,7042,5692,3622,7990,6000,0,2000,5000,0,-30,-4368,1990,10392,5042,692,-0.00015,-0.02184,0.00995,0.05196,0.02521,0.00346,-3
573,220000,1,1,2,29,1,-1,-1,-1,-1,-1,0,3003,2646,1125,0,3455,3003,2646,1125,0,3455,1000,0,-3003,357,1521,1125,-3455,2455,-0.01365,0.0016227272727272726,0.006913636363636364,0.005113636363636364,-0.015704545454545454,0.011159090909090908,-4
574,250000,1,2,1,29,0,0,0,-1,-1,-1,227762,191424,18016,15353,325,325,35018,1000,20000,325,325,318,1,192744,190424,-1984,15028,0,7,0.770976,0.761696,-0.007936,0.060112,0.0,2.8e-05,-3
575,240000,0,2,2,35,0,0,0,0,0,0,179662,180787,181379,170318,128076,64634,7003,8000,8000,2500,2400,2600,0,172659,172787,173379,167818,125676,62034,0.7194125,0.7199458333333333,0.7224125,0.6992416666666667,0.52365,0.258475,0
576,30000,1,3,1,47,1,2,0,0,0,0,32724,29279,27149,14930,14400,0,0,1500,797,680,0,0,1,32724,27779,26352,14250,14400,0,1.0908,0.9259666666666667,0.8784,0.475,0.48,0.0,3
577,80000,1,2,2,25,-2,-2,-2,-2,-2,-2,0,0,0,0,0,0,0,0,0,0,0,0,0,0,0,0,0,0,0,0.0,0.0,0.0,0.0,0.0,0.0,-12
578,90000,1,2,1,30,-1,-1,-1,-1,0,0,414,414,414,6936,7272,7595,414,414,6936,1000,1000,1000,1,0,0,-6522,5936,6272,6595,0.0,0.0,-0.07246666666666667,0.06595555555555556,0.06968888888888888,0.07327777777777778,-4
579,190000,1,2,1,40,0,0,0,0,0,0,124082,125032,129167,130331,132958,135814,4500,6147,4800,4800,5000,10600,1,119582,118885,124367,125531,127958,125214,0.629378947368421,0.6257105263157895,0.6545631578947368,0.6606894736842105,0.6734631578947369,0.659021052631579,0
580,50000,1,2,1,34,-2,-1,0,0,0,0,50680,50655,50710,50503,40140,-21364,50702,2033,1776,2000,29000,59901,1,-22,48622,48934,48503,11140,-81265,-0.00044,0.97244,0.97868,0.97006,0.2228,-1.6253,-3
581,30000,1,2,1,38,0,0,0,-2,-2,-2,6061,3656,0,0,0,0,1007,0,0,0,0,0,1,5054,3656,0,0,0,0,0.16846666666666665,0.12186666666666666,0.0,0.0,0.0,0.0,-6
582,60000,0,2,1,42,0,0,0,0,0,0,49244,48310,41746,25488,26199,28200,2000,2000,1000,1501,3000,1500,1,47244,46310,40746,23987,23199,26700,0.7874,0.7718333333333334,0.6791,0.3997833333333333,0.38665,0.445,0
583,110000,0,1,1,32,2,2,2,2,2,2,95686,98374,99562,100532,102779,100966,5100,3700,3500,4000,0,10060,1,90586,94674,96062,96532,102779,90906,0.8235090909090909,0.8606727272727273,0.8732909090909091,0.8775636363636363,0.9343545454545454,0.8264181818181818,12
584,320000,0,3,1,56,0,0,0,0,0,0,274210,262737,199761,187759,68920,62702,9441,7821,7361,2227,2046,1892,1,264769,254916,192400,185532,66874,60810,0.827403125,0.7966125,0.60125,0.5797875,0.20898125,0.19003125,0
585,90000,1,2,1,32,0,0,-2,-1,-1,-2,4857,-43,-43,968,4385,17889,0,0,1011,4385,17889,9455,1,4857,-43,-1054,-3417,-13504,8434,0.05396666666666667,-0.00047777777777777776,-0.011711111111111111,-0.03796666666666667,-0.15004444444444445,0.0937111111111111,-6
586,230000,1,1,2,25,-2,-2,-2,-2,-2,-2,264,264,264,264,264,264,264,264,264,264,264,264,0,0,0,0,0,0,0,0.0,0.0,0.0,0.0,0.0,0.0,-12
587,60000,1,2,1,25,2,0,0,2,0,0,33598,34733,37460,36558,37945,38782,2000,3600,0,2000,1600,1600,1,31598,31133,37460,34558,36345,37182,0.5266333333333333,0.5188833333333334,0.6243333333333333,0.5759666666666666,0.60575,0.6197,4
588,120000,1,1,2,27,0,0,0,0,0,0,70835,59986,60779,62958,57763,53004,3000,2500,3000,2000,2000,2500,0,67835,57486,57779,60958,55763,50504,0.5652916666666666,0.47905,0.48149166666666665,0.5079833333333333,0.46469166666666667,0.42086666666666667,0
589,50000,1,2,1,39,0,0,0,0,0,0,32802,31002,32115,31824,32498,21757,1497,2000,1000,1064,1059,290,1,31305,29002,31115,30760,31439,21467,0.6261,0.58004,0.6223,0.6152,0.62878,0.42934,0
590,220000,0,1,2,35,1,-2,-2,-2,-2,-2,0,0,0,0,0,0,0,0,0,0,0,0,0,0,0,0,0,0,0,0.0,0.0,0.0,0.0,0.0,0.0,-9
591,170000,0,3,1,45,-1,0,0,0,0,0,34778,40441,40937,34090,34894,36829,10000,5000,2000,2000,3000,2000,1,24778,35441,38937,32090,31894,34829,0.14575294117647059,0.2084764705882353,0.22904117647058825,0.18876470588235295,0.18761176470588237,0.2048764705882353,-1
592,180000,0,2,2,30,-1,-1,-1,-1,-1,-1,440,30404,0,880,150,430,30404,0,880,150,430,747,0,-29964,30404,-880,730,-280,-317,-0.16646666666666668,0.16891111111111112,-0.004888888888888889,0.004055555555555555,-0.0015555555555555555,-0.001761111111111111,-6
593,50000,0,2,3,36,0,0,0,0,0,0,26432,27708,28928,29475,29579,30445,1700,2000,1300,1200,1500,2000,0,24732,25708,27628,28275,28079,28445,0.49464,0.51416,0.55256,0.5655,0.56158,0.5689,0
594,210000,0,2,1,31,-1,-1,2,-1,-1,-1,1748,2488,740,2048,740,740,2488,0,2048,740,740,740,1,-740,2488,-1308,1308,0,0,-0.0035238095238095237,0.011847619047619048,-0.006228571428571429,0.006228571428571429,0.0,0.0,-3
595,100000,1,2,1,35,-2,-2,-2,-2,-2,-2,3835,1891,1799,1728,6000,0,1891,1799,1728,6000,0,330,1,1944,92,71,-4272,6000,-330,0.01944,0.00092,0.00071,-0.04272,0.06,-0.0033,-12
596,200000,1,1,1,44,0,-1,-1,-2,-2,-1,26814,367,0,0,561,3854,368,0,0,561,3878,3,1,26446,367,0,-561,-3317,3851,0.13223,0.001835,0.0,-0.002805,-0.016585,0.019255,-7
597,440000,1,2,1,40,-1,-1,-1,-1,-1,-1,3278,2028,981,873,873,840,2035,982,874,874,841,7453,1,1243,1046,107,-1,32,-6613,0.002825,0.0023772727272727274,0.00024318181818181817,-2.2727272727272728e-06,7.272727272727273e-05,-0.015029545454545455,-6
598,180000,1,1,1,55,1,-2,-2,-2,-2,-2,0,0,0,0,0,0,0,0,0,0,0,0,1,0,0,0,0,0,0,0.0,0.0,0.0,0.0,0.0,0.0,-9
599,30000,0,3,1,58,0,0,0,0,0,0,19143,20168,21229,21495,21800,22437,1640,1700,915,800,1000,1961,1,17503,18468,20314,20695,20800,20476,0.5834333333333334,0.6156,0.6771333333333334,0.6898333333333333,0.6933333333333334,0.6825333333333333,0
600,90000,0,2,2,44,1,2,2,2,2,0,36835,35949,40567,41604,40637,41824,0,5539,2000,0,2000,3000,0,36835,30410,38567,41604,38637,38824,0.4092777777777778,0.3378888888888889,0.42852222222222225,0.46226666666666666,0.4293,0.4313777777777778,9
601,220000,0,1,1,55,-1,-1,-2,-1,-1,-1,1782,0,0,80737,5381,2232,0,0,80737,5381,2232,121953,1,1782,0,-80737,75356,3149,-119721,0.0081,0.0,-0.3669863636363636,0.34252727272727274,0.014313636363636363,-0.5441863636363636,-7
602,260000,0,1,2,45,-1,-1,-2,-1,0,-1,6062,-900,-900,1905,897,4641,0,0,2805,2,4654,3661,0,6062,-900,-3705,1903,-3757,980,0.023315384615384616,-0.0034615384615384616,-0.01425,0.007319230769230769,-0.01445,0.003769230769230769,-6
603,360000,1,1,2,33,0,0,0,0,0,0,20376,17726,18797,15816,16112,10793,1500,2016,1095,1024,350,1323,0,18876,15710,17702,14792,15762,9470,0.05243333333333333,0.04363888888888889,0.04917222222222222,0.04108888888888889,0.043783333333333334,0.026305555555555554,0
604,90000,0,3,1,62,0,0,0,0,-1,-1,86200,81995,16985,12985,285,-4715,2500,1000,1000,500,0,31000,1,83700,80995,15985,12485,285,-35715,0.93,0.8999444444444444,0.1776111111111111,0.13872222222222222,0.0031666666666666666,-0.3968333333333333,-2
605,110000,1,1,1,32,1,2,0,0,0,0,42867,41901,44126,43483,43435,41010,0,3000,2000,2000,2000,3600,1,42867,38901,42126,41483,41435,37410,0.3897,0.35364545454545454,0.38296363636363634,0.3771181818181818,0.3766818181818182,0.3400909090909091,3
606,30000,0,3,2,27,0,0,0,0,0,0,29584,25645,24564,25823,26269,26335,3000,2000,2000,2500,3000,2500,0,26584,23645,22564,23323,23269,23835,0.8861333333333333,0.7881666666666667,0.7521333333333333,0.7774333333333333,0.7756333333333333,0.7945,0
607,210000,1,2,2,26,0,0,0,0,0,0,177492,179951,171135,166199,144060,132326,10000,10000,10000,10000,10000,10000,0,167492,169951,161135,156199,134060,122326,0.7975809523809524,0.8092904761904762,0.7673095238095238,0.7438047619047619,0.6383809523809524,0.5825047619047619,0
608,180000,1,2,1,27,0,0,0,0,0,0,3063,4083,4634,3652,1973,689,1084,1084,1005,46,16,0,1,1979,2999,3629,3606,1957,689,0.010994444444444444,0.016661111111111113,0.020161111111111112,0.020033333333333334,0.010872222222222222,0.0038277777777777776,0
609,140000,1,3,1,42,0,0,0,0,0,0,138391,135476,135956,137143,137195,136300,6300,6500,6265,5000,5006,5000,1,132091,128976,129691,132143,132189,131300,0.9435071428571429,0.9212571428571429,0.9263642857142858,0.9438785714285715,0.9442071428571429,0.9378571428571428,0
610,70000,0,2,1,42,0,0,0,0,0,0,70293,69199,66398,66282,67580,67273,3300,2600,2600,3000,2600,2600,1,66993,66599,63798,63282,64980,64673,0.9570428571428572,0.9514142857142858,0.9114,0.9040285714285714,0.9282857142857143,0.9239,0
611,260000,0,1,1,41,-2,-2,-1,0,0,0,1086,2853,38836,45087,47201,46199,3552,38836,20000,15000,15000,10000,1,-2466,-35983,18836,30087,32201,36199,-0.009484615384615385,-0.13839615384615384,0.07244615384615384,0.11571923076923077,0.12385,0.13922692307692308,-5
612,200000,1,1,1,27,-2,-2,-2,-2,-2,-2,-3,-3,-3,360,0,0,0,0,363,0,0,0,1,-3,-3,-366,360,0,0,-1.5e-05,-1.5e-05,-0.00183,0.0018,0.0,0.0,-12
613,190000,0,2,2,29,0,0,0,0,0,0,185222,163336,157158,149423,115038,97756,5836,6358,5487,4038,3803,3042,0,179386,156978,151671,145385,111235,94714,0.9441368421052632,0.8262,0.7982684210526316,0.7651842105263158,0.5854473684210526,0.49849473684210527,0
614,50000,1,2,2,23,-2,-2,-2,-2,-2,-2,0,0,0,0,0,0,0,0,0,0,0,0,0,0,0,0,0,0,0,0.0,0.0,0.0,0.0,0.0,0.0,-12
615,200000,1,4,2,40,0,0,0,0,0,0,201598,198373,152601,105588,73886,198487,10100,6700,5500,4500,127600,7500,0,191498,191673,147101,101088,-53714,190987,0.95749,0.958365,0.735505,0.50544,-0.26857,0.954935,0
616,160000,0,2,1,55,0,0,0,0,0,0,155389,152162,154715,155026,79051,81089,6911,6500,4270,2518,2994,0,1,148478,145662,150445,152508,76057,81089,0.9279875,0.9103875,0.94028125,0.953175,0.47535625,0.50680625,0
617,130000,1,2,1,53,0,0,0,0,0,0,210628,215308,219970,221119,21904,22052,6800,6794,5315,2000,1000,1000,1,203828,208514,214655,219119,20904,21052,1.5679076923076922,1.603953846153846,1.6511923076923076,1.6855307692307693,0.1608,0.16193846153846153,0
618,60000,1,1,2,22,2,0,0,0,0,-1,58841,60970,58082,59882,19663,29343,3700,1400,2000,500,30000,1100,0,55141,59570,56082,59382,-10337,28243,0.9190166666666667,0.9928333333333333,0.9347,0.9897,-0.17228333333333334,0.47071666666666667,1
619,110000,0,1,2,33,0,0,0,0,0,0,9495,12633,88334,53978,23687,26567,4018,80004,1500,12013,7000,2000,0,5477,-67371,86834,41965,16687,24567,0.049790909090909094,-0.6124636363636363,0.7894,0.3815,0.1517,0.22333636363636364,0
620,210000,1,1,2,28,-1,-1,0,0,0,0,2568,52720,107861,112533,118699,41329,52720,57861,12533,8699,1329,13580,0,-50152,-5141,95328,103834,117370,27749,-0.23881904761904763,-0.02448095238095238,0.45394285714285715,0.494447619047619,0.5589047619047619,0.13213809523809525,-2
621,50000,0,1,1,60,0,0,0,0,0,0,50546,50854,50024,20281,20285,20066,2112,1712,705,759,748,487,1,48434,49142,49319,19522,19537,19579,0.96868,0.98284,0.98638,0.39044,0.39074,0.39158,0
622,190000,0,1,2,35,0,0,0,0,0,0,24873,23522,22117,23433,22173,22598,1807,2000,2010,1003,2007,3019,0,23066,21522,20107,22430,20166,19579,0.1214,0.11327368421052632,0.10582631578947369,0.11805263157894737,0.10613684210526315,0.10304736842105264,0
623,150000,0,1,2,30,2,2,2,2,2,2,17352,21338,20304,21585,20718,22813,5000,0,2000,0,3000,0,0,12352,21338,18304,21585,17718,22813,0.08234666666666667,0.14225333333333334,0.12202666666666667,0.1439,0.11812,0.15208666666666668,12
624,100000,1,2,1,38,2,2,2,2,0,0,36414,37516,38622,37706,38148,40630,2000,2000,0,1369,3100,0,1,34414,35516,38622,36337,35048,40630,0.34414,0.35516,0.38622,0.36337,0.35048,0.4063,8
625,230000,0,1,1,39,-1,-1,-1,-1,-1,-1,660,660,660,660,660,660,660,660,660,660,660,660,1,0,0,0,0,0,0,0.0,0.0,0.0,0.0,0.0,0.0,-6
626,170000,1,1,1,41,0,0,0,0,0,0,165602,138507,136176,61000,59477,44218,80000,4742,2022,2076,1776,10433,1,85602,133765,134154,58924,57701,33785,0.5035411764705883,0.7868529411764705,0.7891411764705882,0.34661176470588234,0.33941764705882355,0.19873529411764707,0
627,170000,0,2,2,29,-1,-1,0,-1,-1,-1,3362,64602,18070,910,9080,4839,64612,4000,910,9080,4839,5130,0,-61250,60602,17160,-8170,4241,-291,-0.3602941176470588,0.3564823529411765,0.10094117647058823,-0.048058823529411765,0.024947058823529412,-0.001711764705882353,-5
628,80000,1,1,2,25,0,0,0,0,0,0,78327,79322,76290,58987,57947,58077,3000,2454,2059,2100,2149,1956,0,75327,76868,74231,56887,55798,56121,0.9415875,0.96085,0.9278875,0.7110875,0.697475,0.7015125,0
629,260000,1,1,1,28,-2,-2,-2,-2,-2,-2,0,0,0,0,0,0,0,0,0,0,0,0,1,0,0,0,0,0,0,0.0,0.0,0.0,0.0,0.0,0.0,-12
630,260000,0,2,2,29,1,2,0,0,0,0,263943,258331,261518,194791,198894,197564,0,7700,6000,6130,7500,6500,0,263943,250631,255518,188661,191394,191064,1.0151653846153845,0.9639653846153846,0.9827615384615385,0.7256192307692307,0.7361307692307693,0.7348615384615385,3
631,50000,0,3,2,23,0,0,-2,-2,-2,-2,4332,0,0,0,0,0,0,0,0,0,0,0,0,4332,0,0,0,0,0,0.08664,0.0,0.0,0.0,0.0,0.0,-8
632,240000,0,2,2,67,0,0,0,0,0,0,508581,471796,468202,442401,419209,425061,17389,80167,15167,16000,13133,196084,0,491192,391629,453035,426401,406076,228977,2.0466333333333333,1.6317875,1.8876458333333332,1.7766708333333334,1.6919833333333334,0.9540708333333333,0
633,20000,0,2,2,29,0,0,-2,-2,-2,-2,16809,0,0,0,0,0,0,0,0,0,0,0,0,16809,0,0,0,0,0,0.84045,0.0,0.0,0.0,0.0,0.0,-8
634,100000,0,2,2,27,0,0,0,0,2,0,41298,42448,44368,48652,47885,48850,2000,2500,4900,0,1763,2000,0,39298,39948,39468,48652,46122,46850,0.39298,0.39948,0.39468,0.48652,0.46122,0.4685,2
635,80000,1,2,2,40,2,0,0,0,2,2,57364,58637,59863,62860,63976,63293,2200,2200,4000,1777,0,2000,0,55164,56437,55863,61083,63976,61293,0.68955,0.7054625,0.6982875,0.7635375,0.7997,0.7661625,6
636,180000,1,2,2,30,0,0,0,0,0,0,43779,44213,44561,45130,47790,48222,1751,1712,1894,4000,1837,1711,0,42028,42501,42667,41130,45953,46511,0.23348888888888888,0.23611666666666667,0.23703888888888888,0.2285,0.25529444444444443,0.2583944444444444,0
637,80000,1,3,1,48,2,2,2,0,0,0,63695,33283,22442,15553,5593,1350,6056,652,517,0,27,5200,1,57639,32631,21925,15553,5566,-3850,0.7204875,0.4078875,0.2740625,0.1944125,0.069575,-0.048125,6
638,430000,1,2,1,42,0,0,0,0,0,0,89395,90052,90604,91200,92134,92834,3243,3200,3185,3500,3500,3420,1,86152,86852,87419,87700,88634,89414,0.20035348837209302,0.20198139534883722,0.2033,0.203953488372093,0.20612558139534884,0.20793953488372094,0
639,30000,1,3,1,47,-2,-2,-2,-2,-2,-2,6911,10507,4785,4567,11762,4209,10523,4790,4736,55762,4209,22815,1,-3612,5717,49,-51195,7553,-18606,-0.1204,0.19056666666666666,0.0016333333333333334,-1.7065,0.2517666666666667,-0.6202,-12
640,210000,1,3,2,35,-2,-2,-2,-2,-2,-2,1983,-17,9000,7905,1434,1008,0,9017,7905,1434,1008,660,0,1983,-9034,1095,6471,426,348,0.009442857142857143,-0.043019047619047616,0.005214285714285715,0.030814285714285714,0.0020285714285714286,0.0016571428571428572,-12
641,90000,1,3,3,42,0,0,2,0,0,0,12174,15035,14509,15518,15563,18289,3072,0,1555,600,3000,2000,0,9102,15035,12954,14918,12563,16289,0.10113333333333334,0.16705555555555557,0.14393333333333333,0.16575555555555554,0.1395888888888889,0.1809888888888889,2
642,200000,1,1,2,26,-1,0,-1,0,-1,-1,980,2980,3438,2102,38,0,2000,3438,50,38,0,0,0,-1020,-458,3388,2064,38,0,-0.0051,-0.00229,0.01694,0.01032,0.00019,0.0,-4
643,360000,1,1,2,32,0,0,0,0,0,0,166848,149903,138091,138123,140324,108772,7294,6135,4504,4669,4060,3475,0,159554,143768,133587,133454,136264,105297,0.4432055555555556,0.3993555555555556,0.371075,0.37070555555555557,0.37851111111111113,0.29249166666666665,0
644,10000,1,3,1,41,-1,2,-1,-1,2,2,1838,1651,172,2034,2069,1891,0,179,2034,214,0,283,1,1838,1472,-1862,1820,2069,1608,0.1838,0.1472,-0.1862,0.182,0.2069,0.1608,3
645,210000,0,3,1,45,2,3,4,4,5,6,115785,122904,129847,137277,145533,154105,10478,10478,11078,11078,11678,10478,1,105307,112426,118769,126199,133855,143627,0.5014619047619048,0.5353619047619048,0.5655666666666667,0.6009476190476191,0.6374047619047619,0.6839380952380952,24
646,170000,0,2,2,27,-1,-1,-1,-1,-1,-1,416,416,416,416,416,416,416,416,416,416,416,416,0,0,0,0,0,0,0,0.0,0.0,0.0,0.0,0.0,0.0,-6
647,360000,1,2,2,41,-1,-1,-1,-1,-1,-1,3640,1436,1114,1917,19588,16666,1436,1114,1917,19588,16666,707,0,2204,322,-803,-17671,2922,15959,0.0061222222222222225,0.0008944444444444445,-0.0022305555555555555,-0.04908611111111111,0.008116666666666666,0.044330555555555554,-6
648,160000,1,2,2,24,0,0,0,0,0,0,142214,145225,149812,151426,154688,158511,5300,7000,5600,5700,6400,6400,0,136914,138225,144212,145726,148288,152111,0.8557125,0.86390625,0.901325,0.9107875,0.9268,0.95069375,0
649,180000,1,2,2,36,1,-2,-2,-2,-1,-1,0,0,0,0,1482,0,0,0,0,1482,0,9262,0,0,0,0,-1482,1482,-9262,0.0,0.0,0.0,-0.008233333333333334,0.008233333333333334,-0.05145555555555555,-7
650,20000,0,2,2,24,1,3,2,2,3,2,7719,7455,7187,8367,7945,7669,0,0,1300,0,0,1000,0,7719,7455,5887,8367,7945,6669,0.38595,0.37275,0.29435,0.41835,0.39725,0.33345,13
651,50000,0,3,2,23,0,0,0,-1,-1,-1,7965,8404,10240,170,-220,390,1500,2000,170,0,1000,3309,0,6465,6404,10070,170,-1220,-2919,0.1293,0.12808,0.2014,0.0034,-0.0244,-0.05838,-3
652,120000,0,2,2,27,0,0,0,0,0,0,29344,33474,29029,26523,20554,19348,5053,1789,2037,659,802,640,0,24291,31685,26992,25864,19752,18708,0.202425,0.2640416666666667,0.22493333333333335,0.21553333333333333,0.1646,0.1559,0
653,360000,1,1,2,37,0,0,0,0,0,-1,16600,19190,20384,23255,22495,380,3194,2384,3271,2509,381,2469,0,13406,16806,17113,20746,22114,-2089,0.03723888888888889,0.046683333333333334,0.04753611111111111,0.05762777777777778,0.061427777777777776,-0.005802777777777777,-1
654,430000,1,1,1,42,-2,-2,-2,-2,-2,-2,1580,1526,806,2792,3010,-200,1526,806,2792,3010,200,0,1,54,720,-1986,-218,2810,-200,0.0001255813953488372,0.0016744186046511627,-0.0046186046511627905,-0.0005069767441860465,0.006534883720930232,-0.00046511627906976747,-12
655,80000,0,2,2,36,-2,-2,-2,-2,-2,-2,59223,26241,10387,74864,74305,0,1141,10725,74864,1486,0,0,0,58082,15516,-64477,73378,74305,0,0.726025,0.19395,-0.8059625,0.917225,0.9288125,0.0,-12
656,80000,1,1,2,25,-1,-1,2,-1,-1,-2,746,4824,690,6097,0,0,4830,0,6097,0,0,2169,0,-4084,4824,-5407,6097,0,-2169,-0.05105,0.0603,-0.0675875,0.0762125,0.0,-0.0271125,-4
657,50000,1,1,2,26,-1,0,0,0,-2,-2,5310,34105,34536,0,0,0,29000,1000,0,0,0,0,0,-23690,33105,34536,0,0,0,-0.4738,0.6621,0.69072,0.0,0.0,0.0,-5
658,130000,1,3,1,39,0,0,2,0,0,0,91982,99328,96898,97990,100160,102190,8900,0,3600,3800,3800,5000,1,83082,99328,93298,94190,96360,97190,0.6390923076923077,0.7640615384615385,0.7176769230769231,0.7245384615384616,0.7412307692307692,0.7476153846153846,2
659,310000,0,2,2,42,0,0,0,0,0,0,169749,172685,176630,180315,184072,188194,7000,6630,6379,6586,7086,7522,0,162749,166055,170251,173729,176986,180672,0.5249967741935484,0.5356612903225807,0.5491967741935484,0.560416129032258,0.5709225806451613,0.5828129032258065,0
660,350000,1,4,1,50,0,0,0,0,0,0,136293,139215,142695,98404,100367,102465,4846,5577,3488,3417,3536,3707,1,131447,133638,139207,94987,96831,98758,0.37556285714285714,0.38182285714285713,0.3977342857142857,0.27139142857142856,0.27666,0.2821657142857143,0
661,410000,1,1,1,53,-1,-1,-1,-1,-1,-1,4213,187,7884,1842,1129,7592,187,7898,1842,1129,7592,0,1,4026,-7711,6042,713,-6463,7592,0.00981951219512195,-0.01880731707317073,0.014736585365853658,0.0017390243902439023,-0.015763414634146343,0.01851707317073171,-6
662,200000,1,1,2,31,-1,2,2,-2,-2,-2,450,450,0,0,0,0,0,0,0,0,0,0,0,450,450,0,0,0,0,0.00225,0.00225,0.0,0.0,0.0,0.0,-3
663,470000,0,2,2,29,0,0,0,0,0,0,59235,47091,34901,33953,34188,35444,3106,5017,3007,2001,2093,10076,0,56129,42074,31894,31952,32095,25368,0.11942340425531915,0.08951914893617022,0.0678595744680851,0.06798297872340425,0.06828723404255319,0.053974468085106385,0
664,140000,1,1,1,35,0,0,0,0,0,0,92924,88331,83421,79088,73360,67700,4691,4251,4500,3000,2500,2300,1,88233,84080,78921,76088,70860,65400,0.6302357142857142,0.6005714285714285,0.5637214285714286,0.5434857142857142,0.5061428571428571,0.46714285714285714,0
665,200000,0,3,2,30,-2,-2,-2,-2,-2,-2,0,680,1100,1500,1402,0,680,1100,1500,1402,0,0,0,-680,-420,-400,98,1402,0,-0.0034,-0.0021,-0.002,0.00049,0.00701,0.0,-12
666,60000,1,4,2,27,0,0,0,0,0,0,170536,175143,180162,190202,209923,55491,5143,5162,10202,19923,1591,5500,0,165393,169981,169960,170279,208332,49991,2.75655,2.8330166666666665,2.832666666666667,2.8379833333333333,3.4722,0.8331833333333334,0
667,300000,1,2,1,31,-1,-1,-1,-1,-1,-1,3862,-3,6367,570,3749,127,0,6370,570,3749,1217,60959,1,3862,-6373,5797,-3179,2532,-60832,0.012873333333333334,-0.021243333333333333,0.019323333333333335,-0.010596666666666667,0.00844,-0.20277333333333333,-6
668,200000,1,3,1,42,-1,-1,-1,-2,-1,0,535,10468,0,0,400,400,10468,0,0,400,0,0,1,-9933,10468,0,-400,400,400,-0.049665,0.05234,0.0,-0.002,0.002,0.002,-6
669,200000,1,2,1,39,-1,2,-1,-1,-1,-1,3603,272,5881,0,3331,0,0,5881,20,3331,0,8447,1,3603,-5609,5861,-3331,3331,-8447,0.018015,-0.028045,0.029305,-0.016655,0.016655,-0.042235,-3
670,50000,1,2,1,36,0,0,0,0,0,0,44625,46078,46689,8261,8434,8738,2174,1785,296,306,444,10686,1,42451,44293,46393,7955,7990,-1948,0.84902,0.88586,0.92786,0.1591,0.1598,-0.03896,0
671,20000,0,2,2,21,0,0,-1,0,0,0,19739,17875,19174,19158,18762,19223,1000,26299,673,680,772,851,0,18739,-8424,18501,18478,17990,18372,0.93695,-0.4212,0.92505,0.9239,0.8995,0.9186,-1
672,240000,0,1,1,48,0,0,0,0,0,0,234984,234559,240896,135900,135853,127777,9500,11217,4855,4000,3200,3000,1,225484,223342,236041,131900,132653,124777,0.9395166666666667,0.9305916666666667,0.9835041666666666,0.5495833333333333,0.5527208333333333,0.5199041666666666,0
673,430000,1,1,1,43,0,-1,-1,-1,-1,-1,30000,28490,33490,30636,30240,0,28647,35000,30636,30241,0,179,1,1353,-6510,2854,395,30240,-179,0.0031465116279069767,-0.01513953488372093,0.006637209302325581,0.0009186046511627907,0.07032558139534884,-0.00041627906976744185,-5
674,160000,1,2,2,25,-1,-1,0,0,0,0,5536,15041,15877,12311,16270,7922,15046,4055,6000,7000,3000,1324,0,-9510,10986,9877,5311,13270,6598,-0.0594375,0.0686625,0.06173125,0.03319375,0.0829375,0.0412375,-2
675,130000,1,1,2,25,0,0,0,0,-2,-2,123945,127883,133400,0,0,0,6000,9000,0,0,0,0,0,117945,118883,133400,0,0,0,0.9072692307692307,0.9144846153846153,1.0261538461538462,0.0,0.0,0.0,-4
676,140000,1,2,1,37,-1,-1,-1,-1,2,-1,316,586,5842,9422,8956,316,586,5842,8956,0,316,316,1,-270,-5256,-3114,9422,8640,0,-0.0019285714285714286,-0.03754285714285714,-0.022242857142857144,0.0673,0.061714285714285715,0.0,-3
677,50000,0,2,1,33,-2,-2,-2,-2,-2,-2,390,390,0,780,0,0,390,0,780,0,0,0,1,0,390,-780,780,0,0,0.0,0.0078,-0.0156,0.0156,0.0,0.0,-12
678,110000,1,1,2,32,0,0,0,0,0,0,46603,48351,51815,47225,34975,43725,2536,5000,1653,1500,10000,1495,0,44067,43351,50162,45725,24975,42230,0.4006090909090909,0.3941,0.4560181818181818,0.4156818181818182,0.22704545454545455,0.3839090909090909,0
679,50000,0,3,1,54,2,2,2,0,0,0,18691,21072,20039,20042,20097,20288,3000,0,700,750,900,692,1,15691,21072,19339,19292,19197,19596,0.31382,0.42144,0.38678,0.38584,0.38394,0.39192,6
680,160000,0,2,2,37,-1,-1,0,0,0,0,3090,52125,26325,29638,35474,38190,52165,5000,7000,8000,5000,1200,0,-49075,47125,19325,21638,30474,36990,-0.30671875,0.29453125,0.12078125,0.1352375,0.1904625,0.2311875,-2
681,80000,0,3,2,66,0,0,0,0,0,0,58592,52465,16937,15159,12195,0,2912,3000,3000,3000,0,0,0,55680,49465,13937,12159,12195,0,0.696,0.6183125,0.1742125,0.1519875,0.1524375,0.0,0
682,380000,1,3,1,46,1,-2,-1,-1,-1,-1,0,0,224,4034,0,2062,0,224,4034,0,2062,0,1,0,-224,-3810,4034,-2062,2062,0.0,-0.0005894736842105263,-0.010026315789473684,0.01061578947368421,-0.0054263157894736845,0.0054263157894736845,-5
683,150000,1,3,2,41,2,0,0,0,0,0,102629,85817,78898,70886,65869,67805,3100,3160,2505,2500,3000,5000,0,99529,82657,76393,68386,62869,62805,0.6635266666666667,0.5510466666666667,0.5092866666666667,0.4559066666666667,0.41912666666666665,0.4187,2
684,180000,1,2,1,47,-1,-1,-2,-2,-2,-2,11900,4256,4000,4000,4000,4000,4256,4000,4000,4000,4000,4000,1,7644,256,0,0,0,0,0.042466666666666666,0.0014222222222222223,0.0,0.0,0.0,0.0,-10
685,200000,1,3,1,42,0,0,0,0,2,-1,1554,1645,1408,1800,819,886,1345,1108,669,0,886,2415,1,209,537,739,1800,-67,-1529,0.001045,0.002685,0.003695,0.009,-0.000335,-0.007645,1
686,100000,0,1,2,39,-1,-1,-1,-1,-1,-1,1442,1261,1411,1411,1075,1139,1261,1411,1411,1075,1500,0,0,181,-150,0,336,-425,1139,0.00181,-0.0015,0.0,0.00336,-0.00425,0.01139,-6
687,230000,1,1,2,34,-1,0,0,0,-1,0,18482,22938,3569,2845,1935,6781,5000,1000,0,2000,5000,1000,0,13482,21938,3569,845,-3065,5781,0.05861739130434783,0.09538260869565217,0.015517391304347827,0.003673913043478261,-0.01332608695652174,0.02513478260869565,-2
688,200000,1,1,2,29,-1,-1,-1,-1,0,0,27869,5531,6781,12162,12410,12410,5531,6781,12162,248,0,1703,0,22338,-1250,-5381,11914,12410,10707,0.11169,-0.00625,-0.026905,0.05957,0.06205,0.053535,-4
689,50000,0,3,2,34,-2,-2,-2,-2,-2,-2,17095,18261,19313,19304,19725,5770,1448,1500,419,455,115,19627,0,15647,16761,18894,18849,19610,-13857,0.31294,0.33522,0.37788,0.37698,0.3922,-0.27714,-12
690,290000,0,1,2,34,-1,-1,-2,-1,-1,-1,1597,-2002,-1001,3999,0,4483,0,0,5000,0,4483,1209,0,1597,-2002,-6001,3999,-4483,3274,0.005506896551724138,-0.006903448275862069,-0.020693103448275862,0.013789655172413793,-0.015458620689655173,0.011289655172413792,-7
691,230000,0,1,1,37,0,0,0,0,0,0,30769,30792,30140,31067,31091,28223,1500,1600,1500,1000,1000,1200,1,29269,29192,28640,30067,30091,27023,0.12725652173913043,0.12692173913043478,0.12452173913043478,0.13072608695652174,0.1308304347826087,0.11749130434782609,0
692,270000,1,1,1,40,0,0,0,-2,-2,-2,18751,5706,0,0,0,0,1000,0,0,0,0,0,1,17751,5706,0,0,0,0,0.06574444444444444,0.021133333333333334,0.0,0.0,0.0,0.0,-6
693,360000,1,1,1,30,1,-2,-2,-2,-2,-2,0,0,0,0,0,0,0,0,0,0,0,0,1,0,0,0,0,0,0,0.0,0.0,0.0,0.0,0.0,0.0,-9
694,210000,0,3,2,37,-1,-1,-1,-1,-1,-1,53748,98002,10347,20198,2960,976,99737,11188,20564,3486,976,1060,0,-45989,86814,-10217,16712,1984,-84,-0.2189952380952381,0.4134,-0.048652380952380954,0.07958095238095238,0.009447619047619048,-0.0004,-6
695,150000,1,1,2,34,-2,-2,-2,-2,-2,-2,0,0,0,0,0,0,0,0,0,0,0,0,0,0,0,0,0,0,0,0.0,0.0,0.0,0.0,0.0,0.0,-12
696,210000,1,1,1,32,1,-2,-2,-2,-2,-2,0,0,0,0,0,0,0,0,0,0,0,0,1,0,0,0,0,0,0,0.0,0.0,0.0,0.0,0.0,0.0,-9
697,30000,0,2,1,43,3,2,2,2,2,2,1700,2610,1914,2182,2000,2566,1100,0,300,0,600,0,1,600,2610,1614,2182,1400,2566,0.02,0.087,0.0538,0.07273333333333333,0.04666666666666667,0.08553333333333334,13
698,50000,1,2,2,27,-1,-1,-1,-1,-1,-1,45750,1655,8425,10408,53327,318,1655,8425,10424,53327,318,3770,0,44095,-6770,-1999,-42919,53009,-3452,0.8819,-0.1354,-0.03998,-0.85838,1.06018,-0.06904,-6
699,140000,0,1,2,27,-2,-1,0,0,0,0,25001,138430,135573,98172,93677,95276,141472,8000,5075,4000,4000,5000,0,-116471,130430,130498,94172,89677,90276,-0.8319357142857143,0.9316428571428571,0.9321285714285714,0.6726571428571428,0.64055,0.6448285714285714,-3
700,280000,0,3,1,52,0,0,0,0,0,0,247868,251246,258032,263163,267083,272706,9000,10842,10928,9700,10000,10125,1,238868,240404,247104,253463,257083,262581,0.8531,0.8585857142857143,0.8825142857142857,0.905225,0.9181535714285715,0.9377892857142858,0
701,200000,1,1,2,26,0,0,0,0,-2,-2,196168,201190,200662,-1528,-1528,-1504,8800,10183,1504,0,24,204395,0,187368,191007,199158,-1528,-1552,-205899,0.93684,0.955035,0.99579,-0.00764,-0.00776,-1.029495,-4
702,360000,1,1,2,30,0,-1,-1,-1,-1,-2,37012,4810,3969,6657,642,6204,4924,3969,6657,642,6204,7052,0,32088,841,-2688,6015,-5562,-848,0.08913333333333333,0.0023361111111111113,-0.007466666666666667,0.016708333333333332,-0.01545,-0.0023555555555555556,-6
703,160000,1,1,1,47,1,-2,-2,-2,-2,-2,0,0,0,0,0,0,0,0,0,0,0,0,1,0,0,0,0,0,0,0.0,0.0,0.0,0.0,0.0,0.0,-9
704,120000,1,1,1,35,0,0,0,0,0,0,9756,12092,15516,17373,17950,18363,2519,3643,2500,1000,689,1000,1,7237,8449,13016,16373,17261,17363,0.06030833333333333,0.07040833333333334,0.10846666666666667,0.13644166666666666,0.14384166666666667,0.14469166666666666,0
705,140000,1,2,1,28,-1,2,-1,-1,-1,-1,1953,1366,464,337,548,395,0,464,337,548,395,681,1,1953,902,127,-211,153,-286,0.01395,0.0064428571428571425,0.0009071428571428571,-0.001507142857142857,0.0010928571428571428,-0.0020428571428571427,-3
706,150000,1,2,1,27,-2,-2,-2,-2,-2,-2,929,0,0,0,0,0,0,0,0,0,0,0,1,929,0,0,0,0,0,0.006193333333333334,0.0,0.0,0.0,0.0,0.0,-12
707,50000,0,2,2,24,-1,-1,-2,-2,-2,-2,402,-2760,-3650,-3650,-3650,-3650,0,0,0,0,0,0,0,402,-2760,-3650,-3650,-3650,-3650,0.00804,-0.0552,-0.073,-0.073,-0.073,-0.073,-10
708,480000,1,2,1,35,-1,2,-1,-1,2,0,18214,11031,182123,188956,179179,181746,0,182123,12960,0,9000,50000,1,18214,-171092,169163,188956,170179,131746,0.03794583333333333,-0.35644166666666666,0.35242291666666664,0.39365833333333333,0.35453958333333335,0.27447083333333333,1
709,130000,1,3,2,39,1,2,2,2,0,-1,4867,3189,4634,2946,1473,780,0,2946,0,0,780,0,0,4867,243,4634,2946,693,780,0.03743846153846154,0.0018692307692307693,0.03564615384615385,0.022661538461538462,0.005330769230769231,0.006,6
710,230000,1,2,1,39,2,0,0,0,0,0,183718,187811,176457,125552,127993,112107,7236,5603,4187,4327,5237,15226,1,176482,182208,172270,121225,122756,96881,0.7673130434782609,0.7922086956521739,0.749,0.5270652173913043,0.5337217391304347,0.42122173913043476,2
711,110000,1,2,2,28,0,0,0,0,0,0,106202,105080,107420,107325,108545,105341,5300,5540,5361,4500,4000,4500,0,100902,99540,102059,102825,104545,100841,0.917290909090909,0.9049090909090909,0.9278090909090909,0.9347727272727273,0.9504090909090909,0.9167363636363637,0
712,120000,1,2,1,27,-1,-1,-1,-1,0,0,1164,1844,-7809,120680,63530,63552,1671,380,131062,2000,3000,3000,1,-507,1464,-138871,118680,60530,60552,-0.004225,0.0122,-1.1572583333333333,0.989,0.5044166666666666,0.5046,-4
713,20000,0,2,1,34,0,0,0,0,0,0,12857,14183,14890,15642,16387,17113,1541,1248,1000,1000,1000,1000,1,11316,12935,13890,14642,15387,16113,0.5658,0.64675,0.6945,0.7321,0.76935,0.80565,0
714,30000,0,3,1,42,0,0,2,-1,-1,2,14617,20350,18456,4190,13702,13247,6000,28,5000,13702,0,10000,1,8617,20322,13456,-9512,13702,3247,0.28723333333333334,0.6774,0.44853333333333334,-0.31706666666666666,0.4567333333333333,0.10823333333333333,2
715,40000,0,2,2,27,0,0,0,0,0,0,38561,38614,39951,40552,38935,40187,1700,2000,1526,1500,1900,1400,0,36861,36614,38425,39052,37035,38787,0.921525,0.91535,0.960625,0.9763,0.925875,0.969675,0
716,500000,0,1,1,48,0,0,0,0,0,0,107595,109605,113409,114191,117285,120388,5000,5571,4152,5000,5000,5000,1,102595,104034,109257,109191,112285,115388,0.20519,0.208068,0.218514,0.218382,0.22457,0.230776,0
717,90000,0,2,2,26,-1,2,-1,0,0,0,481,1149,39674,38968,39853,8064,1000,39674,1200,1217,1025,500,0,-519,-38525,38474,37751,38828,7564,-0.0057666666666666665,-0.4280555555555556,0.42748888888888886,0.4194555555555556,0.4314222222222222,0.08404444444444445,0
718,50000,0,2,2,35,0,0,0,0,0,-1,57570,54383,49966,7825,3753,34287,2460,1140,226,555,35190,1203,0,55110,53243,49740,7270,-31437,33084,1.1022,1.06486,0.9948,0.1454,-0.62874,0.66168,-1
719,60000,0,3,2,36,3,2,0,0,0,0,56807,55339,55751,37851,34195,33499,0,2141,2000,2000,2000,2000,0,56807,53198,53751,35851,32195,31499,0.9467833333333333,0.8866333333333334,0.89585,0.5975166666666667,0.5365833333333333,0.5249833333333334,5
720,80000,1,3,2,52,0,0,0,0,0,-1,42635,39508,36060,30470,18306,7432,1623,1740,1200,366,7432,0,0,41012,37768,34860,30104,10874,7432,0.51265,0.4721,0.43575,0.3763,0.135925,0.0929,-1
721,30000,0,2,2,31,1,2,2,2,2,2,10916,11940,11462,13263,12758,13545,1500,0,2300,0,1300,800,0,9416,11940,9162,13263,11458,12745,0.3138666666666667,0.398,0.3054,0.4421,0.38193333333333335,0.42483333333333334,11
722,180000,1,1,2,29,-2,-2,-2,-2,-2,-2,0,0,432,0,0,0,0,432,0,0,0,0,0,0,-432,432,0,0,0,0.0,-0.0024,0.0024,0.0,0.0,0.0,-12
723,250000,1,1,1,32,1,-1,0,0,0,0,-154973,59514,220765,180488,173140,170233,225066,198031,6069,4310,5752,4638,1,-380039,-138517,214696,176178,167388,165595,-1.520156,-0.554068,0.858784,0.704712,0.669552,0.66238,0
724,30000,1,1,2,23,0,0,0,0,0,0,18397,19789,21450,22391,23029,23745,2000,2000,1300,1000,1100,2000,0,16397,17789,20150,21391,21929,21745,0.5465666666666666,0.5929666666666666,0.6716666666666666,0.7130333333333333,0.7309666666666667,0.7248333333333333,0
725,50000,0,3,1,30,0,0,0,0,0,0,50545,49502,46418,19980,19751,20477,2603,1621,1000,1000,1204,1000,1,47942,47881,45418,18980,18547,19477,0.95884,0.95762,0.90836,0.3796,0.37094,0.38954,0
726,50000,0,2,2,56,0,0,0,0,0,0,48025,49128,49348,44932,19559,18859,1884,1997,1943,693,683,680,0,46141,47131,47405,44239,18876,18179,0.92282,0.94262,0.9481,0.88478,0.37752,0.36358,0
727,140000,1,3,2,28,-1,-1,-1,-1,0,-1,800,7937,9920,7078,3936,1555,7937,10132,7084,4,1555,0,0,-7137,-2195,2836,7074,2381,1555,-0.05097857142857143,-0.015678571428571427,0.020257142857142856,0.05052857142857143,0.017007142857142856,0.011107142857142857,-5
728,150000,1,2,2,43,0,0,0,0,0,0,111024,111486,12596,13610,14381,15147,2720,1500,1229,1000,1000,1000,0,108304,109986,11367,12610,13381,14147,0.7220266666666667,0.73324,0.07578,0.08406666666666666,0.08920666666666667,0.09431333333333333,0
729,50000,1,2,1,34,2,2,2,0,0,0,46843,49378,48052,48573,28902,28205,4310,0,2033,1119,985,2000,1,42533,49378,46019,47454,27917,26205,0.85066,0.98756,0.92038,0.94908,0.55834,0.5241,6
730,70000,1,3,1,57,0,0,0,0,0,0,10042,10577,11129,11650,12997,14322,1176,1196,1185,2000,2000,2000,1,8866,9381,9944,9650,10997,12322,0.12665714285714286,0.13401428571428572,0.14205714285714285,0.13785714285714284,0.1571,0.17602857142857142,0
731,290000,0,2,2,27,0,0,0,0,0,0,98861,89638,50453,193665,188075,162106,3221,3104,160045,4959,5201,4582,0,95640,86534,-109592,188706,182874,157524,0.32979310344827584,0.29839310344827585,-0.3779034482758621,0.6507103448275862,0.6306,0.5431862068965517,0
732,180000,0,3,1,30,-1,0,0,0,0,0,56951,57941,58994,60047,61389,63048,2100,2150,2200,2500,3000,1000,1,54851,55791,56794,57547,58389,62048,0.30472777777777776,0.30995,0.3155222222222222,0.3197055555555556,0.32438333333333336,0.34471111111111113,-1
733,50000,1,2,1,50,0,0,0,0,0,0,50224,47178,48400,29781,30082,26609,2200,2520,1000,1100,1000,1000,1,48024,44658,47400,28681,29082,25609,0.96048,0.89316,0.948,0.57362,0.58164,0.51218,0
734,50000,0,2,2,27,0,0,0,0,-1,-1,47481,36112,31992,33361,100,0,1910,1790,79,100,1200,0,0,45571,34322,31913,33261,-1100,0,0.91142,0.68644,0.63826,0.66522,-0.022,0.0,-2
735,50000,0,3,2,25,-1,0,0,0,0,0,42838,37225,36087,9636,9590,10030,1759,1779,320,500,1000,1000,0,41079,35446,35767,9136,8590,9030,0.82158,0.70892,0.71534,0.18272,0.1718,0.1806,-1
736,90000,1,3,1,35,2,2,2,0,0,0,35077,37557,29355,20046,14905,15075,3407,56,603,553,430,133,1,31670,37501,28752,19493,14475,14942,0.35188888888888886,0.41667777777777776,0.3194666666666667,0.2165888888888889,0.16083333333333333,0.1660222222222222,6
737,320000,1,2,2,28,1,2,2,0,0,0,23595,23906,22035,22015,21163,25806,2000,0,2007,1000,5000,2000,0,21595,23906,20028,21015,16163,23806,0.067484375,0.07470625,0.0625875,0.065671875,0.050509375,0.07439375,5
738,190000,1,2,2,27,0,0,0,0,0,0,97136,98767,101452,103471,104083,106359,4418,5452,5471,4083,4359,3697,0,92718,93315,95981,99388,99724,102662,0.48798947368421053,0.4911315789473684,0.5051631578947369,0.5230947368421053,0.5248631578947368,0.5403263157894737,0
739,20000,0,2,2,24,1,2,-1,0,-1,-1,12060,11047,780,390,12246,12409,0,780,0,12246,911,0,0,12060,10267,780,-11856,11335,12409,0.603,0.51335,0.039,-0.5928,0.56675,0.62045,0
740,200000,0,2,1,55,0,0,0,0,0,0,169287,172655,178858,180101,173138,176920,6177,8982,6758,6257,6633,6115,1,163110,163673,172100,173844,166505,170805,0.81555,0.818365,0.8605,0.86922,0.832525,0.854025,0
741,160000,1,2,2,33,0,0,0,0,0,0,140225,140745,139923,140815,139935,138912,5211,5000,5000,5000,5000,6000,0,135014,135745,134923,135815,134935,132912,0.8438375,0.84840625,0.84326875,0.84884375,0.84334375,0.8307,0
742,80000,1,2,1,39,0,0,0,0,0,0,41753,42956,43850,38112,38876,39697,2200,2000,2000,1700,1600,1700,1,39553,40956,41850,36412,37276,37997,0.4944125,0.51195,0.523125,0.45515,0.46595,0.4749625,0
743,400000,0,1,1,50,0,0,0,0,0,0,16241,14697,12762,13043,10137,8249,1217,1302,1052,510,305,512,1,15024,13395,11710,12533,9832,7737,0.03756,0.0334875,0.029275,0.0313325,0.02458,0.0193425,0
744,30000,1,2,2,22,0,0,2,0,0,0,23892,28459,25499,25778,28708,30520,5300,0,1000,3352,2300,0,0,18592,28459,24499,22426,26408,30520,0.6197333333333334,0.9486333333333333,0.8166333333333333,0.7475333333333334,0.8802666666666666,1.0173333333333334,2
745,360000,0,1,1,54,1,-1,-1,-1,-1,0,-281,2520,7508,434,2139,993,3011,7545,502,2205,5,1799,1,-3292,-5025,7006,-1771,2134,-806,-0.009144444444444445,-0.013958333333333333,0.01946111111111111,-0.004919444444444444,0.0059277777777777775,-0.002238888888888889,-3
746,360000,1,2,2,37,-1,-1,-1,-1,-1,-1,333,333,5043,333,0,333,333,5043,333,0,333,210,0,0,-4710,4710,333,-333,123,0.0,-0.013083333333333334,0.013083333333333334,0.000925,-0.000925,0.00034166666666666666,-6
747,30000,0,3,2,24,2,2,2,0,0,-2,28470,31407,30200,30000,0,0,3407,0,0,0,0,0,0,25063,31407,30200,30000,0,0,0.8354333333333334,1.0469,1.0066666666666666,1.0,0.0,0.0,4
748,220000,1,2,1,40,-2,-2,-2,-2,-2,-2,5785,4164,8553,11652,14968,7898,4183,8603,11709,15823,7937,5302,1,1602,-4439,-3156,-4171,7031,2596,0.007281818181818182,-0.020177272727272728,-0.014345454545454545,-0.018959090909090908,0.03195909090909091,0.0118,-12
749,90000,1,2,1,27,2,2,2,0,0,0,85753,87510,85188,87112,169533,90316,4000,0,4200,3285,7787,4000,1,81753,87510,80988,83827,161746,86316,0.9083666666666667,0.9723333333333334,0.8998666666666667,0.9314111111111111,1.7971777777777778,0.9590666666666666,6
750,50000,1,2,1,31,0,0,0,0,0,0,45614,44187,29253,14199,14965,15712,2450,2100,1000,1000,1000,1000,1,43164,42087,28253,13199,13965,14712,0.86328,0.84174,0.56506,0.26398,0.2793,0.29424,0
751,360000,0,2,2,34,-1,-1,-1,-1,-1,0,1978,8583,993,26454,10456,31581,8625,998,26561,10456,21738,0,0,-6647,7585,-25568,15998,-11282,31581,-0.018463888888888887,0.021069444444444443,-0.07102222222222222,0.04443888888888889,-0.03133888888888889,0.087725,-5
752,140000,1,1,2,28,1,2,0,0,0,2,99215,96776,98949,100673,106935,104427,0,3932,3717,8000,0,4000,0,99215,92844,95232,92673,106935,100427,0.7086785714285714,0.6631714285714285,0.6802285714285714,0.66195,0.7638214285714285,0.7173357142857143,5
753,210000,1,1,2,31,-1,-1,-1,0,0,-1,15332,10000,19875,57751,25456,10625,10000,19875,50000,15456,10625,213,0,5332,-9875,-30125,42295,14831,10412,0.02539047619047619,-0.04702380952380952,-0.14345238095238094,0.2014047619047619,0.07062380952380952,0.04958095238095238,-4
754,50000,1,2,2,38,0,0,0,0,0,-1,41724,92054,50120,19587,10577,7533,5000,5120,10292,5577,7533,1000,0,36724,86934,39828,14010,3044,6533,0.73448,1.73868,0.79656,0.2802,0.06088,0.13066,-1
755,300000,1,1,2,30,-1,-1,-1,-1,0,0,515,200,208,2609,2040,1341,200,208,2610,0,0,0,0,315,-8,-2402,2609,2040,1341,0.00105,-2.6666666666666667e-05,-0.008006666666666667,0.008696666666666667,0.0068,0.00447,-4
756,50000,0,2,2,32,0,0,0,0,0,2,50240,50149,50021,44924,49669,42689,6000,8000,3000,9000,0,10000,0,44240,42149,47021,35924,49669,32689,0.8848,0.84298,0.94042,0.71848,0.99338,0.65378,2
757,230000,1,2,2,35,-1,-1,0,0,0,0,2873,29488,65868,58171,56033,47192,29525,50014,8242,7032,5030,8007,0,-26652,-20526,57626,51139,51003,39185,-0.11587826086956522,-0.08924347826086956,0.2505478260869565,0.22234347826086956,0.22175217391304347,0.1703695652173913,-2
758,50000,0,2,1,32,0,0,0,0,0,0,37293,35441,26265,19526,13250,11250,1634,1420,391,300,500,0,1,35659,34021,25874,19226,12750,11250,0.71318,0.68042,0.51748,0.38452,0.255,0.225,0
759,50000,1,2,1,57,-1,-1,-1,-2,-2,-2,173,274,0,0,0,0,274,0,0,0,0,2590,1,-101,274,0,0,0,-2590,-0.00202,0.00548,0.0,0.0,0.0,-0.0518,-9
760,50000,0,2,2,42,0,0,0,0,0,0,47691,48738,48565,48301,50851,51153,3304,2300,2000,3500,3000,4000,0,44387,46438,46565,44801,47851,47153,0.88774,0.92876,0.9313,0.89602,0.95702,0.94306,0
761,140000,1,2,1,32,0,0,0,0,0,0,129653,116582,112170,102931,100179,102417,5820,4920,3600,3700,3900,3602,1,123833,111662,108570,99231,96279,98815,0.8845214285714286,0.7975857142857142,0.7755,0.7087928571428571,0.6877071428571429,0.7058214285714286,0
762,180000,1,2,2,34,2,0,0,0,2,2,51385,53925,54848,57988,59438,61974,3140,923,4663,2530,3687,5000,0,48245,53002,50185,55458,55751,56974,0.26802777777777775,0.2944555555555556,0.27880555555555553,0.3081,0.30972777777777777,0.3165222222222222,6
763,50000,0,2,1,30,4,3,2,0,0,0,49926,48840,46958,47796,48800,50108,0,0,2000,2000,2000,6000,1,49926,48840,44958,45796,46800,44108,0.99852,0.9768,0.89916,0.91592,0.936,0.88216,9
764,360000,1,1,1,32,1,-2,-2,-2,-2,-2,0,0,0,0,0,0,0,0,0,0,0,0,1,0,0,0,0,0,0,0.0,0.0,0.0,0.0,0.0,0.0,-9
765,20000,1,2,1,38,3,4,3,2,2,2,18666,18087,17517,16930,18043,17156,0,0,0,1381,0,1600,1,18666,18087,17517,15549,18043,15556,0.9333,0.90435,0.87585,0.77745,0.90215,0.7778,16
766,230000,1,1,1,34,-2,-2,-2,-2,-2,-2,711,-1,-1,-1,-1,-1,0,0,0,0,0,0,1,711,-1,-1,-1,-1,-1,0.003091304347826087,-4.347826086956521e-06,-4.347826086956521e-06,-4.347826086956521e-06,-4.347826086956521e-06,-4.347826086956521e-06,-12
767,100000,1,2,2,33,2,2,0,0,0,0,74763,73010,74198,74964,76655,78328,0,3000,2000,2000,2000,2000,0,74763,70010,72198,72964,74655,76328,0.74763,0.7001,0.72198,0.72964,0.74655,0.76328,4
768,30000,1,3,1,44,-1,-1,2,0,0,0,1072,5122,4440,4050,3660,3660,4440,0,0,0,0,0,1,-3368,5122,4440,4050,3660,3660,-0.11226666666666667,0.17073333333333332,0.148,0.135,0.122,0.122,0
769,70000,0,1,2,28,0,0,0,0,0,0,19728,16923,10076,33079,23188,20937,8000,2000,30000,5000,20000,25000,0,11728,14923,-19924,28079,3188,-4063,0.16754285714285713,0.21318571428571428,-0.28462857142857145,0.40112857142857145,0.04554285714285714,-0.058042857142857146,0
770,50000,0,3,2,49,0,0,0,2,0,0,26116,27192,29535,28761,29298,30111,1500,2803,0,1000,1300,1200,0,24616,24389,29535,27761,27998,28911,0.49232,0.48778,0.5907,0.55522,0.55996,0.57822,2
771,100000,0,2,2,39,0,0,0,0,0,0,121895,107315,115214,83649,59993,62813,4500,10000,11000,3000,4000,3000,0,117395,97315,104214,80649,55993,59813,1.17395,0.97315,1.04214,0.80649,0.55993,0.59813,0
772,40000,0,2,1,40,1,2,0,0,0,0,34364,33512,34549,35572,36481,37889,0,1577,1600,1500,2000,2000,1,34364,31935,32949,34072,34481,35889,0.8591,0.798375,0.823725,0.8518,0.862025,0.897225,3
773,40000,1,2,1,48,-1,0,0,0,0,0,27273,27207,28055,15199,17331,19428,2000,3000,3000,3000,3000,5000,1,25273,24207,25055,12199,14331,14428,0.631825,0.605175,0.626375,0.304975,0.358275,0.3607,-1
774,80000,0,1,2,38,-1,-1,-1,0,-1,-1,780,259,7544,390,390,332,259,7544,0,390,332,780,0,521,-7285,7544,0,58,-448,0.0065125,-0.0910625,0.0943,0.0,0.000725,-0.0056,-5
775,100000,0,2,2,41,-1,2,2,2,2,2,1941,3255,3056,4998,4769,9691,1500,0,2000,0,5000,0,0,441,3255,1056,4998,-231,9691,0.00441,0.03255,0.01056,0.04998,-0.00231,0.09691,9
776,70000,0,3,1,47,0,0,2,2,0,0,62080,67523,68334,67132,66796,67743,6874,2030,0,1866,1878,1909,1,55206,65493,68334,65266,64918,65834,0.7886571428571428,0.9356142857142857,0.9762,0.9323714285714285,0.9274,0.9404857142857143,4
777,380000,1,1,2,30,-2,-2,-1,0,0,0,-81,-303,32475,32891,33564,34056,223,33178,1171,1197,1250,5000,0,-304,-33481,31304,31694,32314,29056,-0.0008,-0.08810789473684211,0.08237894736842105,0.08340526315789473,0.08503684210526316,0.07646315789473684,-5
778,20000,0,2,1,53,0,0,2,2,2,2,16039,19752,19112,20223,18806,20001,4000,0,1382,0,3000,0,1,12039,19752,17730,20223,15806,20001,0.60195,0.9876,0.8865,1.01115,0.7903,1.00005,8
779,170000,0,2,2,31,0,-1,0,0,0,0,172012,167929,116189,192082,120077,92593,168019,5000,6000,7125,5000,4500,0,3993,162929,110189,184957,115077,88093,0.023488235294117647,0.9584058823529412,0.6481705882352942,1.0879823529411765,0.6769235294117647,0.5181941176470588,-1
780,80000,1,3,1,41,0,0,0,0,0,0,76095,78197,64065,54764,55868,57288,3500,2600,2000,2000,2303,2300,1,72595,75597,62065,52764,53565,54988,0.9074375,0.9449625,0.7758125,0.65955,0.6695625,0.68735,0
781,50000,1,3,1,45,0,0,0,0,0,0,48169,48163,49302,16522,15175,16371,2400,2500,1318,700,1600,600,1,45769,45663,47984,15822,13575,15771,0.91538,0.91326,0.95968,0.31644,0.2715,0.31542,0
782,60000,1,1,2,25,2,2,2,2,4,3,38050,39147,38223,43261,42009,41036,2000,0,6000,0,0,1400,0,36050,39147,32223,43261,42009,39636,0.6008333333333333,0.65245,0.53705,0.7210166666666666,0.70015,0.6606,15
783,200000,1,2,1,50,-2,-2,-2,-2,-2,-2,411,453,348,359,672,1620,453,348,359,672,1620,384,1,-42,105,-11,-313,-948,1236,-0.00021,0.000525,-5.5e-05,-0.001565,-0.00474,0.00618,-12
784,30000,1,3,1,28,0,0,0,2,0,0,23182,19083,19632,15252,14021,13793,2000,2000,0,1500,1353,0,1,21182,17083,19632,13752,12668,13793,0.7060666666666666,0.5694333333333333,0.6544,0.4584,0.4222666666666667,0.45976666666666666,2
785,30000,1,3,1,29,-1,-1,-1,0,0,0,3489,14926,9937,8027,14709,7483,14969,9942,10,10022,384,0,1,-11480,4984,9927,-1995,14325,7483,-0.38266666666666665,0.16613333333333333,0.3309,-0.0665,0.4775,0.24943333333333334,-3
786,90000,1,2,1,33,0,0,0,0,0,0,77379,67092,61071,44821,24653,25254,2500,3908,2100,884,1000,1000,1,74879,63184,58971,43937,23653,24254,0.8319888888888889,0.7020444444444445,0.6552333333333333,0.4881888888888889,0.2628111111111111,0.2694888888888889,0
787,230000,1,1,2,31,-1,-1,-1,-1,-1,0,2850,1940,8508,-853,13909,29160,1940,8508,0,19000,19160,0,0,910,-6568,8508,-19853,-5251,29160,0.003956521739130435,-0.028556521739130435,0.03699130434782609,-0.08631739130434783,-0.022830434782608697,0.12678260869565217,-5
788,220000,1,1,1,36,-1,-1,-1,-2,-1,-1,307,191,-125,-441,10243,9927,200,0,0,11000,10000,11000,1,107,191,-125,-11441,243,-1073,0.00048636363636363634,0.0008681818181818182,-0.0005681818181818182,-0.052004545454545456,0.0011045454545454546,-0.0048772727272727275,-7
789,60000,1,2,1,45,0,0,0,0,-1,-1,60244,59868,58221,16305,3124,29484,3000,2577,1525,3124,29484,1326,1,57244,57291,56696,13181,-26360,28158,0.9540666666666666,0.95485,0.9449333333333333,0.21968333333333334,-0.43933333333333335,0.4693,-2
790,200000,1,1,2,39,0,0,0,0,0,0,155693,158710,133245,131906,135533,137809,6000,5000,4871,5905,5491,5000,0,149693,153710,128374,126001,130042,132809,0.748465,0.76855,0.64187,0.630005,0.65021,0.664045,0
791,150000,1,2,1,37,-2,-1,-1,-2,-2,-1,0,1771,0,730,626,2718,1771,0,730,626,2718,0,1,-1771,1771,-730,104,-2092,2718,-0.011806666666666667,0.011806666666666667,-0.004866666666666667,0.0006933333333333333,-0.013946666666666666,0.01812,-9
792,20000,1,1,2,27,0,0,0,0,-1,-1,14088,8842,6653,2946,1186,416,1111,1009,7,1190,416,831,0,12977,7833,6646,1756,770,-415,0.64885,0.39165,0.3323,0.0878,0.0385,-0.02075,-2
793,260000,1,1,2,44,0,0,0,0,0,0,279670,286796,295631,299692,164332,183033,11778,15000,8526,20000,20000,20092,0,267892,271796,287105,279692,144332,162941,1.0303538461538462,1.0453692307692308,1.10425,1.0757384615384615,0.5551230769230769,0.6266961538461538,0
794,240000,1,2,2,30,0,-1,-1,-2,-2,-2,7818,9363,0,0,0,0,9434,0,0,0,0,178,0,-1616,9363,0,0,0,-178,-0.006733333333333333,0.0390125,0.0,0.0,0.0,-0.0007416666666666666,-8
795,220000,1,2,1,53,2,0,0,0,0,0,220389,223682,223193,215040,210884,210479,8490,8100,8000,7804,8254,6640,1,211899,215582,215193,207236,202630,203839,0.9631772727272727,0.9799181818181818,0.97815,0.9419818181818181,0.9210454545454545,0.9265409090909091,2
796,160000,1,2,1,35,2,2,2,2,2,2,131104,133828,135146,136520,139432,141971,6300,5000,5100,5252,5000,6000,1,124804,128828,130046,131268,134432,135971,0.780025,0.805175,0.8127875,0.820425,0.8402,0.84981875,12
797,300000,0,2,2,34,0,0,0,0,0,0,50281,51441,54107,55111,56688,58272,2000,3500,3000,2500,2500,2500,0,48281,47941,51107,52611,54188,55772,0.16093666666666667,0.15980333333333333,0.17035666666666666,0.17537,0.18062666666666666,0.18590666666666666,0
798,290000,0,1,2,31,2,0,0,0,0,0,45021,44702,35181,28847,28131,3016,2700,1707,1800,0,0,2411,0,42321,42995,33381,28847,28131,605,0.1459344827586207,0.14825862068965517,0.11510689655172414,0.09947241379310345,0.09700344827586208,0.002086206896551724,2
799,80000,1,2,2,23,-2,-2,-2,-2,-2,-2,0,2946,390,390,390,780,4419,390,390,390,780,0,0,-4419,2556,0,0,-390,780,-0.0552375,0.03195,0.0,0.0,-0.004875,0.00975,-12
800,60000,1,1,2,28,0,0,0,-1,-1,0,38991,13115,2958,4556,19213,18825,10008,2950,4556,19938,800,900,0,28983,10165,-1598,-15382,18413,17925,0.48305,0.16941666666666666,-0.026633333333333332,-0.2563666666666667,0.30688333333333334,0.29875,-2
801,280000,0,1,2,31,0,0,0,0,0,2,164736,170564,150666,133465,133536,132964,8833,12005,5000,8000,3000,5000,0,155903,158559,145666,125465,130536,127964,0.5567964285714285,0.5662821428571428,0.5202357142857142,0.4480892857142857,0.4662,0.4570142857142857,2
802,80000,0,3,1,48,0,0,0,0,0,0,76288,71659,67528,64035,60612,57532,3003,2403,3003,3001,2401,3109,1,73285,69256,64525,61034,58211,54423,0.9160625,0.8657,0.8065625,0.762925,0.7276375,0.6802875,0
803,30000,0,2,2,32,2,3,2,2,2,0,32704,31895,31091,31002,29879,29382,0,0,2300,0,996,1000,0,32704,31895,28791,31002,28883,28382,1.0901333333333334,1.0631666666666666,0.9597,1.0334,0.9627666666666667,0.9460666666666666,11
804,230000,1,2,1,62,0,0,0,0,0,0,167635,170085,172204,173045,176163,179625,6474,7726,5601,6100,6427,6000,1,161161,162359,166603,166945,169736,173625,0.7007,0.705908695652174,0.7243608695652174,0.7258478260869565,0.7379826086956521,0.7548913043478261,0
805,360000,1,4,2,28,0,0,0,0,-1,-1,243114,46734,12558,0,730,500,1587,1028,0,730,500,0,0,241527,45706,12558,-730,230,500,0.6709083333333333,0.1269611111111111,0.034883333333333336,-0.0020277777777777777,0.0006388888888888889,0.001388888888888889,-2
806,160000,1,1,2,30,-1,-1,-2,-1,-1,2,9640,0,0,2804,403,253,0,0,2804,403,0,3144,0,9640,0,-2804,2401,403,-2891,0.06025,0.0,-0.017525,0.01500625,0.00251875,-0.01806875,-4
807,330000,0,2,1,48,-2,-2,-2,-2,-2,-2,6051,8346,8952,2732,2732,2732,8387,8996,2745,2745,2745,2734,1,-2336,-650,6207,-13,-13,-2,-0.007078787878787879,-0.00196969696969697,0.01880909090909091,-3.939393939393939e-05,-3.939393939393939e-05,-6.060606060606061e-06,-12
808,30000,1,2,1,25,0,0,0,2,0,0,25530,26600,29765,28933,29205,29630,1500,3600,0,978,2300,0,1,24030,23000,29765,27955,26905,29630,0.801,0.7666666666666667,0.9921666666666666,0.9318333333333333,0.8968333333333334,0.9876666666666667,2
809,430000,1,3,2,30,0,0,0,0,0,0,308741,304476,277823,251443,236975,203526,12000,11000,11000,10000,8000,8000,0,296741,293476,266823,241443,228975,195526,0.6900953488372094,0.6825023255813953,0.6205186046511628,0.5614953488372093,0.5325,0.4547116279069767,0
810,300000,0,3,2,51,-1,-1,-1,-1,-1,-1,18341,19847,6246,3872,11875,5290,19854,6279,3883,11883,5305,9998,0,-1513,13568,2363,-8011,6570,-4708,-0.005043333333333334,0.045226666666666665,0.007876666666666667,-0.026703333333333332,0.0219,-0.015693333333333333,-6
811,210000,1,2,2,30,0,0,2,2,2,0,89670,94043,85022,90779,84209,70162,7500,103,10000,0,3000,2000,0,82170,93940,75022,90779,81209,68162,0.3912857142857143,0.44733333333333336,0.35724761904761904,0.4322809523809524,0.38670952380952384,0.32458095238095236,6
812,210000,1,2,2,32,-2,-2,-2,-2,-2,-2,0,0,980,0,0,0,0,980,0,0,0,238,0,0,-980,980,0,0,-238,0.0,-0.004666666666666667,0.004666666666666667,0.0,0.0,-0.0011333333333333334,-12
813,330000,1,2,1,51,0,0,0,2,0,0,208263,200865,194176,184986,173688,164579,10000,10500,8000,6000,6000,6000,1,198263,190365,186176,178986,167688,158579,0.6007969696969697,0.5768636363636364,0.564169696969697,0.5423818181818182,0.5081454545454546,0.4805424242424242,2
814,50000,0,2,2,49,5,4,3,2,0,0,52321,51210,50125,48640,17450,60,0,0,0,2000,1003,1076,0,52321,51210,50125,46640,16447,-1016,1.04642,1.0242,1.0025,0.9328,0.32894,-0.02032,14
815,260000,0,1,2,33,-1,-1,-1,-2,-1,-1,1025,799,-1,-1,358,492,803,0,0,359,494,0,0,222,799,-1,-360,-136,492,0.0008538461538461538,0.003073076923076923,-3.846153846153846e-06,-0.0013846153846153845,-0.0005230769230769231,0.0018923076923076923,-7
816,100000,1,2,1,38,0,0,0,2,2,2,89745,91659,96808,84528,67873,65503,3421,7728,0,5000,2600,0,1,86324,83931,96808,79528,65273,65503,0.86324,0.83931,0.96808,0.79528,0.65273,0.65503,6
817,100000,1,3,1,44,2,2,0,0,0,2,12724,12228,13255,13959,14921,14539,0,1529,1233,1195,0,1300,1,12724,10699,12022,12764,14921,13239,0.12724,0.10699,0.12022,0.12764,0.14921,0.13239,6
818,330000,1,2,1,39,1,-1,-1,-1,2,-1,0,1380,0,404,404,24420,1380,0,404,0,24420,480,1,-1380,1380,-404,404,-24016,23940,-0.0041818181818181815,0.0041818181818181815,-0.0012242424242424243,0.0012242424242424243,-0.07277575757575758,0.07254545454545455,-1
819,50000,0,1,2,30,0,0,0,-1,-1,-2,50457,51400,0,3794,0,0,2400,0,3794,0,0,9551,0,48057,51400,-3794,3794,0,-9551,0.96114,1.028,-0.07588,0.07588,0.0,-0.19102,-4
820,80000,1,2,1,40,-1,0,-1,-1,-1,-1,5143,8351,3234,1819,1909,1909,6458,3917,1819,2299,1909,3069,1,-1315,4434,1415,-480,0,-1160,-0.0164375,0.055425,0.0176875,-0.006,0.0,-0.0145,-5
821,210000,1,2,1,28,-2,-2,-2,-2,-2,-2,1412,1194,404,2851,2959,693,1194,404,2851,2959,782,2657,1,218,790,-2447,-108,2177,-1964,0.0010380952380952381,0.003761904761904762,-0.011652380952380952,-0.0005142857142857143,0.010366666666666666,-0.009352380952380952,-12
822,200000,1,2,1,44,0,0,0,2,0,0,120515,117292,24612,19527,16471,13408,3030,4452,0,708,656,1000,1,117485,112840,24612,18819,15815,12408,0.587425,0.5642,0.12306,0.094095,0.079075,0.06204,2
823,340000,0,3,2,38,-2,-2,-2,-2,-2,-2,660,1131,291,291,291,291,1131,291,291,291,291,8048,0,-471,840,0,0,0,-7757,-0.0013852941176470588,0.0024705882352941176,0.0,0.0,0.0,-0.022814705882352942,-12
824,30000,1,2,1,22,2,0,0,0,0,0,26846,27718,28067,28334,28984,14769,2000,1500,1000,800,728,1000,1,24846,26218,27067,27534,28256,13769,0.8282,0.8739333333333333,0.9022333333333333,0.9178,0.9418666666666666,0.4589666666666667,2
825,100000,0,1,2,27,1,-1,-1,0,-1,-1,0,429,858,429,429,429,429,858,0,429,429,429,0,-429,-429,858,0,0,0,-0.00429,-0.00429,0.00858,0.0,0.0,0.0,-3
826,80000,0,1,2,23,-1,-1,-1,-1,0,0,444,444,444,888,888,444,444,444,888,444,0,1038,0,0,0,-444,444,888,-594,0.0,0.0,-0.00555,0.00555,0.0111,-0.007425,-4
827,210000,1,1,1,34,0,0,0,0,0,0,201324,207222,209189,106090,108300,87404,10646,8601,3601,3719,3300,3400,1,190678,198621,205588,102371,105000,84004,0.9079904761904762,0.9458142857142857,0.9789904761904762,0.4874809523809524,0.5,0.4000190476190476,0
828,30000,0,2,2,30,0,0,0,0,0,0,7038,8052,10153,9761,9960,4010,1291,2392,1000,199,80,949,0,5747,5660,9153,9562,9880,3061,0.19156666666666666,0.18866666666666668,0.3051,0.3187333333333333,0.3293333333333333,0.10203333333333334,0
829,60000,1,2,3,33,-1,-1,-1,2,-1,-1,4260,780,390,390,390,390,780,390,0,390,390,2405,0,3480,390,390,0,0,-2015,0.058,0.0065,0.0065,0.0,0.0,-0.03358333333333333,-3
830,200000,0,1,2,28,-1,-1,-1,0,-1,-1,13383,1183,14714,11938,303,3262,1183,14714,0,303,3262,3635,0,12200,-13531,14714,11635,-2959,-373,0.061,-0.067655,0.07357,0.058175,-0.014795,-0.001865,-5
831,100000,1,2,2,23,0,0,0,0,0,2,85435,85957,86295,86945,94526,91630,3143,3052,3264,10398,0,3390,0,82292,82905,83031,76547,94526,88240,0.82292,0.82905,0.83031,0.76547,0.94526,0.8824,2
832,210000,1,2,2,28,0,0,0,0,0,0,40236,29230,24717,26563,22812,13620,2200,1854,2700,0,0,0,0,38036,27376,22017,26563,22812,13620,0.18112380952380952,0.13036190476190476,0.10484285714285714,0.12649047619047618,0.10862857142857144,0.06485714285714286,0
833,390000,1,1,2,28,0,0,0,0,0,0,125863,131249,119175,115922,101725,90334,10053,5028,5045,3012,3000,5572,0,115810,126221,114130,112910,98725,84762,0.29694871794871797,0.32364358974358975,0.2926410256410256,0.2895128205128205,0.25314102564102564,0.21733846153846154,0
834,90000,1,2,1,33,0,0,0,2,0,0,27180,26772,70398,56266,47804,44230,1405,56388,112,1779,1786,5414,1,25775,-29616,70286,54487,46018,38816,0.2863888888888889,-0.3290666666666667,0.7809555555555555,0.6054111111111111,0.5113111111111112,0.4312888888888889,2
835,210000,0,2,2,35,1,-2,-2,-2,-2,-2,0,0,0,0,0,0,0,0,0,0,0,0,0,0,0,0,0,0,0,0.0,0.0,0.0,0.0,0.0,0.0,-9
836,210000,1,2,2,44,0,0,0,0,0,0,84298,85379,87469,90380,91355,92565,3379,3469,4380,3355,3565,3607,0,80919,81910,83089,87025,87790,88958,0.3853285714285714,0.39004761904761903,0.39566190476190477,0.4144047619047619,0.41804761904761906,0.4236095238095238,0
837,140000,1,3,1,38,2,2,0,0,2,2,122283,118913,120435,139795,142950,140505,0,5000,21500,5500,0,5000,1,122283,113913,98935,134295,142950,135505,0.87345,0.8136642857142857,0.7066785714285714,0.95925,1.0210714285714286,0.9678928571428571,8
838,50000,0,3,1,51,0,0,0,0,0,0,43045,42965,43132,43995,43230,43334,1738,1653,1516,1530,2139,1572,1,41307,41312,41616,42465,41091,41762,0.82614,0.82624,0.83232,0.8493,0.82182,0.83524,0
839,150000,1,2,1,50,3,2,0,0,-2,-1,3227,3029,3964,0,0,2322,0,1000,0,0,2322,0,1,3227,2029,3964,0,-2322,2322,0.021513333333333332,0.013526666666666666,0.026426666666666668,0.0,-0.01548,0.01548,2
840,260000,0,1,1,53,-1,3,2,0,0,-1,1361,1188,792,792,396,2289,0,0,396,0,2289,164047,1,1361,1188,396,792,-1893,-161758,0.0052346153846153844,0.004569230769230769,0.001523076923076923,0.003046153846153846,-0.00728076923076923,-0.6221461538461538,3
841,200000,0,1,1,53,0,0,0,0,0,0,66012,68099,70387,71929,58133,40500,2500,2700,2242,2093,1300,0,1,63512,65399,68145,69836,56833,40500,0.31756,0.326995,0.340725,0.34918,0.284165,0.2025,0
842,280000,1,2,2,35,0,0,0,0,0,0,184050,171714,154940,136894,138467,128473,7088,6107,5000,5057,5005,50012,0,176962,165607,149940,131837,133462,78461,0.6320071428571429,0.5914535714285715,0.5355,0.47084642857142855,0.47665,0.28021785714285713,0
843,240000,1,1,1,41,-1,-1,-1,-1,-1,-1,4420,16829,4745,2430,7792,33196,16920,4774,2442,7829,33361,1076,1,-12500,12055,2303,-5399,-25569,32120,-0.052083333333333336,0.050229166666666665,0.009595833333333333,-0.022495833333333333,-0.1065375,0.13383333333333333,-6
844,220000,1,2,1,32,0,0,0,0,0,0,194961,197536,203251,208355,213015,217475,7200,9000,10000,8000,8010,8500,1,187761,188536,193251,200355,205005,208975,0.8534590909090909,0.8569818181818182,0.8784136363636363,0.9107045454545455,0.9318409090909091,0.9498863636363636,0
845,180000,1,2,2,29,1,2,0,0,0,2,77494,75658,76942,80419,90715,37376,0,3100,5000,11000,1000,1000,0,77494,72558,71942,69419,89715,36376,0.4305222222222222,0.4031,0.3996777777777778,0.3856611111111111,0.4984166666666667,0.2020888888888889,5
846,30000,1,1,2,23,0,0,0,0,0,0,28239,29974,29841,27592,17569,4059,2500,1011,301,37,17,0,0,25739,28963,29540,27555,17552,4059,0.8579666666666667,0.9654333333333334,0.9846666666666667,0.9185,0.5850666666666666,0.1353,0
847,180000,1,2,2,34,0,0,0,0,0,0,18314,18630,19126,12939,6939,3439,2000,2000,1042,0,0,191,0,16314,16630,18084,12939,6939,3248,0.09063333333333333,0.0923888888888889,0.10046666666666666,0.07188333333333333,0.03855,0.018044444444444443,0
848,20000,1,2,1,26,0,0,0,0,0,0,18141,17718,18058,18623,15692,15215,1600,1700,1509,1000,670,740,1,16541,16018,16549,17623,15022,14475,0.82705,0.8009,0.82745,0.88115,0.7511,0.72375,0
849,400000,0,1,1,38,-2,-2,-2,-2,-2,-2,23052,7754,13052,12639,12315,7831,8025,13972,13046,13040,7923,14533,1,15027,-6218,6,-401,4392,-6702,0.0375675,-0.015545,1.5e-05,-0.0010025,0.01098,-0.016755,-12
850,20000,0,2,2,25,0,0,0,0,0,0,13896,12906,13983,10983,5400,0,2000,2500,2000,0,0,0,0,11896,10406,11983,10983,5400,0,0.5948,0.5203,0.59915,0.54915,0.27,0.0,0
851,140000,0,1,2,35,-1,-1,-1,-1,-1,-1,325,537,4233,857,325,325,537,4233,857,325,325,954,0,-212,-3696,3376,532,0,-629,-0.0015142857142857143,-0.0264,0.024114285714285713,0.0038,0.0,-0.004492857142857143,-6
852,50000,0,1,2,46,0,0,0,0,0,0,49386,49487,50401,49148,30036,29873,2000,2500,2040,2000,1037,2000,0,47386,46987,48361,47148,28999,27873,0.94772,0.93974,0.96722,0.94296,0.57998,0.55746,0
853,300000,0,1,2,32,1,2,2,-1,0,0,10566,11293,12000,3458,56338,56735,1200,1200,9427,55000,2000,2000,0,9366,10093,2573,-51542,54338,54735,0.03122,0.03364333333333333,0.008576666666666666,-0.17180666666666666,0.18112666666666666,0.18245,4
854,280000,0,2,2,33,0,0,0,0,0,0,265120,238661,223383,162196,165129,168295,9104,9401,6001,6001,6201,6201,0,256016,229260,217382,156195,158928,162094,0.9143428571428571,0.8187857142857143,0.7763642857142857,0.5578392857142858,0.5676,0.5789071428571428,0
855,310000,0,1,1,39,1,-1,0,0,0,0,166517,18901,19781,22432,24058,25646,150000,1500,3000,2000,2000,3000,1,16517,17401,16781,20432,22058,22646,0.05328064516129032,0.056132258064516126,0.05413225806451613,0.06590967741935484,0.07115483870967743,0.0730516129032258,0
856,50000,0,2,2,24,0,0,0,0,0,0,47530,46155,28650,19659,19802,19699,1537,1679,688,713,858,660,0,45993,44476,27962,18946,18944,19039,0.91986,0.88952,0.55924,0.37892,0.37888,0.38078,0
857,500000,0,1,1,34,-2,-1,-1,-1,-1,-1,33348,90852,42389,19238,34750,21464,90889,42398,19244,34750,21464,28557,1,-57541,48454,23145,-15512,13286,-7093,-0.115082,0.096908,0.04629,-0.031024,0.026572,-0.014186,-7
858,230000,0,3,2,41,0,0,0,0,0,0,9552,11376,13185,14648,15419,15423,2000,2000,2000,1000,562,2000,0,7552,9376,11185,13648,14857,13423,0.03283478260869565,0.04076521739130435,0.04863043478260869,0.05933913043478261,0.06459565217391304,0.05836086956521739,0
859,260000,1,1,1,36,0,0,-1,-1,0,0,10942,7045,246,7156,7164,3677,3000,246,7178,5164,1209,1209,1,7942,6799,-6932,1992,5955,2468,0.030546153846153848,0.02615,-0.026661538461538462,0.007661538461538462,0.022903846153846153,0.009492307692307692,-2
860,110000,0,3,1,41,0,0,0,0,0,0,53497,51110,48995,46772,33220,31858,2510,2509,2031,1507,2032,1521,1,50987,48601,46964,45265,31188,30337,0.46351818181818183,0.44182727272727274,0.4269454545454546,0.4115,0.28352727272727274,0.2757909090909091,0
861,160000,1,1,1,41,-1,-1,-1,-1,-1,-1,24411,7944,1080,0,40100,18899,7944,1080,0,40100,18899,4180,1,16467,6864,1080,-40100,21201,14719,0.10291875,0.0429,0.00675,-0.250625,0.13250625,0.09199375,-6
862,210000,1,1,1,36,0,0,-2,-2,-2,-2,15991,0,0,0,0,0,0,0,0,0,0,0,1,15991,0,0,0,0,0,0.07614761904761905,0.0,0.0,0.0,0.0,0.0,-8
863,50000,1,1,1,34,0,0,0,0,0,0,46750,48317,48282,18299,19323,20329,2320,1282,3299,1323,1329,1114,1,44430,47035,44983,16976,17994,19215,0.8886,0.9407,0.89966,0.33952,0.35988,0.3843,0
864,240000,0,1,1,43,-2,-2,-2,-2,-2,-2,3645,9077,4234,7118,8187,8708,9088,4234,7118,8187,8708,9291,1,-5443,4843,-2884,-1069,-521,-583,-0.022679166666666667,0.020179166666666668,-0.012016666666666667,-0.004454166666666667,-0.002170833333333333,-0.0024291666666666667,-12
865,240000,0,2,1,49,-2,-2,-2,-2,-2,-2,4639,1825,973,-110,-110,-110,1838,976,110,0,0,0,1,2801,849,863,-110,-110,-110,0.011670833333333333,0.0035375,0.0035958333333333333,-0.0004583333333333333,-0.0004583333333333333,-0.0004583333333333333,-12
866,50000,1,2,2,29,1,2,2,2,0,0,46376,45354,49086,48027,49037,48032,0,4500,0,1751,1736,2971,0,46376,40854,49086,46276,47301,45061,0.92752,0.81708,0.98172,0.92552,0.94602,0.90122,7
867,50000,0,2,1,29,1,2,0,0,0,2,23451,22781,24108,25203,26681,26117,0,2000,1800,2200,0,2250,1,23451,20781,22308,23003,26681,23867,0.46902,0.41562,0.44616,0.46006,0.53362,0.47734,5
868,800000,0,1,2,46,-2,-2,-2,-1,-1,-1,6229,4636,3810,6193,1957,3175,4644,3832,6219,1961,3183,27201,0,1585,804,-2409,4232,-1226,-24026,0.00198125,0.001005,-0.00301125,0.00529,-0.0015325,-0.0300325,-9
869,130000,0,2,1,55,-1,2,2,-1,-1,2,780,780,390,390,1080,540,390,0,390,1080,0,390,1,390,780,0,-690,1080,150,0.003,0.006,0.0,-0.0053076923076923075,0.008307692307692308,0.001153846153846154,3
870,250000,0,1,1,39,-1,-1,-2,-1,-1,-1,1852,0,0,2576,20552,0,0,0,2576,20739,0,2231,1,1852,0,-2576,-18163,20552,-2231,0.007408,0.0,-0.010304,-0.072652,0.082208,-0.008924,-7
871,200000,0,2,2,32,-1,-1,-1,-1,-1,-1,9249,9362,11109,9471,11132,9633,9363,11119,9473,11140,9636,23635,0,-114,-1757,1636,-1669,1496,-14002,-0.00057,-0.008785,0.00818,-0.008345,0.00748,-0.07001,-6
872,130000,1,2,1,45,0,0,0,0,0,0,79277,63767,62599,51950,44189,38034,3500,3022,2000,2000,2000,2000,1,75777,60745,60599,49950,42189,36034,0.5829,0.46726923076923077,0.4661461538461538,0.3842307692307692,0.32453076923076923,0.27718461538461536,0
873,50000,1,2,1,28,-1,-1,-1,2,-1,-1,1019,1672,836,836,836,1517,1672,836,0,836,1517,1394,1,-653,836,836,0,-681,123,-0.01306,0.01672,0.01672,0.0,-0.01362,0.00246,-3
874,200000,1,1,2,40,0,0,0,0,0,0,132563,135202,137111,137121,139343,141859,4841,5047,4922,4926,5105,5500,0,127722,130155,132189,132195,134238,136359,0.63861,0.650775,0.660945,0.660975,0.67119,0.681795,0
875,80000,0,2,1,52,0,0,0,0,0,0,75113,76860,77456,21118,22260,23396,3500,2202,1500,1500,1500,1500,1,71613,74658,75956,19618,20760,21896,0.8951625,0.933225,0.94945,0.245225,0.2595,0.2737,0
876,200000,1,1,1,47,-1,-1,-1,-1,-1,-1,935,1418,-2,120,150,928,1418,0,122,300,928,464,1,-483,1418,-124,-180,-778,464,-0.002415,0.00709,-0.00062,-0.0009,-0.00389,0.00232,-6
877,150000,1,2,1,33,1,2,0,0,0,0,42932,42010,46007,47978,49100,50181,0,5000,3000,2000,2000,2000,1,42932,37010,43007,45978,47100,48181,0.2862133333333333,0.24673333333333333,0.2867133333333333,0.30652,0.314,0.32120666666666664,3
878,20000,1,2,1,36,2,0,0,0,2,0,17638,17058,17541,19338,17889,18486,1666,1149,1946,0,1007,0,1,15972,15909,15595,19338,16882,18486,0.7986,0.79545,0.77975,0.9669,0.8441,0.9243,4
879,130000,1,1,2,34,-2,-2,-2,-2,-2,-2,0,0,388,0,418,0,0,388,0,418,0,238,0,0,-388,388,-418,418,-238,0.0,-0.0029846153846153846,0.0029846153846153846,-0.003215384615384615,0.003215384615384615,-0.0018307692307692309,-12
880,50000,0,3,2,40,0,0,0,0,-1,0,50693,50019,36939,29500,19655,20067,1747,1515,3076,20693,679,653,0,48946,48504,33863,8807,18976,19414,0.97892,0.97008,0.67726,0.17614,0.37952,0.38828,-1
881,360000,0,1,1,62,-1,-1,-1,-1,-1,-1,5875,7279,6894,7143,1787,19526,7289,6918,7148,1792,19541,3689,1,-1414,361,-254,5351,-17754,15837,-0.003927777777777777,0.0010027777777777778,-0.0007055555555555555,0.014863888888888888,-0.04931666666666667,0.043991666666666665,-6
882,50000,1,3,1,47,0,0,0,0,0,0,32516,32774,33597,29105,26154,27699,1870,1693,1106,1473,3000,2507,1,30646,31081,32491,27632,23154,25192,0.61292,0.62162,0.64982,0.55264,0.46308,0.50384,0
883,90000,0,2,1,34,0,0,0,0,0,0,86371,85679,87036,88742,49148,48396,3073,3700,3374,1543,1405,1500,1,83298,81979,83662,87199,47743,46896,0.9255333333333333,0.9108777777777778,0.9295777777777777,0.9688777777777777,0.5304777777777778,0.5210666666666667,0
884,210000,1,2,1,48,-1,-1,-1,-1,-1,0,11876,11876,11876,11876,18954,11876,11876,11876,11876,18954,5000,11876,1,0,0,0,-7078,13954,0,0.0,0.0,0.0,-0.033704761904761904,0.06644761904761905,0.0,-5
885,210000,1,2,1,30,0,0,0,0,0,0,104701,106134,108423,91143,82733,74125,4002,5000,3500,3000,2700,5000,1,100699,101134,104923,88143,80033,69125,0.4795190476190476,0.4815904761904762,0.4996333333333333,0.41972857142857145,0.3811095238095238,0.32916666666666666,0
886,490000,0,1,2,44,-1,-1,-1,-1,-1,-1,2920,4040,3649,8343,6641,5779,4060,3659,8357,6660,5796,4736,0,-1140,381,-4708,1683,845,1043,-0.002326530612244898,0.0007775510204081632,-0.009608163265306122,0.0034346938775510205,0.0017244897959183673,0.0021285714285714285,-6
887,260000,1,1,1,32,-2,-2,-2,-2,-2,-2,0,0,0,0,0,1150,0,0,0,0,1150,0,1,0,0,0,0,-1150,1150,0.0,0.0,0.0,0.0,-0.004423076923076923,0.004423076923076923,-12
888,20000,1,3,1,50,2,0,0,0,0,0,15887,16895,18379,19020,18620,19000,1275,1759,1400,0,380,0,1,14612,15136,16979,19020,18240,19000,0.7306,0.7568,0.84895,0.951,0.912,0.95,2
889,170000,0,1,1,60,0,0,0,0,0,0,170359,178514,98196,100108,95629,89472,11700,3600,3500,3500,3300,3500,1,158659,174914,94696,96608,92329,85972,0.9332882352941176,1.0289058823529411,0.5570352941176471,0.5682823529411765,0.5431117647058824,0.5057176470588235,0
890,40000,0,1,2,25,-1,-1,-1,0,0,-1,511,513,1531,1017,506,499,513,1531,0,0,499,0,0,-2,-1018,1531,1017,7,499,-5e-05,-0.02545,0.038275,0.025425,0.000175,0.012475,-4
891,50000,1,1,2,29,0,0,0,0,0,0,41897,17304,16544,14787,15975,17098,4000,2000,3000,3000,3000,3000,0,37897,15304,13544,11787,12975,14098,0.75794,0.30608,0.27088,0.23574,0.2595,0.28196,0
892,100000,1,2,1,35,0,0,0,0,0,0,77394,76081,61898,53035,15785,7762,2640,3007,2300,200,290,50000,1,74754,73074,59598,52835,15495,-42238,0.74754,0.73074,0.59598,0.52835,0.15495,-0.42238,0
893,210000,0,3,1,50,-1,-1,-1,-1,-1,-1,4137,390,390,4962,0,780,390,390,4962,0,780,6668,1,3747,0,-4572,4962,-780,-5888,0.017842857142857143,0.0,-0.02177142857142857,0.02362857142857143,-0.0037142857142857142,-0.028038095238095237,-6
894,320000,1,1,1,45,1,-2,-2,-1,-1,-1,0,0,0,370,9301,0,0,0,370,9301,0,0,1,0,0,-370,-8931,9301,0,0.0,0.0,-0.00115625,-0.027909375,0.029065625,0.0,-6
895,50000,1,2,1,26,0,0,0,0,0,0,41891,33849,30220,30235,28979,23593,1781,2016,1450,1314,814,978,1,40110,31833,28770,28921,28165,22615,0.8022,0.63666,0.5754,0.57842,0.5633,0.4523,0
896,220000,1,2,1,41,-2,-2,-2,-2,-2,-2,24435,2131,36010,1050,9522,2340,2142,36204,1055,9569,6995,492,1,22293,-34073,34955,-8519,2527,1848,0.10133181818181818,-0.15487727272727272,0.15888636363636363,-0.03872272727272727,0.011486363636363637,0.0084,-12
897,110000,1,3,2,32,-1,-1,-1,-1,-1,0,9943,9267,4957,6037,7628,2746,9284,6960,6055,7651,8,5159,0,659,2307,-1098,-1614,7620,-2413,0.005990909090909091,0.02097272727272727,-0.009981818181818182,-0.014672727272727273,0.06927272727272728,-0.021936363636363636,-5
898,320000,0,2,1,35,0,0,0,0,0,0,10125,11475,12549,10853,11755,7559,1526,1600,1098,1000,272,300,1,8599,9875,11451,9853,11483,7259,0.026871875,0.030859375,0.035784375,0.030790625,0.035884375,0.022684375,0
899,200000,1,3,2,47,2,2,2,2,2,2,199436,202947,193936,196186,200162,189915,8214,7000,6800,7134,0,6836,0,191222,195947,187136,189052,200162,183079,0.95611,0.979735,0.93568,0.94526,1.00081,0.915395,12
900,260000,1,2,1,37,1,-1,-1,-1,0,-1,0,312,920,37686,36523,574,312,920,37686,0,574,348,1,-312,-608,-36766,37686,35949,226,-0.0012,-0.0023384615384615384,-0.14140769230769232,0.14494615384615384,0.13826538461538462,0.0008692307692307693,-3
901,30000,0,1,1,38,8,7,6,5,4,3,35031,34552,33756,32960,31881,31085,0,0,0,0,0,0,1,35031,34552,33756,32960,31881,31085,1.1677,1.1517333333333333,1.1252,1.0986666666666667,1.0627,1.0361666666666667,33
902,20000,1,3,1,47,0,0,0,0,2,0,19753,19728,19763,20240,18955,15255,1401,1306,2000,0,800,800,1,18352,18422,17763,20240,18155,14455,0.9176,0.9211,0.88815,1.012,0.90775,0.72275,2
903,180000,1,1,2,42,-1,0,0,0,0,0,4314,5495,54903,56458,58616,55032,2500,50000,3000,3000,2000,2500,0,1814,-44505,51903,53458,56616,52532,0.010077777777777778,-0.24725,0.28835,0.2969888888888889,0.31453333333333333,0.29184444444444446,-1
904,130000,1,2,1,47,-1,-1,-1,-1,-1,-2,2317,29,2595,1030,-1121,-2452,3000,3000,1000,897,0,2003,1,-683,-2971,1595,133,-1121,-4455,-0.005253846153846154,-0.022853846153846155,0.012269230769230768,0.001023076923076923,-0.008623076923076923,-0.03426923076923077,-7
905,300000,1,2,1,38,-1,-1,-1,-1,0,0,5848,24718,45114,16949,9537,0,24718,45533,17136,0,0,0,1,-18870,-20815,27978,16949,9537,0,-0.0629,-0.06938333333333334,0.09326,0.05649666666666667,0.03179,0.0,-4
906,180000,1,1,2,27,-1,2,-1,-1,-1,2,980,980,376,0,2202,150,0,376,0,2202,0,819,0,980,604,376,-2202,2202,-669,0.0054444444444444445,0.0033555555555555556,0.002088888888888889,-0.012233333333333334,0.012233333333333334,-0.0037166666666666667,0
907,400000,1,1,1,55,-1,-1,-1,-1,0,0,153951,193159,72201,199209,179290,9780,193358,72356,199209,411,0,126743,1,-39407,120803,-127008,198798,179290,-116963,-0.0985175,0.3020075,-0.31752,0.496995,0.448225,-0.2924075,-4
908,160000,1,2,2,38,0,0,0,0,0,0,133017,125321,122044,111799,92039,89536,7008,6300,5000,3000,2606,4006,0,126009,119021,117044,108799,89433,85530,0.78755625,0.74388125,0.731525,0.67999375,0.55895625,0.5345625,0
909,140000,0,1,2,26,0,0,-2,-2,-1,-1,17376,4879,6266,4379,420,0,4907,6284,4392,420,0,245,0,12469,-1405,1874,3959,420,-245,0.08906428571428572,-0.010035714285714285,0.013385714285714286,0.028278571428571427,0.003,-0.00175,-6
910,20000,0,3,1,57,-1,-1,-1,-1,0,0,390,390,390,21515,2942,0,390,390,10728,59,0,0,1,0,0,-10338,21456,2942,0,0.0,0.0,-0.5169,1.0728,0.1471,0.0,-4
911,390000,1,1,2,30,0,0,0,0,0,0,86124,89129,90294,92243,94186,97562,4300,3437,3346,3475,5000,10005,0,81824,85692,86948,88768,89186,87557,0.2098051282051282,0.2197230769230769,0.22294358974358974,0.22761025641025642,0.22868205128205127,0.22450512820512822,0
912,200000,1,3,2,47,0,0,0,0,0,0,203183,202961,194449,196814,200526,198717,7521,7000,7000,7128,8000,7100,0,195662,195961,187449,189686,192526,191617,0.97831,0.979805,0.937245,0.94843,0.96263,0.958085,0
913,210000,1,2,1,36,0,0,0,0,0,0,54717,55522,54929,55696,54773,51616,2017,1900,1900,1925,1845,1886,1,52700,53622,53029,53771,52928,49730,0.2509523809523809,0.25534285714285715,0.25251904761904764,0.256052380952381,0.2520380952380952,0.2368095238095238,0
914,100000,1,3,2,25,0,0,0,0,0,0,97997,97018,94247,62919,10492,4809,4000,4046,4752,4000,4500,3000,0,93997,92972,89495,58919,5992,1809,0.93997,0.92972,0.89495,0.58919,0.05992,0.01809,0
915,500000,1,3,2,29,0,0,0,0,0,0,110651,94609,95607,95276,90310,91229,3005,3027,6024,3003,2334,4087,0,107646,91582,89583,92273,87976,87142,0.215292,0.183164,0.179166,0.184546,0.175952,0.174284,0
916,440000,0,1,1,79,0,0,0,0,0,0,429309,437906,447326,447112,438187,447543,15715,16519,16513,15800,16531,15677,1,413594,421387,430813,431312,421656,431866,0.9399863636363637,0.9576977272727273,0.9791204545454546,0.9802545454545455,0.9583090909090909,0.9815136363636363,0
917,150000,1,2,1,45,-1,-1,-1,-2,-2,-2,16611,18540,18204,16132,-5880,-20544,18552,18267,16142,5880,13707,1088,1,-1941,273,2062,10252,-19587,-21632,-0.01294,0.00182,0.013746666666666667,0.06834666666666667,-0.13058,-0.14421333333333333,-9
918,150000,1,2,2,36,0,0,0,0,0,0,134797,138269,144163,146171,136004,138903,5600,8000,5775,5000,5200,3320,0,129197,130269,138388,141171,130804,135583,0.8613133333333334,0.86846,0.9225866666666667,0.94114,0.8720266666666666,0.9038866666666666,0
919,200000,1,1,1,27,1,-2,-1,2,0,0,-896,2500,653,653,653,0,7052,653,0,0,0,1300,1,-7948,1847,653,653,653,-1300,-0.03974,0.009235,0.003265,0.003265,0.003265,-0.0065,0
920,10000,0,2,2,31,-1,-1,-1,-1,-1,-2,390,390,0,780,0,0,390,0,780,0,0,0,0,0,390,-780,780,0,0,0.0,0.039,-0.078,0.078,0.0,0.0,-7
921,80000,1,2,1,34,2,2,2,0,0,0,76142,80627,76776,61884,55501,54840,6611,1,3000,2504,2000,2200,1,69531,80626,73776,59380,53501,52640,0.8691375,1.007825,0.9222,0.74225,0.6687625,0.658,6
922,300000,1,1,2,31,0,0,0,0,-1,-1,31827,11158,1616,3658,658,662,1009,1000,2700,658,662,0,0,30818,10158,-1084,3000,-4,662,0.10272666666666666,0.03386,-0.0036133333333333334,0.01,-1.3333333333333333e-05,0.0022066666666666667,-2
923,190000,0,3,1,34,0,0,0,0,0,0,187780,189924,192232,186472,190262,193403,6781,7071,6744,6866,7203,7182,1,180999,182853,185488,179606,183059,186221,0.9526263157894737,0.9623842105263158,0.9762526315789474,0.9452947368421053,0.9634684210526315,0.9801105263157894,0
924,50000,1,2,2,34,0,0,0,0,0,0,47303,48427,48069,49081,48485,49484,2807,3008,2812,2000,2000,2000,0,44496,45419,45257,47081,46485,47484,0.88992,0.90838,0.90514,0.94162,0.9297,0.94968,0
925,80000,0,1,2,24,-1,0,-1,2,-1,0,2130,3100,173,173,3435,11962,1010,173,0,3438,10004,5500,0,1120,2927,173,-3265,-6569,6462,0.014,0.0365875,0.0021625,-0.0408125,-0.0821125,0.080775,-1
926,50000,1,2,1,47,0,0,0,0,0,0,48991,43412,33995,29759,29766,29665,2000,1500,1050,1100,1100,1200,1,46991,41912,32945,28659,28666,28465,0.93982,0.83824,0.6589,0.57318,0.57332,0.5693,0
927,80000,0,2,2,53,0,0,0,0,0,0,80577,78781,78363,48902,49996,-1719,3261,2342,1630,1759,0,52085,0,77316,76439,76733,47143,49996,-53804,0.96645,0.9554875,0.9591625,0.5892875,0.62495,-0.67255,0
928,120000,1,3,1,43,0,0,0,0,0,0,116032,114987,117491,118513,75278,77070,4201,5001,4134,2700,3000,5030,1,111831,109986,113357,115813,72278,72040,0.931925,0.91655,0.9446416666666667,0.9651083333333333,0.6023166666666666,0.6003333333333334,0
929,90000,1,2,1,29,0,0,0,0,0,0,5618,6645,7635,8020,8403,9504,1125,1115,500,500,1252,154,1,4493,5530,7135,7520,7151,9350,0.04992222222222222,0.06144444444444445,0.07927777777777778,0.08355555555555555,0.07945555555555556,0.10388888888888889,0
930,350000,1,1,2,39,-1,-1,-1,-1,-1,-1,3860,648,11094,4041,4485,9364,648,11198,4057,4523,9407,3948,0,3212,-10550,7037,-482,-4922,5416,0.009177142857142858,-0.03014285714285714,0.020105714285714286,-0.0013771428571428572,-0.014062857142857143,0.015474285714285715,-6
931,160000,1,3,1,37,0,0,0,0,0,0,17500,15933,19536,7550,6977,7811,10000,10000,3006,3000,3000,0,1,7500,5933,16530,4550,3977,7811,0.046875,0.03708125,0.1033125,0.0284375,0.02485625,0.04881875,0
932,240000,1,2,1,49,-2,-1,2,-1,-1,-1,0,2353,2135,3305,0,5370,2421,0,3305,0,5370,4605,1,-2421,2353,-1170,3305,-5370,765,-0.0100875,0.009804166666666666,-0.004875,0.013770833333333333,-0.022375,0.0031875,-4
933,330000,1,2,1,28,0,0,0,0,0,2,221793,225079,229947,233122,246414,253338,10000,10000,8507,17215,11000,0,1,211793,215079,221440,215907,235414,253338,0.6417969696969696,0.6517545454545455,0.671030303030303,0.6542636363636364,0.7133757575757576,0.7676909090909091,2
934,500000,1,3,1,44,2,-1,0,0,0,-1,1273,79108,329774,328950,336073,1257,79113,255005,6780,8401,1262,2120,1,-77840,-175897,322994,320549,334811,-863,-0.15568,-0.351794,0.645988,0.641098,0.669622,-0.001726,0
935,20000,1,2,1,43,1,2,0,0,0,0,17188,16619,17341,18352,18716,19109,0,1294,1305,669,694,697,1,17188,15325,16036,17683,18022,18412,0.8594,0.76625,0.8018,0.88415,0.9011,0.9206,3
936,50000,1,2,1,39,3,3,2,0,0,0,52714,51593,50492,47633,18283,18610,0,0,5000,3000,1000,2000,1,52714,51593,45492,44633,17283,16610,1.05428,1.03186,0.90984,0.89266,0.34566,0.3322,8
937,500000,1,1,1,34,0,0,0,0,0,0,30376,32715,60927,76088,110294,108964,15000,30007,30000,50000,5000,5000,1,15376,2708,30927,26088,105294,103964,0.030752,0.005416,0.061854,0.052176,0.210588,0.207928,0
938,360000,0,1,2,27,-1,-1,-1,-1,-1,-1,5810,4036,2310,1300,0,348,4041,2310,1300,0,348,1080,0,1769,1726,1010,1300,-348,-732,0.004913888888888889,0.004794444444444444,0.0028055555555555555,0.003611111111111111,-0.0009666666666666667,-0.002033333333333333,-6
939,180000,1,1,1,47,-1,-1,-1,-1,-1,-1,8059,11622,16379,9795,8414,6557,11680,16466,9844,8456,6589,5823,1,-3621,-4844,6535,1339,1825,734,-0.020116666666666668,-0.02691111111111111,0.036305555555555556,0.007438888888888889,0.010138888888888888,0.004077777777777777,-6
940,100000,1,1,3,47,0,0,0,0,0,0,43175,42669,42238,41646,40976,40503,1680,1722,1603,1406,1598,1502,0,41495,40947,40635,40240,39378,39001,0.41495,0.40947,0.40635,0.4024,0.39378,0.39001,0
941,50000,0,2,1,22,0,0,0,-1,-1,0,47559,50463,49094,1884,19792,19809,3690,2500,942,19792,727,792,1,43869,47963,48152,-17908,19065,19017,0.87738,0.95926,0.96304,-0.35816,0.3813,0.38034,-2
942,50000,1,2,1,36,2,2,2,2,0,0,46203,45159,49125,47956,43578,35126,0,4700,0,2004,3500,0,1,46203,40459,49125,45952,40078,35126,0.92406,0.80918,0.9825,0.91904,0.80156,0.70252,8
943,140000,1,1,1,33,1,-1,-1,-2,-2,-2,0,840,0,0,0,0,840,0,0,0,0,0,1,-840,840,0,0,0,0,-0.006,0.006,0.0,0.0,0.0,0.0,-7
944,50000,0,1,2,23,-1,-1,-1,-1,-1,-1,980,3413,1068,1386,2800,3696,3500,11000,2000,2000,6396,3000,0,-2520,-7587,-932,-614,-3596,696,-0.0504,-0.15174,-0.01864,-0.01228,-0.07192,0.01392,-6
945,290000,1,2,2,36,0,0,0,0,0,0,320952,326625,290268,296053,302793,307336,11149,10524,10600,11500,10000,65000,0,309803,316101,279668,284553,292793,242336,1.0682862068965517,1.090003448275862,0.9643724137931035,0.9812172413793103,1.0096310344827586,0.8356413793103449,0
946,400000,0,1,1,34,-1,-1,-2,-1,-1,-1,43711,37077,70369,15283,17668,4841,37954,71577,15973,18285,4875,647,1,5757,-34500,54396,-3002,12793,4194,0.0143925,-0.08625,0.13599,-0.007505,0.0319825,0.010485,-7
947,210000,0,2,2,26,0,0,-2,-2,-1,2,9358,-27,-27,-27,3073,2878,0,0,0,3100,0,2003,0,9358,-27,-27,-3127,3073,875,0.04456190476190476,-0.00012857142857142858,-0.00012857142857142858,-0.01489047619047619,0.014633333333333333,0.004166666666666667,-3
948,60000,0,3,2,27,0,0,0,0,0,0,37170,36918,10163,10692,15307,19838,2000,3000,1000,5000,5000,1000,0,35170,33918,9163,5692,10307,18838,0.5861666666666666,0.5653,0.15271666666666667,0.09486666666666667,0.17178333333333334,0.31396666666666667,0
949,220000,1,1,2,29,-2,-2,-2,-2,-2,-2,19030,14287,8183,21189,7838,321,14287,8194,22000,7838,321,21317,0,4743,6093,-13817,13351,7517,-20996,0.02155909090909091,0.027695454545454544,-0.06280454545454546,0.060686363636363636,0.03416818181818182,-0.09543636363636364,-12
950,360000,1,1,2,30,-2,-2,-2,-2,-2,-2,-28,-28,1072,1980,10780,2036,0,1100,2025,10819,2110,5600,0,-28,-1128,-953,-8839,8670,-3564,-7.777777777777778e-05,-0.0031333333333333335,-0.0026472222222222223,-0.024552777777777778,0.024083333333333335,-0.0099,-12
951,120000,1,2,2,26,1,2,2,2,2,2,52623,51208,57538,56019,60135,61298,0,7200,0,5200,2300,0,0,52623,44008,57538,50819,57835,61298,0.438525,0.36673333333333336,0.4794833333333333,0.42349166666666666,0.4819583333333333,0.5108166666666667,11
952,390000,0,1,2,31,0,0,0,0,0,0,381453,375926,363787,291427,260026,178599,15024,30002,15052,10507,25001,25082,0,366429,345924,348735,280920,235025,153517,0.9395615384615384,0.8869846153846154,0.8941923076923077,0.7203076923076923,0.6026282051282051,0.39363333333333334,0
953,170000,1,2,2,34,-1,-1,-1,-1,-1,-1,3105,1599,1122,1692,648,0,1599,1122,1692,648,0,631,0,1506,477,-570,1044,648,-631,0.008858823529411764,0.0028058823529411763,-0.003352941176470588,0.006141176470588235,0.003811764705882353,-0.0037117647058823528,-6
954,280000,1,2,2,27,1,2,0,0,0,0,297192,284462,283374,238039,234017,145132,0,11143,7300,6024,6000,3500,0,297192,273319,276074,232015,228017,141632,1.0614,0.9761392857142858,0.9859785714285715,0.828625,0.8143464285714286,0.5058285714285714,3
955,70000,0,2,2,29,0,0,0,0,-1,-1,58305,61710,64114,66775,161,5746,5000,4000,5000,161,5800,1500,0,53305,57710,59114,66614,-5639,4246,0.7615,0.8244285714285714,0.8444857142857143,0.9516285714285714,-0.08055714285714285,0.060657142857142854,-2
956,50000,0,3,1,57,3,2,0,0,0,0,12854,12362,13447,13427,13711,14083,0,1600,500,500,600,600,1,12854,10762,12947,12927,13111,13483,0.25708,0.21524,0.25894,0.25854,0.26222,0.26966,5
957,180000,1,2,1,38,0,0,0,0,0,2,36479,38813,40611,42641,45287,44577,2810,2600,2568,3214,0,1630,1,33669,36213,38043,39427,45287,42947,0.18705,0.20118333333333333,0.21135,0.2190388888888889,0.25159444444444445,0.23859444444444444,2
958,20000,0,2,2,22,0,0,0,2,0,0,8785,8134,9992,10526,11049,11865,1142,2000,1000,1000,1000,1000,0,7643,6134,8992,9526,10049,10865,0.38215,0.3067,0.4496,0.4763,0.50245,0.54325,2
959,230000,0,2,2,41,2,0,0,0,0,0,225043,229701,229250,229572,213420,218809,10000,11000,9000,9000,9000,9000,0,215043,218701,220250,220572,204420,209809,0.9349695652173913,0.9508739130434782,0.9576086956521739,0.959008695652174,0.8887826086956522,0.9122130434782608,2
960,100000,0,2,1,30,0,0,0,0,0,-2,37218,33720,24666,10550,0,0,1641,1200,1000,0,0,0,1,35577,32520,23666,10550,0,0,0.35577,0.3252,0.23666,0.1055,0.0,0.0,-2
961,50000,1,2,2,23,2,0,0,0,0,0,48668,48554,45445,38551,28056,28310,4034,2000,5008,1000,2000,1000,0,44634,46554,40437,37551,26056,27310,0.89268,0.93108,0.80874,0.75102,0.52112,0.5462,2
962,80000,0,2,2,26,0,0,0,0,0,0,80233,79849,77796,30300,29922,29120,4000,2300,1300,1300,1500,1500,0,76233,77549,76496,29000,28422,27620,0.9529125,0.9693625,0.9562,0.3625,0.355275,0.34525,0
963,140000,0,2,1,36,1,-1,0,0,0,0,119279,6771,13380,18415,20135,27390,10000,10000,8000,5000,22000,42000,1,109279,-3229,5380,13415,-1865,-14610,0.7805642857142857,-0.023064285714285714,0.03842857142857143,0.09582142857142857,-0.013321428571428571,-0.10435714285714286,0
964,20000,0,2,1,50,1,2,2,2,0,0,18206,18217,19930,780,780,0,1000,3000,0,0,0,0,1,17206,15217,19930,780,780,0,0.8603,0.76085,0.9965,0.039,0.039,0.0,7
965,360000,1,2,1,69,-2,-2,-2,-2,-2,-2,0,0,0,0,0,0,0,0,0,0,0,0,1,0,0,0,0,0,0,0.0,0.0,0.0,0.0,0.0,0.0,-12
966,180000,0,2,2,34,-2,-2,-2,-2,-2,-2,-16,-16,-16,850,0,0,0,0,866,0,0,0,0,-16,-16,-882,850,0,0,-8.888888888888889e-05,-8.888888888888889e-05,-0.0049,0.004722222222222222,0.0,0.0,-12
967,80000,1,2,2,29,-1,-1,-1,2,0,-1,1443,1443,4545,2886,1443,3743,1443,4545,0,0,3743,3000,0,0,-3102,4545,2886,-2300,743,0.0,-0.038775,0.0568125,0.036075,-0.02875,0.0092875,-2
968,20000,0,2,1,38,0,0,0,0,0,0,8337,11191,12219,14009,15773,17515,3000,1210,2000,2000,2000,1200,1,5337,9981,10219,12009,13773,16315,0.26685,0.49905,0.51095,0.60045,0.68865,0.81575,0
969,500000,1,1,1,45,-2,-2,-2,-2,-2,-2,1905,3640,162,0,151,2530,3640,162,0,151,2530,0,1,-1735,3478,162,-151,-2379,2530,-0.00347,0.006956,0.000324,-0.000302,-0.004758,0.00506,-12
970,50000,0,1,2,26,0,0,0,0,0,0,12571,13656,15407,17127,17569,18162,1600,2280,2000,1000,1000,2000,0,10971,11376,13407,16127,16569,16162,0.21942,0.22752,0.26814,0.32254,0.33138,0.32324,0
971,220000,1,1,1,43,-1,-1,-1,2,-1,0,941,911,9743,7480,22880,880,920,9752,0,22880,0,7270,1,21,-8841,9743,-15400,22880,-6390,9.545454545454546e-05,-0.04018636363636364,0.04428636363636364,-0.07,0.104,-0.029045454545454544,-2
972,30000,1,2,2,36,-1,-1,-1,0,0,-1,390,390,780,390,0,780,390,780,0,0,780,0,0,0,-390,780,390,-780,780,0.0,-0.013,0.026,0.013,-0.026,0.026,-4
973,70000,0,1,2,31,-2,-2,-2,-2,-2,-2,25856,13737,7716,25732,46671,26516,13737,7716,25740,46684,26516,56017,0,12119,6021,-18024,-20952,20155,-29501,0.17312857142857144,0.08601428571428571,-0.25748571428571426,-0.2993142857142857,0.2879285714285714,-0.4214428571428571,-12
974,260000,1,1,1,38,-2,-1,-1,-2,-2,-2,622,3074,0,688,2605,377,3084,691,0,2613,378,693,1,-2462,2383,0,-1925,2227,-316,-0.00946923076923077,0.009165384615384615,0.0,-0.007403846153846154,0.008565384615384615,-0.0012153846153846154,-10
975,240000,1,4,2,36,-2,-1,2,0,0,-2,-235,1765,871,871,-155,-155,2000,0,0,155,0,0,0,-2235,1765,871,716,-155,-155,-0.0093125,0.007354166666666667,0.003629166666666667,0.0029833333333333335,-0.0006458333333333333,-0.0006458333333333333,-3
976,280000,1,2,1,50,-1,-1,-1,-1,-1,0,8740,4919,176823,117686,36708,18126,4919,176823,117686,36708,363,853,1,3821,-171904,59137,80978,36345,17273,0.013646428571428572,-0.6139428571428571,0.21120357142857143,0.2892071428571429,0.12980357142857143,0.06168928571428572,-5
977,50000,0,2,2,33,0,0,0,0,0,0,50094,50461,50994,30521,30242,30193,2479,2412,1162,1199,1223,1199,0,47615,48049,49832,29322,29019,28994,0.9523,0.96098,0.99664,0.58644,0.58038,0.57988,0
978,130000,1,2,1,51,0,0,0,0,0,0,124619,128845,131045,94390,91111,93112,6301,6000,5000,4000,3500,4000,1,118318,122845,126045,90390,87611,89112,0.9101384615384616,0.9449615384615384,0.9695769230769231,0.6953076923076923,0.6739307692307692,0.6854769230769231,0
979,30000,1,3,2,41,0,0,0,0,0,2,24217,24216,25254,27099,30297,28817,2000,3000,3000,5000,0,1500,0,22217,21216,22254,22099,30297,27317,0.7405666666666667,0.7072,0.7418,0.7366333333333334,1.0099,0.9105666666666666,2
980,100000,1,1,2,30,2,2,2,2,0,0,92162,93769,95163,74656,65718,78474,3800,3420,80,1800,17000,2000,0,88362,90349,95083,72856,48718,76474,0.88362,0.90349,0.95083,0.72856,0.48718,0.76474,8
981,20000,1,2,1,47,3,2,2,2,2,2,17772,18487,17892,19294,19840,19376,1300,0,1700,1000,0,850,1,16472,18487,16192,18294,19840,18526,0.8236,0.92435,0.8096,0.9147,0.992,0.9263,13
982,200000,1,2,2,46,-2,-2,-2,-2,-2,-2,430,430,430,5241,430,59415,430,430,5241,439,59415,1999,0,0,0,-4811,4802,-58985,57416,0.0,0.0,-0.024055,0.02401,-0.294925,0.28708,-12
983,140000,0,3,1,45,2,2,2,2,2,2,134073,130521,137328,136280,136247,134089,0,10707,5014,5091,4608,42,1,134073,119814,132314,131189,131639,134047,0.9576642857142857,0.8558142857142857,0.9451,0.9370642857142857,0.9402785714285714,0.9574785714285714,12
984,50000,0,1,2,33,1,2,2,0,0,2,26957,28230,27483,27728,29681,29053,2000,0,1000,2400,0,2400,0,24957,28230,26483,25328,29681,26653,0.49914,0.5646,0.52966,0.50656,0.59362,0.53306,7
985,10000,0,3,1,39,1,2,0,0,0,0,10866,10094,9212,9633,9550,9334,0,1201,1062,254,288,365,1,10866,8893,8150,9379,9262,8969,1.0866,0.8893,0.815,0.9379,0.9262,0.8969,3
986,120000,0,2,2,38,-1,-1,-2,-1,2,2,500,0,0,974,974,1624,0,0,974,0,650,0,0,500,0,-974,974,324,1624,0.004166666666666667,0.0,-0.008116666666666666,0.008116666666666666,0.0027,0.013533333333333333,-1
987,110000,0,2,2,25,2,0,0,0,0,0,38449,38433,37038,38336,12907,13541,3000,1800,2000,600,1000,5000,0,35449,36633,35038,37736,11907,8541,0.32226363636363636,0.3330272727272727,0.3185272727272727,0.34305454545454545,0.10824545454545455,0.07764545454545455,2
988,100000,0,2,1,52,1,2,2,2,2,2,15420,16927,16432,18019,17501,18786,2000,0,2100,0,1500,0,1,13420,16927,14332,18019,16001,18786,0.1342,0.16927,0.14332,0.18019,0.16001,0.18786,11
989,320000,0,2,2,29,0,0,0,0,0,0,146515,131130,123226,111975,95510,79385,4697,5920,4000,3012,3000,3000,0,141818,125210,119226,108963,92510,76385,0.44318125,0.39128125,0.37258125,0.340509375,0.28909375,0.238703125,0
990,360000,1,3,2,42,-2,-2,-2,-2,-2,-2,0,0,0,0,0,0,0,0,0,0,0,0,0,0,0,0,0,0,0,0.0,0.0,0.0,0.0,0.0,0.0,-12
991,140000,1,4,2,26,0,0,-2,-2,-1,0,75000,0,0,0,51571,55731,0,0,0,51571,5001,3001,0,75000,0,0,-51571,46570,52730,0.5357142857142857,0.0,0.0,-0.3683642857142857,0.33264285714285713,0.37664285714285717,-5
992,180000,0,2,1,36,0,0,0,0,0,0,184661,183112,183172,183117,179277,183394,7000,7000,7000,6411,7000,7000,1,177661,176112,176172,176706,172277,176394,0.9870055555555556,0.9784,0.9787333333333333,0.9817,0.9570944444444445,0.9799666666666667,0
993,180000,1,3,2,45,0,0,0,2,0,0,76942,77952,80269,66855,67128,67257,4003,5603,3,2504,2511,3021,0,72939,72349,80266,64351,64617,64236,0.40521666666666667,0.4019388888888889,0.4459222222222222,0.3575055555555556,0.3589833333333333,0.35686666666666667,2
994,250000,0,2,1,44,-1,0,-1,0,0,-2,4602,18382,15450,1867,-1,-1,5000,16000,0,1,0,0,1,-398,2382,15450,1866,-1,-1,-0.001592,0.009528,0.0618,0.007464,-4e-06,-4e-06,-4
995,120000,1,1,1,51,0,0,0,-1,0,0,82865,82741,62914,60584,61412,55572,3652,1258,60584,1228,0,0,1,79213,81483,2330,59356,61412,55572,0.6601083333333333,0.679025,0.019416666666666665,0.4946333333333333,0.5117666666666667,0.4631,-1
996,500000,0,1,1,46,0,0,0,0,0,-1,53049,66623,70194,68618,67300,1825,16018,10000,4,333,1831,597,1,37031,56623,70190,68285,65469,1228,0.074062,0.113246,0.14038,0.13657,0.130938,0.002456,-1
997,490000,1,2,1,30,0,0,0,0,0,-1,26088,24092,24488,16995,-1527,62491,2003,2041,1092,4,64895,3003,1,24085,22051,23396,16991,-66422,59488,0.04915306122448979,0.04500204081632653,0.04774693877551021,0.03467551020408163,-0.13555510204081633,0.12140408163265307,-1
998,70000,0,2,2,28,1,2,2,2,2,2,26357,27223,27492,28738,27977,30022,1600,1000,2000,0,2500,0,0,24757,26223,25492,28738,25477,30022,0.3536714285714286,0.37461428571428573,0.3641714285714286,0.41054285714285715,0.36395714285714287,0.42888571428571426,11
999,470000,1,1,2,31,-2,-2,-2,-2,-2,-2,22988,10353,5603,11685,5093,2791,10363,5910,13380,5093,2791,9527,0,12625,4443,-7777,6592,2302,-6736,0.026861702127659575,0.009453191489361702,-0.0165468085106383,0.014025531914893617,0.004897872340425532,-0.014331914893617022,-12
1000,180000,1,1,2,43,-2,-2,-2,-2,-2,-2,0,0,0,5436,100,9330,0,0,5436,100,9330,0,0,0,0,-5436,5336,-9230,9330,0.0,0.0,-0.0302,0.029644444444444445,-0.051277777777777776,0.051833333333333335,-12
1001,500000,1,1,1,36,-1,-1,-1,0,0,0,24170,8051,77908,50297,43679,49749,8091,78192,65,33766,37945,37947,1,16079,-70141,77843,16531,5734,11802,0.032158,-0.140282,0.155686,0.033062,0.011468,0.023604,-3
1002,60000,0,2,1,38,0,0,2,0,0,0,72930,71123,67405,63559,60048,56458,5000,3000,3000,3000,2000,3000,1,67930,68123,64405,60559,58048,53458,1.1321666666666668,1.1353833333333334,1.0734166666666667,1.0093166666666666,0.9674666666666667,0.8909666666666667,2
1003,180000,1,2,2,26,0,0,0,0,0,-1,7149,12946,16163,13142,9800,4857,5946,3663,3159,3000,4857,6240,0,1203,9283,13004,10142,4943,-1383,0.006683333333333334,0.05157222222222222,0.07224444444444444,0.05634444444444445,0.02746111111111111,-0.007683333333333334,-1
1004,30000,1,3,1,60,-1,3,2,0,0,3,5867,5621,4090,2829,2108,1801,0,0,0,1801,0,0,1,5867,5621,4090,1028,2108,1801,0.19556666666666667,0.18736666666666665,0.13633333333333333,0.03426666666666667,0.07026666666666667,0.060033333333333334,7
1005,160000,1,1,1,48,1,-2,-2,-2,-2,-2,0,0,0,0,0,0,0,0,0,0,0,0,1,0,0,0,0,0,0,0.0,0.0,0.0,0.0,0.0,0.0,-9
1006,30000,1,3,2,24,2,2,2,2,2,3,15335,14804,16546,15985,17869,17291,0,2300,0,2300,0,0,0,15335,12504,16546,13685,17869,17291,0.5111666666666667,0.4168,0.5515333333333333,0.45616666666666666,0.5956333333333333,0.5763666666666667,13
1007,100000,1,2,2,35,-1,-1,-1,-1,-1,0,1046,2700,2187,678,2040,944,2702,2187,678,2040,0,0,0,-1656,513,1509,-1362,2040,944,-0.01656,0.00513,0.01509,-0.01362,0.0204,0.00944,-5
1008,200000,0,1,1,32,0,0,0,0,0,0,30144,32649,32425,32625,9687,5526,3000,1000,1000,400,1000,752,1,27144,31649,31425,32225,8687,4774,0.13572,0.158245,0.157125,0.161125,0.043435,0.02387,0
1009,300000,0,1,2,42,-2,-2,-2,-2,-2,-2,161772,111664,123854,0,0,0,114402,127180,0,0,0,0,0,47370,-15516,123854,0,0,0,0.1579,-0.05172,0.41284666666666664,0.0,0.0,0.0,-12
1010,300000,0,2,1,40,0,0,0,0,0,0,25492,28048,30582,33059,35498,39902,3000,3000,3000,3000,5000,5000,1,22492,25048,27582,30059,30498,34902,0.07497333333333334,0.08349333333333334,0.09194,0.10019666666666667,0.10166,0.11634,0
1011,230000,1,2,1,29,0,0,0,0,0,0,69853,61844,24802,61631,46396,28311,2310,2000,49000,1500,1000,2000,1,67543,59844,-24198,60131,45396,26311,0.29366521739130436,0.2601913043478261,-0.10520869565217392,0.2614391304347826,0.19737391304347826,0.11439565217391304,0
1012,220000,0,2,2,29,0,0,0,0,0,0,223773,223304,221631,182629,165314,161971,8391,9000,6901,6000,6000,6435,0,215382,214304,214730,176629,159314,155536,0.9790090909090909,0.9741090909090909,0.9760454545454545,0.8028590909090909,0.7241545454545455,0.7069818181818182,0
1013,20000,0,3,2,27,0,0,-2,-2,-2,-2,36908,0,0,0,0,0,0,0,0,0,0,0,0,36908,0,0,0,0,0,1.8454,0.0,0.0,0.0,0.0,0.0,-8
1014,170000,1,1,1,50,-2,-2,-2,-2,-2,-2,3955,5269,1986,1611,316,1608,5269,1986,1611,316,1608,2957,1,-1314,3283,375,1295,-1292,-1349,-0.007729411764705882,0.019311764705882355,0.0022058823529411764,0.007617647058823529,-0.0076,-0.00793529411764706,-12
1015,200000,1,2,1,34,0,0,0,0,0,0,5481,6430,4494,4771,9454,8595,1068,1140,1000,5000,3000,3000,1,4413,5290,3494,-229,6454,5595,0.022065,0.02645,0.01747,-0.001145,0.03227,0.027975,0
1016,50000,0,2,2,27,0,0,0,0,0,0,47452,48663,50297,36164,37616,39062,2000,2500,2000,2000,2000,2000,0,45452,46163,48297,34164,35616,37062,0.90904,0.92326,0.96594,0.68328,0.71232,0.74124,0
1017,360000,0,1,1,40,-2,-2,-2,-2,-2,-2,5772,11664,15390,7090,2115,20075,11694,10048,35,2126,21220,35114,1,-5922,1616,15355,4964,-19105,-15039,-0.01645,0.004488888888888889,0.042652777777777776,0.013788888888888889,-0.05306944444444445,-0.041775,-12
1018,560000,1,1,2,32,0,0,0,0,0,0,68199,31211,23991,15488,12579,11400,1548,1446,14720,427,1000,300,0,66651,29765,9271,15061,11579,11100,0.11901964285714285,0.053151785714285714,0.016555357142857142,0.026894642857142857,0.020676785714285714,0.01982142857142857,0
1019,360000,0,2,1,35,1,-2,-2,-2,-2,-2,-103,-103,-103,-103,-103,-103,0,0,0,0,0,0,1,-103,-103,-103,-103,-103,-103,-0.0002861111111111111,-0.0002861111111111111,-0.0002861111111111111,-0.0002861111111111111,-0.0002861111111111111,-0.0002861111111111111,-9
1020,30000,1,1,2,24,0,0,0,0,0,0,28885,27924,27709,27457,26848,26407,1459,1414,952,1002,832,2698,0,27426,26510,26757,26455,26016,23709,0.9142,0.8836666666666667,0.8919,0.8818333333333334,0.8672,0.7903,0
1021,50000,1,2,2,24,0,0,0,0,0,0,48393,49405,50934,7728,8390,48679,1814,2343,1137,799,41933,1943,0,46579,47062,49797,6929,-33543,46736,0.93158,0.94124,0.99594,0.13858,-0.67086,0.93472,0
1022,280000,1,2,1,37,0,0,0,-2,-2,-2,198823,206000,0,0,0,0,10000,0,0,0,0,0,1,188823,206000,0,0,0,0,0.6743678571428572,0.7357142857142858,0.0,0.0,0.0,0.0,-6
1023,80000,0,2,3,40,0,0,0,0,0,0,72185,76854,72408,72832,46473,50329,12660,4573,3500,2000,5000,2000,0,59525,72281,68908,70832,41473,48329,0.7440625,0.9035125,0.86135,0.8854,0.5184125,0.6041125,0
1024,330000,1,2,2,30,-2,-2,-2,-2,-2,-2,0,0,0,0,0,0,0,0,0,0,0,0,0,0,0,0,0,0,0,0.0,0.0,0.0,0.0,0.0,0.0,-12
1025,240000,1,2,2,25,0,0,0,0,0,0,175764,178600,182639,186275,190337,193961,6500,7000,6680,7070,6954,14870,0,169264,171600,175959,179205,183383,179091,0.7052666666666667,0.715,0.7331625,0.7466875,0.7640958333333333,0.7462125,0
1026,70000,0,2,2,51,0,0,0,0,0,0,67880,66658,58486,29171,17725,17693,3028,3199,1267,642,651,1665,0,64852,63459,57219,28529,17074,16028,0.9264571428571429,0.9065571428571428,0.8174142857142858,0.40755714285714284,0.24391428571428572,0.22897142857142858,0
1027,160000,1,3,2,24,0,0,0,0,0,0,153470,151486,153378,93971,96587,96623,10000,4600,4800,5000,3000,1000,0,143470,146886,148578,88971,93587,95623,0.8966875,0.9180375,0.9286125,0.55606875,0.58491875,0.59764375,0
1028,200000,1,2,1,46,0,0,0,0,0,0,106651,103173,104137,103422,95206,65108,3692,5000,3300,2500,2930,1500,1,102959,98173,100837,100922,92276,63608,0.514795,0.490865,0.504185,0.50461,0.46138,0.31804,0
1029,400000,1,2,2,24,0,0,-1,-1,-1,-1,14925,12559,3926,500,1236,11975,5000,3926,500,1236,11975,253,0,9925,8633,3426,-736,-10739,11722,0.0248125,0.0215825,0.008565,-0.00184,-0.0268475,0.029305,-4
1030,100000,0,3,2,47,0,0,0,0,0,-2,94667,97088,99520,102650,0,0,4000,4000,5000,0,0,0,0,90667,93088,94520,102650,0,0,0.90667,0.93088,0.9452,1.0265,0.0,0.0,-2
1031,760000,0,3,1,54,0,0,0,0,0,0,447670,455970,462497,469931,474421,480598,20011,19500,19019,18003,20000,22000,1,427659,436470,443478,451928,454421,458598,0.5627092105263158,0.5743026315789473,0.5835236842105264,0.5946421052631579,0.5979223684210526,0.6034184210526315,0
1032,30000,1,1,2,29,1,2,2,0,0,0,12517,13027,12421,6105,5083,0,1006,0,0,0,0,0,0,11511,13027,12421,6105,5083,0,0.3837,0.43423333333333336,0.4140333333333333,0.2035,0.16943333333333332,0.0,5
1033,250000,0,3,1,50,0,0,0,0,0,2,254893,258013,263493,268861,274444,290235,9316,9637,9765,10021,20300,10023,1,245577,248376,253728,258840,254144,280212,0.982308,0.993504,1.014912,1.03536,1.016576,1.120848,2
1034,150000,1,1,2,29,0,0,0,0,0,0,145138,140210,136196,105989,98836,94504,5200,7982,4500,4048,3800,3818,0,139938,132228,131696,101941,95036,90686,0.93292,0.88152,0.8779733333333334,0.6796066666666667,0.6335733333333333,0.6045733333333333,0
1035,70000,0,1,2,27,0,0,0,0,-2,-1,64317,59944,30206,0,0,5000,2500,1000,0,0,5000,5862,0,61817,58944,30206,0,-5000,-862,0.8831,0.8420571428571428,0.43151428571428574,0.0,-0.07142857142857142,-0.012314285714285715,-3
1036,50000,0,2,2,44,0,0,0,0,0,0,49699,49685,28637,38137,27128,29992,2300,1487,21704,3000,15000,18300,0,47399,48198,6933,35137,12128,11692,0.94798,0.96396,0.13866,0.70274,0.24256,0.23384,0
1037,70000,1,2,2,23,1,2,0,0,0,-1,72306,70543,63061,61520,63080,2900,4,2407,2041,2387,2905,72697,0,72302,68136,61020,59133,60175,-69797,1.0328857142857142,0.9733714285714286,0.8717142857142857,0.8447571428571429,0.8596428571428572,-0.9971,2
1038,420000,1,2,2,26,0,0,0,0,0,0,24434,22586,36569,28994,15159,9379,1500,28000,1210,303,2000,0,0,22934,-5414,35359,28691,13159,9379,0.054604761904761906,-0.01289047619047619,0.08418809523809524,0.06831190476190477,0.03133095238095238,0.022330952380952382,0
1039,120000,1,1,2,29,0,0,0,0,0,0,121805,120933,120629,116316,117358,118560,4600,4300,4200,4219,4500,7600,0,117205,116633,116429,112097,112858,110960,0.9767083333333333,0.9719416666666667,0.9702416666666667,0.9341416666666666,0.9404833333333333,0.9246666666666666,0
1040,30000,1,2,2,24,1,2,2,2,2,0,16704,18121,19030,19424,18818,23307,2000,1500,1000,0,5000,2000,0,14704,16621,18030,19424,13818,21307,0.4901333333333333,0.5540333333333334,0.601,0.6474666666666666,0.4606,0.7102333333333334,9
1041,60000,1,2,1,38,0,0,0,0,0,0,55120,47123,48367,48264,29144,27534,1735,1979,1443,988,974,2001,1,53385,45144,46924,47276,28170,25533,0.88975,0.7524,0.7820666666666667,0.7879333333333334,0.4695,0.42555,0
1042,50000,1,2,3,44,0,0,0,0,0,0,42941,44002,43378,28048,28477,29056,1800,2122,1600,1000,1000,1000,0,41141,41880,41778,27048,27477,28056,0.82282,0.8376,0.83556,0.54096,0.54954,0.56112,0
1043,30000,1,2,2,39,-2,-2,-2,-2,-2,-2,2416,2226,2230,561,2230,565,2230,2238,561,2238,565,564,0,186,-12,1669,-1677,1665,1,0.0062,-0.0004,0.05563333333333333,-0.0559,0.0555,3.3333333333333335e-05,-12
1044,500000,1,3,2,37,1,2,0,0,0,0,5186,3985,3935,4861,4523,4637,0,1101,1027,117,141,72,0,5186,2884,2908,4744,4382,4565,0.010372,0.005768,0.005816,0.009488,0.008764,0.00913,3
1045,20000,1,1,2,25,1,2,2,2,2,3,8483,10186,10871,10402,12077,11594,2000,1000,0,2000,0,0,0,6483,9186,10871,8402,12077,11594,0.32415,0.4593,0.54355,0.4201,0.60385,0.5797,12
1046,110000,1,2,1,35,0,0,0,0,0,0,28969,29568,30379,84257,84762,86139,1500,1706,55000,3200,3300,3300,1,27469,27862,-24621,81057,81462,82839,0.2497181818181818,0.25329090909090907,-0.22382727272727274,0.7368818181818182,0.7405636363636363,0.7530818181818182,0
1047,50000,1,3,2,44,0,0,0,0,0,0,43828,40684,37338,31278,31811,28656,1947,1829,1644,4405,1104,2504,0,41881,38855,35694,26873,30707,26152,0.83762,0.7771,0.71388,0.53746,0.61414,0.52304,0
1048,360000,1,1,2,34,1,-2,-2,-2,-2,-2,0,0,0,0,0,0,0,0,0,0,0,0,0,0,0,0,0,0,0,0.0,0.0,0.0,0.0,0.0,0.0,-9
1049,100000,1,1,1,31,1,-2,-2,-2,-2,-1,0,0,0,0,0,6179,0,0,0,0,6179,0,1,0,0,0,0,-6179,6179,0.0,0.0,0.0,0.0,-0.06179,0.06179,-8
1050,60000,0,2,2,31,0,0,0,0,0,2,53234,54361,55395,56416,58792,56130,2580,2557,2500,4500,0,2000,0,50654,51804,52895,51916,58792,54130,0.8442333333333333,0.8634,0.8815833333333334,0.8652666666666666,0.9798666666666667,0.9021666666666667,2
1051,20000,0,2,2,23,1,-2,-2,-2,-2,-2,0,0,0,0,0,0,0,0,0,0,0,0,0,0,0,0,0,0,0,0.0,0.0,0.0,0.0,0.0,0.0,-9
1052,20000,0,2,1,38,2,2,2,2,2,2,6313,8625,8338,9199,9378,9081,2426,0,1000,471,0,482,1,3887,8625,7338,8728,9378,8599,0.19435,0.43125,0.3669,0.4364,0.4689,0.42995,12
1053,210000,0,2,2,37,0,0,0,0,0,0,18896,19777,20803,21816,22250,22716,1500,1350,1363,797,825,829,0,17396,18427,19440,21019,21425,21887,0.08283809523809524,0.08774761904761905,0.09257142857142857,0.10009047619047619,0.10202380952380953,0.10422380952380952,0
1054,170000,1,1,1,39,1,2,0,0,0,2,161105,145908,119161,120662,127815,125098,0,6000,5000,9000,0,6000,1,161105,139908,114161,111662,127815,119098,0.9476764705882353,0.8229882352941177,0.671535294117647,0.6568352941176471,0.7518529411764706,0.7005764705882352,5
1055,80000,1,2,1,31,0,0,0,0,0,0,51346,52955,54063,54608,55695,56786,3000,2500,2000,2500,2500,2500,1,48346,50455,52063,52108,53195,54286,0.604325,0.6306875,0.6507875,0.65135,0.6649375,0.678575,0
1056,200000,1,1,2,42,-1,-1,-1,-1,-1,-1,1347,208,1582,3607,894,301,208,1677,3607,894,301,2457,0,1139,-1469,-2025,2713,593,-2156,0.005695,-0.007345,-0.010125,0.013565,0.002965,-0.01078,-6
1057,220000,0,1,2,37,0,0,0,0,0,0,34339,35075,32355,31573,51279,53590,1294,2000,2000,30000,3000,2000,0,33045,33075,30355,1573,48279,51590,0.15020454545454545,0.15034090909090908,0.13797727272727273,0.00715,0.21945,0.2345,0
1058,50000,1,2,2,31,2,2,2,2,2,2,28947,30072,30895,31589,32071,32709,1900,1600,1500,1300,1300,1500,0,27047,28472,29395,30289,30771,31209,0.54094,0.56944,0.5879,0.60578,0.61542,0.62418,12
1059,50000,0,2,2,27,2,2,0,0,0,0,49079,47992,48502,49170,49891,50570,0,1842,1770,1751,3894,0,0,49079,46150,46732,47419,45997,50570,0.98158,0.923,0.93464,0.94838,0.91994,1.0114,4
1060,90000,0,3,1,62,0,0,-1,0,0,0,98784,52485,46978,47512,48111,48761,1050,47003,1680,1734,1828,1737,1,97734,5482,45298,45778,46283,47024,1.0859333333333334,0.06091111111111111,0.5033111111111112,0.5086444444444445,0.5142555555555556,0.5224888888888889,-1
1061,230000,1,2,2,38,-1,-1,-1,-1,-1,-1,10237,2795,1350,371,2980,0,2795,1350,371,2980,0,2213,0,7442,1445,979,-2609,2980,-2213,0.03235652173913044,0.006282608695652174,0.004256521739130435,-0.011343478260869564,0.012956521739130434,-0.009621739130434783,-6
1062,280000,1,1,2,37,0,0,0,0,0,0,280323,284176,283680,273446,279458,269333,10505,10424,10047,10683,10073,9084,0,269818,273752,273633,262763,269385,260249,0.9636357142857143,0.9776857142857143,0.9772607142857143,0.9384392857142857,0.9620892857142858,0.9294607142857143,0
1063,170000,1,2,2,28,0,-1,0,0,0,0,30860,167941,171459,173310,240738,135722,304815,8000,8127,4810,5000,5400,0,-273955,159941,163332,168500,235738,130322,-1.6115,0.9408294117647059,0.9607764705882353,0.9911764705882353,1.3866941176470589,0.7666,-1
1064,400000,1,1,2,48,-1,-1,-1,0,0,-1,24478,10841,53336,25017,16039,38994,10846,53383,16044,0,39727,0,0,13632,-42542,37292,25017,-23688,38994,0.03408,-0.106355,0.09323,0.0625425,-0.05922,0.097485,-4
1065,80000,1,3,2,65,2,0,0,0,0,0,85882,84985,84247,81619,30095,20639,3900,4000,2048,1300,1700,401,0,81982,80985,82199,80319,28395,20238,1.024775,1.0123125,1.0274875,1.0039875,0.3549375,0.252975,2
1066,200000,0,1,2,26,-2,-2,-1,0,0,0,0,1516,11533,9463,3884,3033,1516,11533,189,1000,2050,11300,0,-1516,-10017,11344,8463,1834,-8267,-0.00758,-0.050085,0.05672,0.042315,0.00917,-0.041335,-5
1067,230000,1,1,1,51,-1,-1,-1,-1,-1,-1,986,2295,2754,74,3381,2308,2295,2764,74,3381,2308,2381,1,-1309,-469,2680,-3307,1073,-73,-0.005691304347826087,-0.002039130434782609,0.011652173913043478,-0.014378260869565217,0.004665217391304348,-0.0003173913043478261,-6
1068,20000,1,3,2,33,0,0,0,0,0,0,20023,20239,19164,19393,19725,20054,1300,1400,1300,1000,1000,1000,0,18723,18839,17864,18393,18725,19054,0.93615,0.94195,0.8932,0.91965,0.93625,0.9527,0
1069,60000,1,2,1,46,0,0,0,0,0,0,21148,23803,24908,26034,26655,27756,3000,1500,1500,1000,1500,1500,1,18148,22303,23408,25034,25155,26256,0.30246666666666666,0.37171666666666664,0.39013333333333333,0.41723333333333334,0.41925,0.4376,0
1070,140000,1,3,2,24,0,0,0,0,0,0,126546,124926,111220,75706,69278,58589,4922,3910,4604,4000,3000,4000,0,121624,121016,106616,71706,66278,54589,0.8687428571428571,0.8644,0.7615428571428572,0.5121857142857142,0.47341428571428573,0.3899214285714286,0
1071,40000,1,2,1,56,0,0,0,0,0,0,30048,31049,32144,33157,33657,34359,1805,1900,1851,1351,1394,1464,1,28243,29149,30293,31806,32263,32895,0.706075,0.728725,0.757325,0.79515,0.806575,0.822375,0
1072,120000,0,2,2,34,-1,-1,-1,-1,-1,-1,1236,856,856,856,856,856,856,856,856,856,856,856,0,380,0,0,0,0,0,0.0031666666666666666,0.0,0.0,0.0,0.0,0.0,-6
1073,200000,1,2,2,28,0,0,0,0,0,0,50925,51519,53693,55506,63261,52979,2455,2629,2442,10000,1502,1517,0,48470,48890,51251,45506,61759,51462,0.24235,0.24445,0.256255,0.22753,0.308795,0.25731,0
1074,30000,1,1,2,23,1,2,0,0,0,0,10764,10454,11862,12104,12351,8000,0,2000,242,247,2000,0,0,10764,8454,11620,11857,10351,8000,0.3588,0.2818,0.3873333333333333,0.3952333333333333,0.34503333333333336,0.26666666666666666,3
1075,430000,1,1,2,33,0,0,0,0,0,0,345053,336467,321019,272838,206081,163130,13206,36000,30000,30000,30000,104000,0,331847,300467,291019,242838,176081,59130,0.7717372093023256,0.6987604651162791,0.6767883720930232,0.564739534883721,0.4094906976744186,0.13751162790697674,0
1076,80000,0,1,2,38,-1,0,0,0,0,0,21788,32562,23346,18361,10434,7387,16445,1482,1011,8,111,3509,0,5343,31080,22335,18353,10323,3878,0.0667875,0.3885,0.2791875,0.2294125,0.1290375,0.048475,-1
1077,70000,0,3,3,35,2,2,2,2,2,2,47702,48839,49636,50517,51658,52758,2200,1900,2000,2100,2100,2000,0,45502,46939,47636,48417,49558,50758,0.6500285714285714,0.6705571428571429,0.6805142857142857,0.6916714285714286,0.7079714285714286,0.7251142857142857,12
1078,140000,1,2,1,27,2,-1,-1,-1,0,0,776,752,776,1580,804,728,752,800,1580,0,700,700,1,24,-48,-804,1580,104,28,0.00017142857142857143,-0.00034285714285714285,-0.005742857142857142,0.011285714285714286,0.0007428571428571429,0.0002,-1
1079,30000,1,1,2,24,2,2,2,0,0,0,31202,32801,30092,30148,30222,28949,2415,0,1045,915,1063,409,0,28787,32801,29047,29233,29159,28540,0.9595666666666667,1.0933666666666666,0.9682333333333333,0.9744333333333334,0.9719666666666666,0.9513333333333334,6
1080,60000,1,2,2,25,0,0,0,0,0,0,18280,19468,20986,23783,25548,21811,1482,2000,3000,3000,1500,2000,0,16798,17468,17986,20783,24048,19811,0.27996666666666664,0.29113333333333336,0.2997666666666667,0.3463833333333333,0.4008,0.33018333333333333,0
1081,80000,0,2,2,41,2,0,0,0,0,0,80140,80627,80668,49233,48737,48280,3253,3211,1691,1721,1800,1576,0,76887,77416,78977,47512,46937,46704,0.9610875,0.9677,0.9872125,0.5939,0.5867125,0.5838,2
1082,310000,1,1,2,26,0,0,0,0,0,0,27283,28286,29427,29548,29839,30532,1459,1600,1607,898,1000,918,0,25824,26686,27820,28650,28839,29614,0.08330322580645161,0.08608387096774194,0.08974193548387097,0.09241935483870968,0.09302903225806451,0.09552903225806451,0
1083,170000,1,2,2,29,0,0,-2,-2,-2,-2,5155,0,0,0,0,0,0,0,0,0,0,0,0,5155,0,0,0,0,0,0.030323529411764708,0.0,0.0,0.0,0.0,0.0,-8
1084,50000,1,3,2,49,0,0,0,0,0,0,101590,50696,49894,49453,29824,29319,1800,1991,1670,1036,1050,1118,0,99790,48705,48224,48417,28774,28201,1.9958,0.9741,0.96448,0.96834,0.57548,0.56402,0
1085,20000,0,2,2,23,-1,-1,0,-1,0,-1,4584,4005,5677,688,1688,61,4005,4078,1237,1000,61,0,0,579,-73,4440,-312,1627,61,0.02895,-0.00365,0.222,-0.0156,0.08135,0.00305,-4
1086,240000,0,1,2,43,-2,-2,-2,-2,-2,-2,5740,0,0,0,0,0,0,0,0,0,0,0,0,5740,0,0,0,0,0,0.023916666666666666,0.0,0.0,0.0,0.0,0.0,-12
1087,360000,1,2,1,38,-1,-1,-1,-1,-1,-1,1604,238,2402,3580,183,1995,239,2414,3597,183,2005,3635,1,1365,-2176,-1195,3397,-1822,-1640,0.0037916666666666667,-0.006044444444444444,-0.0033194444444444443,0.00943611111111111,-0.005061111111111111,-0.004555555555555556,-6
1088,200000,1,2,1,30,0,0,0,0,0,0,75014,77044,80096,82269,85093,86870,3190,4195,4300,5000,3196,3231,1,71824,72849,75796,77269,81897,83639,0.35912,0.364245,0.37898,0.386345,0.409485,0.418195,0
1089,100000,0,2,1,27,-1,2,2,0,0,0,102349,96847,58824,29336,22979,-246,3166,0,1330,1398,12,50000,1,99183,96847,57494,27938,22967,-50246,0.99183,0.96847,0.57494,0.27938,0.22967,-0.50246,3
1090,50000,1,3,1,61,2,0,0,0,2,0,5016,6065,6985,6354,4908,3724,1135,1055,656,0,133,50,1,3881,5010,6329,6354,4775,3674,0.07762,0.1002,0.12658,0.12708,0.0955,0.07348,4
1091,80000,1,2,2,30,0,0,0,-1,0,0,90562,85919,83023,79031,41149,30244,3340,2000,83731,2000,2000,1000,0,87222,83919,-708,77031,39149,29244,1.090275,1.0489875,-0.00885,0.9628875,0.4893625,0.36555,-1
1092,320000,1,2,1,34,0,0,0,0,0,0,3825,3835,6746,9472,11777,14282,3000,3000,3000,3000,3000,4000,1,825,835,3746,6472,8777,10282,0.002578125,0.002609375,0.01170625,0.020225,0.027428125,0.03213125,0
1093,60000,1,1,2,27,0,0,2,2,0,0,4262,7169,8396,8113,8971,10824,3000,1500,0,1000,2000,1000,0,1262,5669,8396,7113,6971,9824,0.021033333333333334,0.09448333333333334,0.13993333333333333,0.11855,0.11618333333333333,0.16373333333333334,4
1094,560000,0,2,1,49,0,0,2,2,-1,-1,13432,12762,7077,3416,3416,416,3300,1416,0,3416,416,3416,1,10132,11346,7077,0,3000,-3000,0.018092857142857143,0.020260714285714285,0.0126375,0.0,0.005357142857142857,-0.005357142857142857,2
1095,50000,0,2,2,25,1,2,0,0,0,0,21679,18566,19918,19584,18508,20047,0,2000,1500,1000,2000,676,0,21679,16566,18418,18584,16508,19371,0.43358,0.33132,0.36836,0.37168,0.33016,0.38742,3
1096,590000,1,2,1,29,-2,-2,-2,-1,0,0,0,0,0,1387,2206,3014,0,0,1387,1000,1000,1000,1,0,0,-1387,387,1206,2014,0.0,0.0,-0.0023508474576271186,0.0006559322033898305,0.0020440677966101694,0.0034135593220338983,-7
1097,600000,1,3,2,44,0,0,0,-1,0,0,140179,112498,82803,380337,368527,390197,5000,8340,380478,12625,60000,7000,0,135179,104158,-297675,367712,308527,383197,0.22529833333333332,0.17359666666666668,-0.496125,0.6128533333333334,0.5142116666666666,0.6386616666666667,-1
1098,10000,0,2,2,32,0,0,0,0,0,0,9576,9028,9644,9790,9990,0,1384,1000,196,200,0,0,0,8192,8028,9448,9590,9990,0,0.8192,0.8028,0.9448,0.959,0.999,0.0,0
1099,10000,0,2,2,47,-1,-1,-1,-1,-1,0,219,9110,9797,-10433,9767,9067,10400,1000,0,20200,200,0,0,-10181,8110,9797,-30633,9567,9067,-1.0181,0.811,0.9797,-3.0633,0.9567,0.9067,-5
1100,250000,1,1,1,49,-1,-1,-2,-2,-1,0,1104,0,0,0,3000,1500,0,0,0,3000,0,3212,1,1104,0,0,-3000,3000,-1712,0.004416,0.0,0.0,-0.012,0.012,-0.006848,-7
1101,100000,1,2,2,23,2,2,2,2,2,2,90680,93267,95189,96332,97560,95885,5000,4300,3600,3700,0,7300,0,85680,88967,91589,92632,97560,88585,0.8568,0.88967,0.91589,0.92632,0.9756,0.88585,12
1102,550000,1,1,2,33,0,0,0,0,0,0,337733,261223,267274,273547,172198,176573,10000,11000,12300,6300,8000,8000,0,327733,250223,254974,267247,164198,168573,0.5958781818181819,0.4549509090909091,0.4635890909090909,0.48590363636363637,0.2985418181818182,0.3064963636363636,0
1103,430000,1,1,2,34,1,2,0,0,2,0,14965,11576,14099,15128,14647,16317,0,3000,3500,0,2000,2000,0,14965,8576,10599,15128,12647,14317,0.03480232558139535,0.019944186046511627,0.024648837209302325,0.035181395348837206,0.029411627906976743,0.033295348837209304,5
1104,130000,1,3,1,23,0,0,0,0,0,0,109592,113508,115633,96898,46425,0,5733,5659,4680,2325,0,0,1,103859,107849,110953,94573,46425,0,0.7989153846153846,0.8296076923076923,0.8534846153846154,0.7274846153846154,0.3571153846153846,0.0,0
1105,450000,1,3,2,26,0,0,0,0,0,0,28765,24672,23095,20776,6189,2396,1714,2012,1107,21,512,81081,0,27051,22660,21988,20755,5677,-78685,0.06011333333333333,0.050355555555555556,0.048862222222222224,0.046122222222222224,0.012615555555555555,-0.17485555555555554,0
1106,100000,1,1,1,44,0,0,0,0,0,2,68444,71722,73525,75303,79994,78550,5000,3000,3000,5900,0,5000,1,63444,68722,70525,69403,79994,73550,0.63444,0.68722,0.70525,0.69403,0.79994,0.7355,2
1107,50000,0,2,1,47,0,0,0,0,0,0,38830,35866,30260,19187,19324,19192,1600,8820,1293,820,700,689,1,37230,27046,28967,18367,18624,18503,0.7446,0.54092,0.57934,0.36734,0.37248,0.37006,0
1108,50000,1,2,3,39,0,0,0,0,0,0,49005,49407,45881,45784,50072,49112,6000,5000,5000,8000,4000,4000,0,43005,44407,40881,37784,46072,45112,0.8601,0.88814,0.81762,0.75568,0.92144,0.90224,0
1109,30000,0,1,2,27,0,0,0,0,-1,-1,18239,17963,18425,1183,2000,0,2000,3000,300,3000,0,0,0,16239,14963,18125,-1817,2000,0,0.5413,0.4987666666666667,0.6041666666666666,-0.060566666666666664,0.06666666666666667,0.0,-2
1110,20000,0,2,2,35,0,0,0,3,7,6,6855,11392,15863,20581,20298,19424,5000,5000,5000,0,0,1000,0,1855,6392,10863,20581,20298,18424,0.09275,0.3196,0.54315,1.02905,1.0149,0.9212,16
1111,50000,1,3,1,44,2,2,2,2,2,2,19178,20088,19499,21578,20940,22605,1500,0,2385,0,2000,0,1,17678,20088,17114,21578,18940,22605,0.35356,0.40176,0.34228,0.43156,0.3788,0.4521,12
1112,210000,1,1,2,33,1,-2,-2,-1,-1,-1,0,0,0,25478,9485,0,0,0,25478,9485,0,0,0,0,0,-25478,15993,9485,0,0.0,0.0,-0.12132380952380953,0.07615714285714285,0.04516666666666667,0.0,-6
1113,50000,1,2,2,23,2,0,0,0,0,0,49441,45880,42621,21734,18775,19590,1998,2198,1300,655,1100,654,0,47443,43682,41321,21079,17675,18936,0.94886,0.87364,0.82642,0.42158,0.3535,0.37872,2
1114,320000,1,1,2,39,0,0,0,0,0,0,91224,93025,99433,107659,110567,99935,10000,10000,10000,10000,5000,5000,0,81224,83025,89433,97659,105567,94935,0.253825,0.259453125,0.279478125,0.305184375,0.329896875,0.296671875,0
1115,100000,1,2,1,43,0,0,0,0,0,-2,94713,97503,100138,99000,0,0,4366,5100,2000,0,0,0,1,90347,92403,98138,99000,0,0,0.90347,0.92403,0.98138,0.99,0.0,0.0,-2
1116,240000,1,2,2,24,0,0,0,0,0,0,75830,50787,51524,31783,33993,36783,1480,1601,1400,3000,3180,37102,0,74350,49186,50124,28783,30813,-319,0.3097916666666667,0.20494166666666666,0.20885,0.11992916666666667,0.1283875,-0.0013291666666666666,0
1117,250000,1,3,1,50,-2,-2,-2,-2,-2,-2,193355,8173,-11,-11,39618,20380,8173,0,0,39629,20380,32701,1,185182,8173,-11,-39640,19238,-12321,0.740728,0.032692,-4.4e-05,-0.15856,0.076952,-0.049284,-12
1118,70000,1,2,2,26,0,0,0,0,0,0,30139,8241,8398,8864,9301,10702,2000,2000,2000,2000,3000,1500,0,28139,6241,6398,6864,6301,9202,0.4019857142857143,0.08915714285714285,0.0914,0.09805714285714286,0.09001428571428571,0.13145714285714286,0
1119,20000,0,2,1,50,0,0,0,0,2,0,6620,7556,8570,10020,9715,10153,1200,1300,1600,0,600,600,1,5420,6256,6970,10020,9115,9553,0.271,0.3128,0.3485,0.501,0.45575,0.47765,2
1120,180000,1,1,2,28,1,2,2,2,0,0,5930,5689,8414,8062,5052,2806,0,3000,0,200,0,0,0,5930,2689,8414,7862,5052,2806,0.03294444444444444,0.014938888888888889,0.04674444444444444,0.04367777777777778,0.028066666666666667,0.015588888888888888,7
1121,40000,0,3,1,50,1,2,0,-1,-1,-2,35879,34625,36757,20650,0,0,0,3078,21650,0,0,0,1,35879,31547,15107,20650,0,0,0.896975,0.788675,0.377675,0.51625,0.0,0.0,-1
1122,50000,1,2,2,25,2,2,2,2,2,2,33586,34636,35683,36200,36808,37671,1900,1900,1400,1500,1600,1500,0,31686,32736,34283,34700,35208,36171,0.63372,0.65472,0.68566,0.694,0.70416,0.72342,12
1123,280000,1,2,2,25,0,0,0,0,0,0,139019,141146,129252,103317,101085,104181,4074,4232,4022,3000,4010,100022,0,134945,136914,125230,100317,97075,4159,0.48194642857142855,0.48897857142857143,0.44725,0.358275,0.34669642857142857,0.014853571428571428,0
1124,230000,0,2,1,38,-1,-1,-1,-1,-1,-1,326,326,326,326,326,326,326,326,326,326,326,326,1,0,0,0,0,0,0,0.0,0.0,0.0,0.0,0.0,0.0,-6
1125,20000,0,1,2,29,2,2,3,2,2,2,10512,12044,11562,11080,11700,12357,2000,0,0,800,1000,500,0,8512,12044,11562,10280,10700,11857,0.4256,0.6022,0.5781,0.514,0.535,0.59285,13
1126,240000,0,3,1,33,0,0,0,2,0,0,64853,67948,197032,169878,164926,160600,8000,157500,0,5759,5775,6407,1,56853,-89552,197032,164119,159151,154193,0.2368875,-0.3731333333333333,0.8209666666666666,0.6838291666666667,0.6631291666666667,0.6424708333333333,2
1127,460000,0,1,1,37,2,0,0,0,0,0,7121,7953,8642,9151,9702,9752,1273,1288,1123,1000,502,3000,1,5848,6665,7519,8151,9200,6752,0.01271304347826087,0.014489130434782609,0.016345652173913042,0.017719565217391306,0.02,0.014678260869565217,2
1128,120000,0,2,1,38,1,2,2,2,2,2,116344,111960,115804,92542,83581,61650,0,6781,0,5550,0,0,1,116344,105179,115804,86992,83581,61650,0.9695333333333334,0.8764916666666667,0.9650333333333333,0.7249333333333333,0.6965083333333333,0.51375,11
1129,230000,1,1,2,48,0,0,0,0,0,0,161083,164757,168214,159106,162436,165878,7800,7684,5600,5755,6000,6300,0,153283,157073,162614,153351,156436,159578,0.6664478260869565,0.6829260869565218,0.7070173913043478,0.6667434782608695,0.6801565217391304,0.6938173913043478,0
1130,20000,1,2,1,37,-1,-1,-1,-1,-1,0,425,1626,460,360,1520,1160,1629,460,360,1520,0,2233,1,-1204,1166,100,-1160,1520,-1073,-0.0602,0.0583,0.005,-0.058,0.076,-0.05365,-5
1131,30000,1,2,2,22,0,0,2,0,0,0,27762,30392,27688,28134,29591,28883,5000,0,3000,2000,1300,1500,0,22762,30392,24688,26134,28291,27383,0.7587333333333334,1.0130666666666666,0.8229333333333333,0.8711333333333333,0.9430333333333333,0.9127666666666666,2
1132,120000,1,2,2,25,2,3,3,3,4,4,94635,97592,100536,103478,104886,107220,5400,5400,5500,4600,4600,5200,0,89235,92192,95036,98878,100286,102020,0.743625,0.7682666666666667,0.7919666666666667,0.8239833333333333,0.8357166666666667,0.8501666666666666,19
1133,170000,1,1,2,27,-1,-1,-1,-1,-1,-1,272,272,272,755,759,602,272,272,755,759,602,2581,0,0,0,-483,-4,157,-1979,0.0,0.0,-0.0028411764705882354,-2.3529411764705884e-05,0.0009235294117647059,-0.011641176470588235,-6
1134,50000,0,1,1,24,0,0,0,0,0,0,47734,47025,48102,48612,49465,50299,1763,1840,1751,1717,1773,1845,1,45971,45185,46351,46895,47692,48454,0.91942,0.9037,0.92702,0.9379,0.95384,0.96908,0
1135,50000,1,2,1,47,0,0,0,0,-2,-2,32547,33481,26775,0,0,0,1582,1800,0,0,0,0,1,30965,31681,26775,0,0,0,0.6193,0.63362,0.5355,0.0,0.0,0.0,-4
1136,50000,1,3,1,54,0,0,0,0,0,0,16648,16200,15622,14277,12930,11657,1588,1483,611,458,403,351,1,15060,14717,15011,13819,12527,11306,0.3012,0.29434,0.30022,0.27638,0.25054,0.22612,0
1137,270000,1,1,2,34,0,0,0,0,0,0,126642,127741,132405,131241,127080,122213,4500,7028,4728,5037,4530,5000,0,122142,120713,127677,126204,122550,117213,0.45237777777777777,0.4470851851851852,0.4728777777777778,0.46742222222222224,0.4538888888888889,0.43412222222222224,0
1138,20000,1,4,2,23,0,0,0,0,0,-2,16371,17801,18256,18425,0,0,2000,1200,369,0,0,0,0,14371,16601,17887,18425,0,0,0.71855,0.83005,0.89435,0.92125,0.0,0.0,-2
1139,50000,0,2,2,25,0,0,0,0,0,2,20636,17792,17422,17273,18827,16996,1604,1702,1500,2004,16,607,0,19032,16090,15922,15269,18811,16389,0.38064,0.3218,0.31844,0.30538,0.37622,0.32778,2
1140,180000,1,1,1,39,-1,-1,-1,-1,-1,-1,892,6809,18390,13999,933,933,6846,18399,13999,933,933,993,1,-5954,-11590,4391,13066,0,-60,-0.033077777777777775,-0.06438888888888888,0.024394444444444444,0.07258888888888888,0.0,-0.0003333333333333333,-6
1141,300000,1,1,1,33,-1,-1,-1,-1,-1,0,3890,4002,1438,5322,6814,2956,4008,1438,5328,6814,114,1740,1,-118,2564,-3890,-1492,6700,1216,-0.0003933333333333333,0.008546666666666666,-0.012966666666666666,-0.004973333333333333,0.022333333333333334,0.004053333333333333,-5
1142,270000,1,2,1,37,-1,-1,-2,-1,-1,-1,304,-22,-348,326,326,304,0,0,1000,326,304,0,1,304,-22,-1348,0,22,304,0.0011259259259259258,-8.148148148148148e-05,-0.004992592592592593,0.0,8.148148148148148e-05,0.0011259259259259258,-7
1143,60000,1,2,3,34,1,-1,0,0,-2,-1,0,60559,56317,0,0,567,60559,1126,0,0,567,1222,0,-60559,59433,56317,0,-567,-655,-1.0093166666666666,0.99055,0.9386166666666667,0.0,-0.00945,-0.010916666666666667,-3
1144,80000,0,2,1,27,-1,0,0,0,0,0,79690,80976,57827,46390,45354,43112,3181,2050,1684,1564,1558,2000,1,76509,78926,56143,44826,43796,41112,0.9563625,0.986575,0.7017875,0.560325,0.54745,0.5139,-1
1145,20000,0,2,3,48,0,0,0,2,0,0,16537,16192,16926,17333,16820,17175,1500,3500,1000,1000,1000,1000,0,15037,12692,15926,16333,15820,16175,0.75185,0.6346,0.7963,0.81665,0.791,0.80875,2
1146,250000,0,3,1,28,0,0,0,0,0,0,249827,191305,90497,92278,93354,95309,8500,3899,3913,3186,3301,3525,1,241327,187406,86584,89092,90053,91784,0.965308,0.749624,0.346336,0.356368,0.360212,0.367136,0
1147,310000,1,2,1,34,-1,-1,-1,-1,-1,-1,3595,4073,11263,2710,2371,2318,4073,11321,2710,2371,2318,4352,1,-478,-7248,8553,339,53,-2034,-0.0015419354838709677,-0.023380645161290323,0.02759032258064516,0.0010935483870967743,0.00017096774193548387,-0.006561290322580645,-6
1148,50000,1,2,1,31,2,0,0,0,0,0,29767,30206,27905,17174,17533,17240,1615,1670,605,626,654,567,1,28152,28536,27300,16548,16879,16673,0.56304,0.57072,0.546,0.33096,0.33758,0.33346,2
1149,20000,0,2,2,37,0,0,0,0,0,0,20009,20602,21255,19105,19609,19283,1700,1600,1200,1000,900,1000,0,18309,19002,20055,18105,18709,18283,0.91545,0.9501,1.00275,0.90525,0.93545,0.91415,0
1150,20000,0,2,1,22,0,0,0,0,0,0,19356,19754,20279,19887,19887,0,1485,1400,398,0,0,0,1,17871,18354,19881,19887,19887,0,0.89355,0.9177,0.99405,0.99435,0.99435,0.0,0
1151,130000,1,3,2,27,0,0,0,0,0,0,124769,127966,119008,46659,47588,47698,5400,3941,1742,1671,1712,1730,0,119369,124025,117266,44988,45876,45968,0.9182230769230769,0.9540384615384615,0.9020461538461538,0.3460615384615385,0.35289230769230767,0.3536,0
1152,210000,1,2,2,49,-1,-1,-1,-1,0,0,991,4045,4056,65825,60803,56578,6035,4056,65825,1420,1132,5000,0,-5044,-11,-61769,64405,59671,51578,-0.02401904761904762,-5.238095238095238e-05,-0.29413809523809525,0.3066904761904762,0.28414761904761904,0.2456095238095238,-4
1153,150000,1,1,2,26,-1,-1,-1,-1,-1,-1,1551,2961,4175,1707,4492,6149,2990,4175,1707,4492,6149,34672,0,-1439,-1214,2468,-2785,-1657,-28523,-0.009593333333333334,-0.008093333333333333,0.016453333333333334,-0.018566666666666665,-0.011046666666666666,-0.19015333333333334,-6
1154,220000,0,2,1,48,0,0,-1,0,0,2,2858,1929,10417,9363,7898,5758,1000,10417,1061,525,0,313,1,1858,-8488,9356,8838,7898,5445,0.008445454545454546,-0.03858181818181818,0.042527272727272726,0.04017272727272727,0.0359,0.02475,1
1155,90000,1,3,1,50,0,0,0,0,0,0,91123,90056,88330,83948,82168,82304,3614,3223,3172,2743,3051,3081,1,87509,86833,85158,81205,79117,79223,0.9723222222222222,0.9648111111111111,0.9462,0.9022777777777777,0.8790777777777777,0.8802555555555556,0
1156,150000,1,1,2,32,0,0,0,0,0,2,125995,127467,130080,131238,141612,140868,5000,4723,3323,11086,0,4000,0,120995,122744,126757,120152,141612,136868,0.8066333333333333,0.8182933333333333,0.8450466666666666,0.8010133333333334,0.94408,0.9124533333333333,2
1157,360000,0,1,2,36,-1,-1,-1,-1,-1,-1,415,-350,325,765,24851,414,0,1000,765,24851,414,30664,0,415,-1350,-440,-24086,24437,-30250,0.0011527777777777777,-0.00375,-0.0012222222222222222,-0.06690555555555555,0.06788055555555556,-0.08402777777777778,-6
1158,160000,0,1,1,41,0,-1,0,0,2,2,117126,11222,15513,18087,17499,19939,15315,15000,3000,0,3000,0,1,101811,-3778,12513,18087,14499,19939,0.63631875,-0.0236125,0.07820625,0.11304375,0.09061875,0.12461875,3
1159,380000,0,1,2,36,0,0,0,0,0,0,68943,75024,61114,60586,55489,55702,8000,5000,2500,5000,4000,4000,0,60943,70024,58614,55586,51489,51702,0.16037631578947367,0.1842736842105263,0.15424736842105263,0.14627894736842106,0.13549736842105264,0.1360578947368421,0
1160,140000,1,2,2,31,-2,-2,-2,-2,-2,-2,390,0,0,0,0,0,0,0,0,0,0,0,0,390,0,0,0,0,0,0.002785714285714286,0.0,0.0,0.0,0.0,0.0,-12
1161,90000,1,3,1,47,0,0,0,0,0,0,84195,86795,88884,82163,22601,22029,4001,4400,3566,7694,1000,1000,1,80194,82395,85318,74469,21601,21029,0.8910444444444444,0.9155,0.9479777777777778,0.8274333333333334,0.24001111111111112,0.23365555555555556,0
1162,30000,1,2,2,25,2,2,2,2,2,2,24022,25038,25429,25714,26353,26868,1700,1100,1000,1200,1100,1200,0,22322,23938,24429,24514,25253,25668,0.7440666666666667,0.7979333333333334,0.8143,0.8171333333333334,0.8417666666666667,0.8556,12
1163,250000,0,2,2,24,1,-2,-1,-1,-1,0,0,0,1859,3582,18717,20213,0,1859,2628,41000,3000,2000,0,0,-1859,-769,-37418,15717,18213,0.0,-0.007436,-0.003076,-0.149672,0.062868,0.072852,-4
1164,180000,1,2,2,30,0,0,0,0,0,0,14445,15404,19885,22355,22902,15373,1500,4911,10355,10902,3500,5493,0,12945,10493,9530,11453,19402,9880,0.07191666666666667,0.05829444444444445,0.05294444444444445,0.06362777777777778,0.10778888888888889,0.05488888888888889,0
1165,50000,0,4,1,45,0,0,0,0,-1,0,33634,34770,34948,-52,848,850,2000,1000,0,900,2,1749,1,31634,33770,34948,-952,846,-899,0.63268,0.6754,0.69896,-0.01904,0.01692,-0.01798,-1
1166,100000,1,3,1,28,2,0,0,2,2,2,29770,30485,32434,32592,33102,33860,1825,3100,1300,1500,1771,0,1,27945,27385,31134,31092,31331,33860,0.27945,0.27385,0.31134,0.31092,0.31331,0.3386,8
1167,50000,0,3,2,28,2,2,2,0,0,2,28129,29184,28421,28751,30685,30040,1800,0,1100,2400,0,1500,0,26329,29184,27321,26351,30685,28540,0.52658,0.58368,0.54642,0.52702,0.6137,0.5708,8
1168,200000,0,2,1,44,-1,-1,2,0,0,-1,780,390,1170,780,0,390,390,780,0,0,390,780,1,390,-390,1170,780,-390,-390,0.00195,-0.00195,0.00585,0.0039,-0.00195,-0.00195,-1
1169,130000,1,1,2,29,0,0,3,3,2,0,106271,119728,121140,117767,115640,116062,15107,5000,0,0,4200,5000,0,91164,114728,121140,117767,111440,111062,0.7012615384615385,0.882523076923077,0.9318461538461539,0.9059,0.8572307692307692,0.854323076923077,8
1170,130000,1,3,1,45,1,-1,2,-1,-1,-1,0,780,390,540,11040,953,780,0,540,11040,953,9622,1,-780,780,-150,-10500,10087,-8669,-0.006,0.006,-0.001153846153846154,-0.08076923076923077,0.0775923076923077,-0.06668461538461538,-1
1171,120000,1,1,1,31,-1,-1,-1,-1,-1,-1,1680,17749,4748,7002,202,345,17749,4748,7020,559,500,1660,1,-16069,13001,-2272,6443,-298,-1315,-0.13390833333333332,0.10834166666666667,-0.018933333333333333,0.053691666666666665,-0.0024833333333333335,-0.010958333333333334,-6
1172,280000,1,1,1,41,0,0,0,0,0,0,96590,99755,81244,81193,82470,49630,5000,3000,3007,5000,2000,1700,1,91590,96755,78237,76193,80470,47930,0.3271071428571429,0.3455535714285714,0.27941785714285716,0.27211785714285713,0.2873928571428571,0.17117857142857143,0
1173,360000,0,2,1,39,0,0,0,0,0,0,23690,67560,26649,15830,20025,21404,60284,16079,5024,9032,8035,12073,1,-36594,51481,21625,6798,11990,9331,-0.10165,0.14300277777777778,0.060069444444444446,0.018883333333333332,0.033305555555555554,0.025919444444444443,0
1174,380000,1,1,2,33,0,0,0,0,0,0,89842,88898,63203,44889,44276,31799,8000,8009,7000,6000,10500,8500,0,81842,80889,56203,38889,33776,23299,0.21537368421052633,0.2128657894736842,0.14790263157894737,0.10233947368421052,0.08888421052631579,0.06131315789473684,0
1175,110000,0,2,2,24,0,0,0,0,0,0,44737,39590,39457,39075,39307,39564,2103,2005,2006,3006,3010,2013,0,42634,37585,37451,36069,36297,37551,0.3875818181818182,0.3416818181818182,0.34046363636363636,0.3279,0.32997272727272725,0.34137272727272727,0
1176,330000,0,1,2,34,-1,-1,-1,-1,0,-1,316,310,6994,632,316,38277,310,7006,2000,0,38277,6000,0,6,-6696,4994,632,-37961,32277,1.8181818181818182e-05,-0.020290909090909092,0.015133333333333334,0.0019151515151515151,-0.11503333333333333,0.09780909090909091,-5
1177,100000,1,1,2,25,1,-1,-1,-1,-1,-1,0,460,0,85,60,520,460,0,85,60,520,0,0,-460,460,-85,25,-460,520,-0.0046,0.0046,-0.00085,0.00025,-0.0046,0.0052,-4
1178,140000,1,2,1,36,0,0,0,0,0,0,74500,64615,59862,42040,32591,21090,3508,10027,5008,5013,5008,2004,1,70992,54588,54854,37027,27583,19086,0.5070857142857143,0.3899142857142857,0.3918142857142857,0.26447857142857145,0.19702142857142857,0.13632857142857144,0
1179,290000,1,1,1,29,0,0,0,0,0,0,232319,109791,106730,93882,91746,76547,5071,4539,3000,3500,3856,3000,1,227248,105252,103730,90382,87890,73547,0.7836137931034483,0.36293793103448274,0.3576896551724138,0.31166206896551724,0.3030689655172414,0.2536103448275862,0
1180,360000,0,2,2,31,-1,-1,-1,0,0,-1,744,9613,18748,18694,11606,7516,9667,18781,6729,58,7553,8758,0,-8923,-9168,12019,18636,4053,-1242,-0.02478611111111111,-0.025466666666666665,0.03338611111111111,0.05176666666666667,0.011258333333333334,-0.00345,-4
1181,340000,1,1,1,62,0,0,0,0,0,0,509365,522309,534137,466565,466774,471573,20309,20137,16565,16774,21573,21000,1,489056,502172,517572,449791,445201,450573,1.4384,1.4769764705882353,1.522270588235294,1.322914705882353,1.3094147058823529,1.325214705882353,0
1182,420000,1,1,1,39,0,0,0,0,0,0,304964,312224,315822,275393,278745,244543,14000,11230,10000,8091,6965,6362,1,290964,300994,305822,267302,271780,238181,0.6927714285714286,0.7166523809523809,0.728147619047619,0.6364333333333333,0.6470952380952381,0.567097619047619,0
1183,20000,1,2,2,22,2,2,0,0,0,3,6900,6643,7872,9077,10989,10529,0,1500,1500,2225,0,0,0,6900,5143,6372,6852,10989,10529,0.345,0.25715,0.3186,0.3426,0.54945,0.52645,7
1184,290000,0,1,2,37,2,0,0,0,0,0,131279,134113,136948,139674,142793,162091,4700,4800,4735,5100,21500,6000,0,126579,129313,132213,134574,121293,156091,0.43647931034482756,0.44590689655172416,0.4559068965517241,0.464048275862069,0.41825172413793105,0.5382448275862068,2
1185,150000,1,1,1,34,-1,-1,-1,-1,-1,-1,3099,3102,3087,2887,2887,2887,3102,3087,2887,2887,2887,3103,1,-3,15,200,0,0,-216,-2e-05,0.0001,0.0013333333333333333,0.0,0.0,-0.00144,-6
1186,120000,1,1,2,48,0,0,0,0,-2,-1,96183,99575,102650,0,0,30900,5000,5000,0,0,30900,30900,0,91183,94575,102650,0,-30900,0,0.7598583333333333,0.788125,0.8554166666666667,0.0,-0.2575,0.0,-3
1187,10000,0,2,2,27,0,0,0,0,0,0,9457,9554,7335,9025,7886,8382,1107,1310,2000,269,1000,1100,0,8350,8244,5335,8756,6886,7282,0.835,0.8244,0.5335,0.8756,0.6886,0.7282,0
1188,10000,1,2,2,44,-2,-2,-2,-1,0,0,390,390,780,17585,18301,18663,390,780,17585,1000,667,692,0,0,-390,-16805,16585,17634,17971,0.0,-0.039,-1.6805,1.6585,1.7634,1.7971,-7
1189,60000,1,1,2,27,1,-1,-1,-1,0,0,0,3947,5691,21001,17931,2439,3947,5691,21028,0,0,841,0,-3947,-1744,-15337,21001,17931,1598,-0.06578333333333333,-0.029066666666666668,-0.25561666666666666,0.35001666666666664,0.29885,0.026633333333333332,-2
1190,360000,0,1,2,35,-1,-1,-1,-1,-2,-1,2010,2936,640,0,0,4750,2936,640,0,0,4750,1470,0,-926,2296,640,0,-4750,3280,-0.0025722222222222223,0.006377777777777777,0.0017777777777777779,0.0,-0.013194444444444444,0.009111111111111111,-7
1191,140000,0,1,2,37,0,-1,0,0,0,0,3351,64555,63796,55234,52959,50617,64555,2898,1890,2000,2000,1900,0,-61204,61657,61906,53234,50959,48717,-0.43717142857142854,0.44040714285714283,0.4421857142857143,0.38024285714285716,0.3639928571428571,0.3479785714285714,-1
1192,80000,1,2,1,44,-2,-2,-2,-1,4,3,0,0,0,600,600,300,0,0,600,0,0,0,1,0,0,-600,600,600,300,0.0,0.0,-0.0075,0.0075,0.0075,0.00375,0
1193,100000,1,3,1,46,0,0,2,2,0,0,80402,86137,84998,85627,78245,79929,8000,1100,3000,3000,3100,3100,1,72402,85037,81998,82627,75145,76829,0.72402,0.85037,0.81998,0.82627,0.75145,0.76829,4
1194,200000,0,2,2,40,1,2,2,0,0,0,193773,196323,181932,132127,132245,138104,7350,261,6206,5006,9406,6,0,186423,196062,175726,127121,122839,138098,0.932115,0.98031,0.87863,0.635605,0.614195,0.69049,5
1195,50000,1,2,2,24,-1,0,-1,2,2,-2,18625,19956,5177,2071,0,0,2071,5191,6,0,0,10450,0,16554,14765,5171,2071,0,-10450,0.33108,0.2953,0.10342,0.04142,0.0,-0.209,0
1196,560000,0,2,1,32,1,-2,-2,-1,-1,-2,19924,16297,4593,2512,11461,3402,1163,1023,2519,46518,3421,11467,1,18761,15274,2074,-44006,8040,-8065,0.03350178571428571,0.027275,0.0037035714285714285,-0.07858214285714285,0.014357142857142857,-0.014401785714285714,-7
1197,250000,1,1,2,35,-2,-2,-2,-2,-2,-2,0,0,26267,26599,2948,2065,0,26267,532,2948,2065,13780,0,0,-26267,25735,23651,883,-11715,0.0,-0.105068,0.10294,0.094604,0.003532,-0.04686,-12
1198,200000,0,3,1,42,0,0,0,2,0,0,151392,148467,153409,145476,119025,115255,7000,14834,0,4575,4180,4634,1,144392,133633,153409,140901,114845,110621,0.72196,0.668165,0.767045,0.704505,0.574225,0.553105,2
1199,30000,1,2,2,54,0,0,2,0,0,2,29230,30786,27167,27440,30117,29523,3500,0,3000,6000,0,781,0,25730,30786,24167,21440,30117,28742,0.8576666666666667,1.0262,0.8055666666666667,0.7146666666666667,1.0039,0.9580666666666666,4
1200,360000,0,1,2,29,1,-2,-2,-2,-2,-2,0,0,0,0,0,0,0,0,0,0,0,0,0,0,0,0,0,0,0,0.0,0.0,0.0,0.0,0.0,0.0,-9
1201,160000,0,1,2,37,2,2,2,2,0,0,63043,67460,68554,66841,74763,87692,6079,3064,0,10000,15000,0,0,56964,64396,68554,56841,59763,87692,0.356025,0.402475,0.4284625,0.35525625,0.37351875,0.548075,8
1202,150000,0,2,1,30,-2,-2,-2,-2,-2,-2,116778,59731,89742,116067,97725,76466,60367,100483,116567,50156,10383,316,1,56411,-40752,-26825,65911,87342,76150,0.3760733333333333,-0.27168,-0.17883333333333334,0.43940666666666667,0.58228,0.5076666666666667,-12
1203,130000,0,1,1,34,0,0,0,0,0,0,128846,130525,74745,68597,54774,53728,5170,2584,4000,2006,2000,2004,1,123676,127941,70745,66591,52774,51724,0.9513538461538461,0.9841615384615384,0.5441923076923076,0.5122384615384615,0.40595384615384617,0.3978769230769231,0
1204,170000,0,2,1,57,-1,-1,-1,-1,0,-1,792,-2604,396,792,396,396,0,3396,792,0,396,396,1,792,-6000,-396,792,0,0,0.004658823529411765,-0.03529411764705882,-0.0023294117647058824,0.004658823529411765,0.0,0.0,-5
1205,190000,0,2,2,39,0,0,0,0,0,0,146224,149289,152886,156273,159800,162570,5500,6000,6000,6000,6000,6000,0,140724,143289,146886,150273,153800,156570,0.7406526315789473,0.7541526315789474,0.7730842105263158,0.7909105263157895,0.8094736842105263,0.8240526315789474,0
1206,200000,1,1,2,33,-1,-1,-1,-1,-2,-2,390,0,780,0,0,0,0,780,0,0,0,0,0,390,-780,780,0,0,0,0.00195,-0.0039,0.0039,0.0,0.0,0.0,-8
1207,190000,1,2,2,30,0,0,0,0,0,0,194724,190781,191861,155967,153193,156494,8900,6200,5500,5600,5800,5600,0,185824,184581,186361,150367,147393,150894,0.9780210526315789,0.971478947368421,0.9808473684210526,0.7914052631578947,0.7757526315789474,0.7941789473684211,0
1208,200000,1,1,1,38,-2,-2,-2,-2,-2,-2,5625,12125,13300,3450,13880,5147,12125,13416,3450,13880,5147,1050,1,-6500,-1291,9850,-10430,8733,4097,-0.0325,-0.006455,0.04925,-0.05215,0.043665,0.020485,-12
1209,140000,1,2,2,30,0,0,0,0,0,0,97288,98068,98098,97055,97035,101525,4400,4500,3500,3500,8000,500,0,92888,93568,94598,93555,89035,101025,0.6634857142857142,0.6683428571428571,0.6757,0.66825,0.6359642857142858,0.7216071428571429,0
1210,160000,0,1,1,39,-2,-2,-2,-2,-2,-2,4138,0,0,0,2920,0,35,0,0,2920,0,12140,1,4103,0,0,-2920,2920,-12140,0.02564375,0.0,0.0,-0.01825,0.01825,-0.075875,-12
1211,70000,1,2,1,25,0,0,0,0,0,0,34645,36021,32128,27265,27133,26234,2000,1804,1100,1005,1504,1007,1,32645,34217,31028,26260,25629,25227,0.46635714285714286,0.4888142857142857,0.44325714285714285,0.37514285714285717,0.3661285714285714,0.3603857142857143,0
1212,200000,1,2,1,39,-1,-1,-1,-1,-1,-1,13145,15549,21375,9312,23958,10825,15571,21488,9312,23958,10825,10773,1,-2426,-5939,12063,-14646,13133,52,-0.01213,-0.029695,0.060315,-0.07323,0.065665,0.00026,-6
1213,110000,0,2,2,29,2,2,2,2,0,0,55700,58362,56598,51908,48647,47862,5000,2500,0,2000,2000,1854,0,50700,55862,56598,49908,46647,46008,0.46090909090909093,0.5078363636363636,0.5145272727272727,0.4537090909090909,0.42406363636363636,0.41825454545454543,8
1214,240000,1,2,1,37,-1,2,-1,-1,-1,0,1769,842,14015,0,1317,566,0,14015,0,1317,0,0,1,1769,-13173,14015,-1317,1317,566,0.007370833333333333,-0.0548875,0.058395833333333334,-0.0054875,0.0054875,0.0023583333333333334,-2
1215,70000,0,2,1,38,0,0,0,0,0,0,52121,53235,52015,38985,36097,36995,1965,1995,1336,1430,1500,1292,1,50156,51240,50679,37555,34597,35703,0.7165142857142857,0.732,0.7239857142857142,0.5365,0.49424285714285715,0.5100428571428571,0
1216,60000,0,1,2,28,0,-1,0,0,-1,2,2295,5293,13421,9900,310,160,6000,10000,900,310,0,3400,0,-3705,-4707,12521,9590,310,-3240,-0.06175,-0.07845,0.20868333333333333,0.15983333333333333,0.005166666666666667,-0.054,0
1217,290000,0,2,1,53,-1,0,0,0,-1,-1,4975,3688,3164,2277,1497,1887,1027,1000,1000,1497,1887,2277,1,3948,2688,2164,780,-390,-390,0.013613793103448275,0.009268965517241379,0.007462068965517241,0.0026896551724137933,-0.0013448275862068967,-0.0013448275862068967,-3
1218,140000,0,2,1,37,0,0,0,0,0,0,90186,74504,72358,48081,45543,26788,2805,2877,1360,1400,1026,1200,1,87381,71627,70998,46681,44517,25588,0.62415,0.5116214285714286,0.5071285714285715,0.3334357142857143,0.31797857142857144,0.18277142857142858,0
1219,60000,1,1,2,23,0,0,0,0,0,0,27369,27961,28509,28628,28785,28921,1466,1452,1009,1040,1048,856,0,25903,26509,27500,27588,27737,28065,0.4317166666666667,0.4418166666666667,0.4583333333333333,0.4598,0.4622833333333333,0.46775,0
1220,50000,1,2,1,47,0,0,0,0,0,0,44624,45128,3837,3913,4146,4225,2355,1064,140,296,296,301,1,42269,44064,3697,3617,3850,3924,0.84538,0.88128,0.07394,0.07234,0.077,0.07848,0
1221,450000,1,2,2,36,1,-2,-2,-2,-2,-2,0,0,0,0,0,0,0,0,0,0,0,0,0,0,0,0,0,0,0,0.0,0.0,0.0,0.0,0.0,0.0,-9
1222,130000,1,3,1,53,0,0,0,0,0,0,18614,20343,22386,24296,25436,27451,2343,2386,2296,1536,2451,2659,1,16271,17957,20090,22760,22985,24792,0.12516153846153846,0.13813076923076922,0.15453846153846154,0.17507692307692307,0.1768076923076923,0.1907076923076923,0
1223,180000,1,2,2,27,0,0,0,0,0,0,53490,54552,56300,56831,57958,59330,1952,2627,2063,2072,2303,2500,0,51538,51925,54237,54759,55655,56830,0.2863222222222222,0.28847222222222224,0.3013166666666667,0.3042166666666667,0.30919444444444444,0.31572222222222224,0
1224,50000,1,2,2,24,0,0,0,0,0,0,26239,17824,17615,17956,18091,18259,1300,5869,1000,795,1000,1000,0,24939,11955,16615,17161,17091,17259,0.49878,0.2391,0.3323,0.34322,0.34182,0.34518,0
1225,230000,1,3,1,31,0,0,0,0,0,0,184444,182933,178409,175091,171800,168476,7016,5500,5125,5031,4969,5071,1,177428,177433,173284,170060,166831,163405,0.7714260869565217,0.7714478260869565,0.7534086956521739,0.7393913043478261,0.7253521739130435,0.7104565217391304,0
1226,380000,0,1,1,46,0,0,0,0,0,-1,141102,84229,28749,14258,7594,190628,5034,2071,29,72,190710,30052,1,136068,82158,28720,14186,-183116,160576,0.3580736842105263,0.21620526315789473,0.07557894736842105,0.037331578947368424,-0.4818842105263158,0.4225684210526316,-1
1227,500000,1,2,1,53,-1,-1,-1,-1,0,-1,7855,17481,12021,132906,122256,37380,17512,12021,132906,0,37380,3500,1,-9657,5460,-120885,132906,84876,33880,-0.019314,0.01092,-0.24177,0.265812,0.169752,0.06776,-5
1228,20000,1,2,1,38,0,0,0,0,0,0,11904,13193,12236,13041,13641,14251,1500,1400,1500,1000,1000,0,1,10404,11793,10736,12041,12641,14251,0.5202,0.58965,0.5368,0.60205,0.63205,0.71255,0
1229,50000,1,3,1,40,0,0,0,0,0,0,48489,49495,50866,48390,17953,23,1813,2184,1248,359,0,20706,1,46676,47311,49618,48031,17953,-20683,0.93352,0.94622,0.99236,0.96062,0.35906,-0.41366,0
1230,80000,1,2,2,23,2,3,2,2,0,0,84176,81516,80146,61392,60325,60469,0,2000,0,3091,2400,2000,0,84176,79516,80146,58301,57925,58469,1.0522,0.99395,1.001825,0.7287625,0.7240625,0.7308625,9
1231,20000,0,2,2,23,0,0,2,0,0,0,18804,17855,17199,17548,17992,31150,2150,1000,504,600,4000,4000,0,16654,16855,16695,16948,13992,27150,0.8327,0.84275,0.83475,0.8474,0.6996,1.3575,2
1232,360000,0,2,2,28,1,-2,-2,-2,-2,-2,0,0,0,0,0,0,0,0,0,0,0,0,0,0,0,0,0,0,0,0.0,0.0,0.0,0.0,0.0,0.0,-9
1233,200000,0,1,1,36,-1,-1,0,-1,-1,-1,3877,11496,5935,295,1867,0,11496,1011,297,2923,0,0,1,-7619,10485,5638,-2628,1867,0,-0.038095,0.052425,0.02819,-0.01314,0.009335,0.0,-5
1234,30000,1,1,2,30,0,0,0,0,0,0,32751,33804,31336,32389,33142,33999,1600,2000,1500,1200,1330,2500,0,31151,31804,29836,31189,31812,31499,1.0383666666666667,1.0601333333333334,0.9945333333333334,1.0396333333333334,1.0604,1.0499666666666667,0
1235,10000,1,3,2,22,0,0,2,0,0,0,10012,9784,9473,8947,9135,8613,2452,7,308,320,328,1000,0,7560,9777,9165,8627,8807,7613,0.756,0.9777,0.9165,0.8627,0.8807,0.7613,2
1236,250000,0,3,1,28,0,0,0,0,0,0,191305,90497,92278,93354,95309,97411,3899,3913,3186,3301,3525,3095,1,187406,86584,89092,90053,91784,94316,0.749624,0.346336,0.356368,0.360212,0.367136,0.377264,0
1237,50000,0,2,2,47,0,0,0,0,0,0,19949,19356,19849,20301,17951,17254,2000,2000,2000,1000,1000,1000,0,17949,17356,17849,19301,16951,16254,0.35898,0.34712,0.35698,0.38602,0.33902,0.32508,0
1238,100000,0,2,2,32,0,0,0,2,2,2,34904,37007,42076,41105,44090,48914,3000,6000,0,4000,5700,2000,0,31904,31007,42076,37105,38390,46914,0.31904,0.31007,0.42076,0.37105,0.3839,0.46914,6
1239,100000,1,2,1,33,0,0,0,0,0,0,82308,83994,85688,86643,88280,90054,3261,3307,2581,2502,2525,2600,1,79047,80687,83107,84141,85755,87454,0.79047,0.80687,0.83107,0.84141,0.85755,0.87454,0
1240,50000,1,1,1,25,0,0,0,0,0,0,51044,50231,46677,44982,21399,20859,2500,3008,1000,761,800,704,1,48544,47223,45677,44221,20599,20155,0.97088,0.94446,0.91354,0.88442,0.41198,0.4031,0
1241,240000,1,3,2,36,1,-2,-2,-2,-1,-1,-28,-28,-28,-28,1522,6820,0,0,0,1550,6900,4100,0,-28,-28,-28,-1578,-5378,2720,-0.00011666666666666667,-0.00011666666666666667,-0.00011666666666666667,-0.006575,-0.022408333333333332,0.011333333333333334,-7
1242,80000,0,3,2,46,2,0,0,0,0,0,77142,78255,79425,70583,48308,46049,3000,3055,3047,1663,1692,1618,0,74142,75200,76378,68920,46616,44431,0.926775,0.94,0.954725,0.8615,0.5827,0.5553875,2
1243,200000,1,2,2,27,2,2,0,0,0,0,186806,166153,157633,145423,146202,144685,0,6908,5200,5400,5700,9101,0,186806,159245,152433,140023,140502,135584,0.93403,0.796225,0.762165,0.700115,0.70251,0.67792,4
1244,440000,1,2,1,47,1,-1,-1,-1,-1,-1,-6,1160,1807,-11,2220,165,1166,1891,0,2231,165,1573,1,-1172,-731,1807,-2242,2055,-1408,-0.0026636363636363637,-0.0016613636363636364,0.004106818181818182,-0.005095454545454545,0.004670454545454545,-0.0032,-4
1245,170000,0,1,2,51,0,0,0,0,0,0,201851,195038,189067,180389,137030,129222,6873,7509,5573,4309,4239,5142,0,194978,187529,183494,176080,132791,124080,1.146929411764706,1.1031117647058823,1.0793764705882354,1.035764705882353,0.7811235294117647,0.7298823529411764,0
1246,50000,1,2,2,26,0,0,0,0,0,0,49722,49052,49243,8760,8796,9176,2200,1325,490,300,500,500,0,47522,47727,48753,8460,8296,8676,0.95044,0.95454,0.97506,0.1692,0.16592,0.17352,0
1247,30000,0,2,1,47,2,2,2,0,0,0,24081,29818,28966,26902,25426,26799,6155,0,1030,1049,5000,482,1,17926,29818,27936,25853,20426,26317,0.5975333333333334,0.9939333333333333,0.9312,0.8617666666666667,0.6808666666666666,0.8772333333333333,6
1248,440000,0,1,2,37,0,0,0,0,0,0,186061,232558,312398,222336,223882,130672,50000,100448,7015,6422,6086,4000,0,136061,132110,305383,215914,217796,126672,0.30922954545454545,0.30025,0.6940522727272728,0.49071363636363635,0.4949909090909091,0.2878909090909091,0
1249,160000,1,2,1,34,-1,-1,-1,-1,-1,-1,2734,0,625,406,338,0,0,625,406,338,0,0,1,2734,-625,219,68,338,0,0.0170875,-0.00390625,0.00136875,0.000425,0.0021125,0.0,-6
1250,150000,0,3,1,45,-2,-2,-2,-2,-2,-2,389,349,8362,882,1594,1385,350,8403,886,1602,1391,1156,1,39,-8054,7476,-720,203,229,0.00026,-0.053693333333333336,0.04984,-0.0048,0.0013533333333333333,0.0015266666666666666,-12
1251,270000,1,1,1,31,0,0,0,0,0,0,86716,88329,91247,91823,93164,95211,6000,6005,4000,4000,4000,5000,1,80716,82324,87247,87823,89164,90211,0.29894814814814813,0.3049037037037037,0.32313703703703706,0.3252703703703704,0.33023703703703705,0.3341148148148148,0
1252,100000,1,1,2,42,0,0,0,0,0,-2,61618,60380,58567,79527,18950,19667,2406,2200,22004,656,1000,396,0,59212,58180,36563,78871,17950,19271,0.59212,0.5818,0.36563,0.78871,0.1795,0.19271,-2
1253,50000,0,3,1,31,1,-2,-2,-2,-2,-2,0,0,0,0,0,0,0,0,0,0,0,0,1,0,0,0,0,0,0,0.0,0.0,0.0,0.0,0.0,0.0,-9
1254,50000,0,2,2,32,-1,2,2,-1,-1,-2,780,390,0,780,0,0,0,0,780,0,0,0,0,780,390,-780,780,0,0,0.0156,0.0078,-0.0156,0.0156,0.0,0.0,-1
1255,370000,0,1,1,45,0,0,0,0,0,0,123485,129885,134782,141002,145637,149281,10000,7000,10000,7000,6000,6000,1,113485,122885,124782,134002,139637,143281,0.3067162162162162,0.3321216216216216,0.3372486486486487,0.36216756756756757,0.3773972972972973,0.38724594594594597,0
1256,180000,0,1,1,38,2,2,2,2,2,2,47276,49256,50186,51102,52178,53213,3000,2000,2000,2000,2000,2100,1,44276,47256,48186,49102,50178,51113,0.24597777777777777,0.26253333333333334,0.2677,0.2727888888888889,0.27876666666666666,0.2839611111111111,12
1257,60000,1,3,1,48,0,0,0,0,0,0,58653,59063,53377,37418,37543,35447,2500,2000,1900,1500,1300,1300,1,56153,57063,51477,35918,36243,34147,0.9358833333333333,0.95105,0.85795,0.5986333333333334,0.60405,0.5691166666666667,0
1258,150000,1,1,1,44,-1,-1,-1,-2,-2,-2,1843,1367,0,0,0,0,1367,0,0,0,0,0,1,476,1367,0,0,0,0,0.003173333333333333,0.009113333333333333,0.0,0.0,0.0,0.0,-9
1259,100000,0,2,2,35,-1,2,2,-1,-1,2,8102,10252,5607,59265,62554,55392,2500,0,59265,4100,2500,0,0,5602,10252,-53658,55165,60054,55392,0.05602,0.10252,-0.53658,0.55165,0.60054,0.55392,3
1260,90000,1,2,1,38,0,0,0,0,0,0,88758,89680,89876,49922,46302,45430,3900,3487,1629,4000,3000,813,1,84858,86193,88247,45922,43302,44617,0.9428666666666666,0.9577,0.9805222222222222,0.5102444444444444,0.48113333333333336,0.49574444444444443,0
1261,30000,1,2,1,39,0,-1,-1,2,0,0,22215,18243,29013,28256,28979,31369,18243,11500,0,1177,3000,0,1,3972,6743,29013,27079,25979,31369,0.1324,0.22476666666666667,0.9671,0.9026333333333333,0.8659666666666667,1.0456333333333334,0
1262,80000,1,2,1,24,0,0,0,2,2,2,48578,50789,54936,55735,56699,55632,3000,5000,2300,2000,0,2500,1,45578,45789,52636,53735,56699,53132,0.569725,0.5723625,0.65795,0.6716875,0.7087375,0.66415,6
1263,110000,1,2,1,27,1,2,2,0,0,0,110593,111679,108455,109392,78524,75745,4363,0,4012,3120,2800,3000,1,106230,111679,104443,106272,75724,72745,0.9657272727272728,1.0152636363636363,0.9494818181818182,0.9661090909090909,0.6884,0.6613181818181818,5
1264,140000,0,3,2,29,0,0,0,0,0,0,7307,11718,5280,8166,18002,22262,5000,3000,3000,10000,5000,2500,0,2307,8718,2280,-1834,13002,19762,0.01647857142857143,0.062271428571428575,0.016285714285714285,-0.0131,0.09287142857142858,0.14115714285714287,0
1265,20000,1,3,1,35,0,0,2,2,0,0,15791,18218,18621,18024,18434,19826,3000,1000,0,700,1700,0,1,12791,17218,18621,17324,16734,19826,0.63955,0.8609,0.93105,0.8662,0.8367,0.9913,4
1266,210000,1,1,2,39,-1,-1,-1,-1,-2,-2,6000,0,2880,0,0,0,0,2880,0,0,0,0,0,6000,-2880,2880,0,0,0,0.02857142857142857,-0.013714285714285714,0.013714285714285714,0.0,0.0,0.0,-8
1267,300000,1,3,2,29,-2,-2,-2,-2,-2,-2,-140,28092,3572,195,209,990,28232,3589,195,210,994,0,0,-28372,24503,3377,-15,-785,990,-0.09457333333333333,0.08167666666666666,0.011256666666666667,-5e-05,-0.002616666666666667,0.0033,-12
1268,150000,0,3,1,43,-1,2,-1,-1,-1,-1,1280,390,390,780,1746,0,0,390,780,1746,0,0,1,1280,0,-390,-966,1746,0,0.008533333333333334,0.0,-0.0026,-0.00644,0.01164,0.0,-3
1269,150000,0,1,2,29,-1,0,0,0,0,-1,108756,152194,105290,149530,146455,141711,46980,64890,122080,106625,141711,138195,0,61776,87304,-16790,42905,4744,3516,0.41184,0.5820266666666667,-0.11193333333333333,0.2860333333333333,0.031626666666666664,0.02344,-2
1270,110000,0,1,2,30,0,0,0,0,2,2,60290,61688,63100,70391,68661,77511,3000,3000,9000,0,10000,3000,0,57290,58688,54100,70391,58661,74511,0.5208181818181818,0.5335272727272727,0.4918181818181818,0.6399181818181818,0.5332818181818182,0.6773727272727272,4
1271,20000,0,2,2,31,0,0,0,2,0,0,12214,13694,16660,16100,17521,19237,2000,3200,0,2000,2000,0,0,10214,10494,16660,14100,15521,19237,0.5107,0.5247,0.833,0.705,0.77605,0.96185,2
1272,60000,0,2,2,25,2,2,2,0,0,0,60323,60729,56473,28603,22191,20750,2000,0,1135,1822,1500,1500,0,58323,60729,55338,26781,20691,19250,0.97205,1.01215,0.9223,0.44635,0.34485,0.32083333333333336,6
1273,20000,0,3,2,25,0,0,2,3,2,2,9248,11859,14264,13746,13228,14333,3100,2900,0,0,1325,670,0,6148,8959,14264,13746,11903,13663,0.3074,0.44795,0.7132,0.6873,0.59515,0.68315,9
1274,170000,0,3,1,46,-1,-1,-1,-1,-1,0,1804,1804,1804,1804,3608,1804,1804,1804,1804,3608,0,1804,1,0,0,0,-1804,3608,0,0.0,0.0,0.0,-0.010611764705882354,0.021223529411764707,0.0,-5
1275,150000,1,2,1,38,-2,-2,-2,-2,-2,-2,1106,2199,2997,735,1104,0,1208,1006,50000,1104,0,0,1,-102,1193,-47003,-369,1104,0,-0.00068,0.007953333333333333,-0.3133533333333333,-0.00246,0.00736,0.0,-12
1276,380000,1,2,1,45,0,0,0,0,0,0,220208,225537,230898,237118,240452,245499,9000,9000,10068,8768,9087,9133,1,211208,216537,220830,228350,231365,236366,0.5558105263157894,0.5698342105263158,0.5811315789473684,0.6009210526315789,0.6088552631578947,0.6220157894736842,0
1277,100000,1,2,1,41,-1,-1,-1,-1,-1,0,621,0,368,0,1900,1900,0,368,0,1900,0,1145,1,621,-368,368,-1900,1900,755,0.00621,-0.00368,0.00368,-0.019,0.019,0.00755,-5
1278,50000,0,2,2,30,1,-1,-1,-1,0,0,0,676,-104,9732,9927,9339,676,0,10500,337,333,407,0,-676,676,-10604,9395,9594,8932,-0.01352,0.01352,-0.21208,0.1879,0.19188,0.17864,-2
1279,180000,0,2,2,39,0,0,0,0,0,0,119466,120491,124553,127096,128992,131660,4500,6000,6100,5500,4900,5500,0,114966,114491,118453,121596,124092,126160,0.6387,0.6360611111111111,0.6580722222222222,0.6755333333333333,0.6894,0.7008888888888889,0
1280,50000,1,2,3,30,2,2,0,0,0,0,40087,38281,34519,33965,33273,31960,0,1466,1282,1293,1257,3013,0,40087,36815,33237,32672,32016,28947,0.80174,0.7363,0.66474,0.65344,0.64032,0.57894,4
1281,330000,1,1,2,30,-1,-1,-2,-2,-2,-2,5014,59970,18585,13835,45476,25125,60207,18585,13835,45476,25125,21370,0,-55193,41385,4750,-31641,20351,3755,-0.16725151515151515,0.12540909090909091,0.014393939393939395,-0.09588181818181818,0.06166969696969697,0.011378787878787879,-10
1282,20000,0,2,2,26,1,4,3,2,3,2,19276,18691,18048,18553,19465,16523,0,0,1000,1400,0,3000,0,19276,18691,17048,17153,19465,13523,0.9638,0.93455,0.8524,0.85765,0.97325,0.67615,15
1283,110000,0,1,2,28,0,0,0,0,0,0,107560,100395,79889,70062,70901,72754,4024,3008,3200,2600,3000,3000,0,103536,97387,76689,67462,67901,69754,0.9412363636363636,0.8853363636363636,0.6971727272727273,0.6132909090909091,0.6172818181818182,0.6341272727272728,0
1284,320000,0,1,1,49,0,0,0,-1,-1,-1,253286,246536,194663,70074,5856,195599,10358,10000,75940,20000,195599,50000,1,242928,236536,118723,50074,-189743,145599,0.75915,0.739175,0.371009375,0.15648125,-0.592946875,0.454996875,-3
1285,20000,1,2,1,35,1,2,2,2,0,0,16335,15780,18411,17809,18009,16595,0,3200,0,765,700,774,1,16335,12580,18411,17044,17309,15821,0.81675,0.629,0.92055,0.8522,0.86545,0.79105,7
1286,200000,1,1,1,34,-2,-2,-2,-2,-2,-2,2955,5895,15146,11575,11564,13744,5938,15682,11633,11622,13813,22699,1,-2983,-9787,3513,-47,-2249,-8955,-0.014915,-0.048935,0.017565,-0.000235,-0.011245,-0.044775,-12
1287,20000,1,2,3,47,1,2,0,0,0,0,9325,8562,9571,9912,10036,10400,1000,1159,500,432,600,0,0,8325,7403,9071,9480,9436,10400,0.41625,0.37015,0.45355,0.474,0.4718,0.52,3
1288,50000,0,2,1,47,0,0,0,0,0,0,50593,50420,49695,47862,18371,18601,1798,2198,1296,805,676,695,1,48795,48222,48399,47057,17695,17906,0.9759,0.96444,0.96798,0.94114,0.3539,0.35812,0
1289,50000,0,2,1,36,2,2,2,2,0,0,49732,48658,51802,50737,48763,50908,0,4000,7,1900,3903,2,1,49732,44658,51795,48837,44860,50906,0.99464,0.89316,1.0359,0.97674,0.8972,1.01812,8
1290,260000,0,1,1,37,0,0,0,0,0,0,244736,249018,253704,255353,175022,130299,10000,10000,5000,5000,5000,3200,1,234736,239018,248704,250353,170022,127099,0.9028307692307692,0.9193,0.9565538461538462,0.9628961538461539,0.6539307692307692,0.4888423076923077,0
1291,50000,0,3,3,39,0,0,0,0,0,0,31514,32346,26223,25791,19476,19066,1710,1787,1295,825,684,784,0,29804,30559,24928,24966,18792,18282,0.59608,0.61118,0.49856,0.49932,0.37584,0.36564,0
1292,150000,1,2,1,41,-1,-1,-2,-1,0,0,1650,0,0,6784,6923,14116,0,0,6784,159,167,760,1,1650,0,-6784,6625,6756,13356,0.011,0.0,-0.045226666666666665,0.04416666666666667,0.04504,0.08904,-5
1293,320000,1,1,2,28,0,0,0,0,0,0,293073,293210,290057,25922,22982,20553,13300,12756,1295,10312,8394,8242,0,279773,280454,288762,15610,14588,12311,0.874290625,0.87641875,0.90238125,0.04878125,0.0455875,0.038471875,0
1294,180000,1,3,1,41,-1,-1,-1,-1,-1,-1,6092,3576,13920,11112,3182,1985,4198,13935,11112,3182,1985,3276,1,1894,-10359,2808,7930,1197,-1291,0.010522222222222223,-0.05755,0.0156,0.044055555555555556,0.00665,-0.007172222222222222,-6
1295,150000,0,1,2,35,1,2,2,2,2,2,143376,145607,146509,148507,152044,136643,6000,4500,5100,5322,20,5033,0,137376,141107,141409,143185,152024,131610,0.91584,0.9407133333333333,0.9427266666666667,0.9545666666666667,1.0134933333333334,0.8774,11
1296,50000,1,2,1,25,2,0,0,0,0,0,50105,50802,49988,19287,19698,20228,2300,1305,1000,855,1000,1000,1,47805,49497,48988,18432,18698,19228,0.9561,0.98994,0.97976,0.36864,0.37396,0.38456,2
1297,250000,0,1,2,34,0,0,0,0,0,0,119310,132243,140069,292404,175050,181766,15000,10000,10000,60000,15000,6000,0,104310,122243,130069,232404,160050,175766,0.41724,0.488972,0.520276,0.929616,0.6402,0.703064,0
1298,20000,1,2,1,29,0,0,0,0,0,0,15890,13995,13375,14205,15869,16666,2000,2000,1000,2000,1000,1000,1,13890,11995,12375,12205,14869,15666,0.6945,0.59975,0.61875,0.61025,0.74345,0.7833,0
1299,50000,1,2,2,24,-2,-2,-1,2,2,0,0,0,37111,37516,36614,37537,0,37111,1307,0,1509,1388,0,0,-37111,35804,37516,35105,36149,0.0,-0.74222,0.71608,0.75032,0.7021,0.72298,-1
1300,220000,1,2,2,29,0,0,0,0,0,0,36106,33494,29518,29569,28587,21201,3000,3000,6000,5000,1136,10000,0,33106,30494,23518,24569,27451,11201,0.1504818181818182,0.1386090909090909,0.1069,0.11167727272727272,0.12477727272727272,0.05091363636363636,0
1301,260000,0,2,2,33,0,0,0,0,0,-1,19152,19934,21693,25492,29876,416,5000,5000,5000,5000,416,566,0,14152,14934,16693,20492,29460,-150,0.054430769230769234,0.057438461538461535,0.06420384615384615,0.07881538461538462,0.1133076923076923,-0.000576923076923077,-1
1302,260000,0,1,1,51,-1,-1,-1,-1,-1,-2,771,1593,419,529,0,4090,1596,437,529,0,4090,98,1,-825,1156,-110,529,-4090,3992,-0.003173076923076923,0.004446153846153846,-0.0004230769230769231,0.0020346153846153847,-0.015730769230769232,0.015353846153846154,-7
1303,80000,1,4,2,27,0,0,0,0,0,0,45268,47140,47411,48443,49478,43264,2600,1800,1700,1700,1700,1300,0,42668,45340,45711,46743,47778,41964,0.53335,0.56675,0.5713875,0.5842875,0.597225,0.52455,0
1304,280000,1,2,1,39,0,0,0,0,0,0,269472,253792,276979,238527,239280,238926,8229,150062,50000,4786,4779,4876,1,261243,103730,226979,233741,234501,234050,0.9330107142857142,0.3704642857142857,0.8106392857142857,0.8347892857142857,0.8375035714285715,0.8358928571428571,0
1305,30000,0,1,2,34,2,2,2,2,2,0,21107,24117,24424,24627,24093,24785,3374,1000,900,0,1094,1000,0,17733,23117,23524,24627,22999,23785,0.5911,0.7705666666666666,0.7841333333333333,0.8209,0.7666333333333334,0.7928333333333333,10
1306,50000,0,1,2,34,-1,-1,-1,0,0,0,27465,24125,47444,43028,43719,0,24125,60003,5000,30000,34000,0,0,3340,-35878,42444,13028,9719,0,0.0668,-0.71756,0.84888,0.26056,0.19438,0.0,-3
1307,160000,0,3,1,30,1,2,0,0,0,0,102867,82729,72583,60565,54651,48468,31,2609,2037,2010,2017,3012,1,102836,80120,70546,58555,52634,45456,0.642725,0.50075,0.4409125,0.36596875,0.3289625,0.2841,3
1308,130000,1,3,1,49,0,0,0,0,0,0,108711,107996,87817,47175,48126,49234,6000,4542,2200,2000,2000,2000,1,102711,103454,85617,45175,46126,47234,0.7900846153846154,0.7958,0.6585923076923077,0.3475,0.3548153846153846,0.36333846153846155,0
1309,50000,1,2,2,36,0,0,0,0,0,0,37329,32540,26601,27358,28017,28593,1500,1500,1200,1100,1042,1009,0,35829,31040,25401,26258,26975,27584,0.71658,0.6208,0.50802,0.52516,0.5395,0.55168,0
1310,300000,0,1,2,28,1,-2,-2,-2,-2,-2,0,0,0,0,0,0,0,0,0,0,0,0,0,0,0,0,0,0,0,0.0,0.0,0.0,0.0,0.0,0.0,-9
1311,190000,1,2,2,53,0,0,0,0,0,0,173058,133198,131891,133516,135008,136486,6300,5000,5000,5000,5100,5000,0,166758,128198,126891,128516,129908,131486,0.8776736842105263,0.6747263157894737,0.6678473684210526,0.6764,0.6837263157894737,0.6920315789473684,0
1312,190000,1,1,2,40,0,0,0,0,0,0,122308,124332,126944,130606,131120,133774,4445,5000,6171,4536,5150,5000,0,117863,119332,120773,126070,125970,128774,0.6203315789473685,0.6280631578947369,0.6356473684210526,0.6635263157894736,0.663,0.6777578947368421,0
1313,50000,0,2,2,25,0,0,0,0,0,0,50479,48294,48735,45036,19246,18872,1649,11890,1367,668,675,673,0,48830,36404,47368,44368,18571,18199,0.9766,0.72808,0.94736,0.88736,0.37142,0.36398,0
1314,110000,1,1,1,35,0,0,0,0,0,0,107905,101573,104079,104829,107400,105694,4000,5300,4000,4200,4000,3800,1,103905,96273,100079,100629,103400,101894,0.944590909090909,0.8752090909090909,0.9098090909090909,0.9148090909090909,0.94,0.9263090909090909,0
1315,480000,1,2,1,54,-2,-2,-2,-2,-2,-2,17189,6013,1717,1385,0,0,6026,1717,1390,0,0,2300,1,11163,4296,327,1385,0,-2300,0.02325625,0.00895,0.00068125,0.0028854166666666668,0.0,-0.004791666666666666,-12
1316,180000,1,1,2,26,-1,-1,-1,-1,-1,-1,2049,0,351,631,13359,384,0,351,631,13359,384,487,0,2049,-351,-280,-12728,12975,-103,0.011383333333333334,-0.00195,-0.0015555555555555555,-0.07071111111111111,0.07208333333333333,-0.0005722222222222222,-6
1317,380000,0,1,1,41,-1,-1,-1,-2,-2,-2,3907,13253,-4,-4,-4,-4,13345,0,0,0,0,0,1,-9438,13253,-4,-4,-4,-4,-0.024836842105263157,0.034876315789473686,-1.0526315789473684e-05,-1.0526315789473684e-05,-1.0526315789473684e-05,-1.0526315789473684e-05,-9
1318,320000,0,1,2,28,-2,-2,-2,-2,-2,-2,26149,3860,360,360,0,720,3894,360,360,0,720,334,0,22255,3500,0,360,-720,386,0.069546875,0.0109375,0.0,0.001125,-0.00225,0.00120625,-12
1319,170000,1,2,2,51,0,0,0,0,0,0,154278,161679,165068,166227,109682,112906,10000,7500,6778,4000,5000,5000,0,144278,154179,158290,162227,104682,107906,0.8486941176470588,0.9069352941176471,0.9311176470588235,0.9542764705882353,0.6157764705882353,0.6347411764705883,0
1320,420000,0,1,2,32,-2,-2,-2,-2,-2,-1,11728,8860,4829,12181,7597,17772,8904,4866,12241,7635,17858,10057,0,2824,3994,-7412,4546,-10261,7715,0.006723809523809523,0.00950952380952381,-0.017647619047619047,0.010823809523809524,-0.02443095238095238,0.018369047619047618,-11
1321,130000,1,1,2,26,-1,-1,-1,-1,-1,-1,3597,4398,3738,1396,13069,1285,4398,3746,1396,13069,1285,1034,0,-801,652,2342,-11673,11784,251,-0.006161538461538461,0.005015384615384615,0.018015384615384614,-0.0897923076923077,0.09064615384615385,0.0019307692307692307,-6
1322,180000,1,2,2,29,0,0,0,2,0,0,172271,179760,180488,142201,141826,125974,11600,9635,0,5245,5172,3726,0,160671,170125,180488,136956,136654,122248,0.8926166666666666,0.9451388888888889,1.002711111111111,0.7608666666666667,0.7591888888888889,0.6791555555555555,2
1323,290000,1,3,1,49,0,0,0,-1,-1,0,169004,166920,153092,3804,155233,148003,7600,7521,3804,160897,5198,6000,1,161404,159399,149288,-157093,150035,142003,0.5565655172413793,0.5496517241379311,0.5147862068965517,-0.5417,0.5173620689655173,0.4896655172413793,-2
1324,150000,0,2,2,27,0,0,0,0,0,0,9489,11757,12438,14240,15288,-1000,2500,1202,3000,1048,0,23799,0,6989,10555,9438,13192,15288,-24799,0.046593333333333334,0.07036666666666666,0.06292,0.08794666666666667,0.10192,-0.16532666666666668,0
1325,350000,0,2,1,43,-2,-2,-2,-2,-2,-2,6088,3405,7763,20573,2367,11486,3436,7813,20604,2376,11493,13885,1,2652,-4408,-12841,18197,-9126,-2399,0.007577142857142857,-0.012594285714285714,-0.03668857142857143,0.05199142857142857,-0.026074285714285713,-0.006854285714285715,-12
1326,130000,1,2,2,24,0,0,0,0,0,0,121720,115630,115939,109428,90359,89216,4155,5802,3487,2908,3013,3093,0,117565,109828,112452,106520,87346,86123,0.9043461538461538,0.8448307692307693,0.8650153846153846,0.8193846153846154,0.6718923076923077,0.6624846153846153,0
1327,60000,1,2,2,25,0,0,0,0,0,0,7885,9244,11082,12133,16891,17615,1500,2000,1242,5000,1000,700,0,6385,7244,9840,7133,15891,16915,0.10641666666666667,0.12073333333333333,0.164,0.11888333333333333,0.26485,0.28191666666666665,0
1328,200000,0,2,1,32,-1,2,-1,0,0,0,9864,5114,499,499,499,0,0,499,0,0,0,0,1,9864,4615,499,499,499,0,0.04932,0.023075,0.002495,0.002495,0.002495,0.0,0
1329,180000,0,1,2,31,-2,-2,-2,-2,-2,-2,2930,3300,2860,4216,2609,9609,3300,2860,4216,2609,9700,6525,0,-370,440,-1356,1607,-7091,3084,-0.0020555555555555557,0.0024444444444444444,-0.007533333333333334,0.008927777777777778,-0.03939444444444445,0.017133333333333334,-12
1330,90000,1,3,2,26,0,0,0,0,0,0,91564,43201,42219,1769,2269,3269,3000,3000,1000,500,1000,86500,0,88564,40201,41219,1269,1269,-83231,0.9840444444444445,0.4466777777777778,0.4579888888888889,0.0141,0.0141,-0.9247888888888889,0
1331,340000,1,1,1,36,-1,-1,-1,-1,-1,0,4490,4834,17716,12010,14111,6995,4834,17716,12636,14111,0,5666,1,-344,-12882,5080,-2101,14111,1329,-0.0010117647058823529,-0.037888235294117646,0.014941176470588236,-0.006179411764705882,0.04150294117647059,0.003908823529411765,-5
1332,250000,1,1,1,43,-2,-2,-2,-2,-2,-2,331,0,0,0,0,0,0,0,0,0,0,0,1,331,0,0,0,0,0,0.001324,0.0,0.0,0.0,0.0,0.0,-12
1333,130000,0,1,2,29,1,-2,-2,-2,-2,-2,0,0,0,0,0,0,0,0,0,0,0,1500,0,0,0,0,0,0,-1500,0.0,0.0,0.0,0.0,0.0,-0.011538461538461539,-9
1334,160000,1,1,1,38,0,0,0,0,0,0,132932,134384,131724,131767,133195,126064,8005,15000,10000,7000,5000,8000,1,124927,119384,121724,124767,128195,118064,0.78079375,0.74615,0.760775,0.77979375,0.80121875,0.7379,0
1335,440000,1,2,2,40,0,0,0,0,0,0,98496,82803,79894,73984,137370,132889,10000,10000,10000,80000,7000,6000,0,88496,72803,69894,-6016,130370,126889,0.20112727272727274,0.16546136363636363,0.15885,-0.013672727272727272,0.29629545454545453,0.2883840909090909,0
1336,50000,1,2,1,36,3,2,2,2,3,2,47222,48142,48082,51969,50865,49611,2000,1000,5000,0,0,2500,1,45222,47142,43082,51969,50865,47111,0.90444,0.94284,0.86164,1.03938,1.0173,0.94222,14
1337,230000,1,2,2,33,0,0,0,0,0,0,232796,233564,235149,166637,165699,163858,9000,9500,6000,6150,6000,10500,0,223796,224064,229149,160487,159699,153358,0.9730260869565217,0.9741913043478261,0.9963,0.6977695652173913,0.6943434782608696,0.6667739130434782,0
1338,50000,0,2,2,23,2,0,0,0,0,0,49301,50660,50036,60770,10598,10122,2500,2142,2254,680,491,340,0,46801,48518,47782,60090,10107,9782,0.93602,0.97036,0.95564,1.2018,0.20214,0.19564,2
1339,30000,1,2,2,23,0,0,0,0,0,0,34084,33476,32006,31672,31247,30673,1521,1573,1500,1300,1300,1329,0,32563,31903,30506,30372,29947,29344,1.0854333333333333,1.0634333333333332,1.0168666666666666,1.0124,0.9982333333333333,0.9781333333333333,0
1340,10000,0,2,2,30,0,-1,0,-1,-1,-1,1473,3236,4790,390,0,780,3236,2000,390,0,780,0,0,-1763,1236,4400,390,-780,780,-0.1763,0.1236,0.44,0.039,-0.078,0.078,-4
1341,230000,0,2,2,28,-2,-2,-2,-2,-2,-2,-73,-73,-73,-73,7723,0,0,0,0,7796,0,0,0,-73,-73,-73,-7869,7723,0,-0.0003173913043478261,-0.0003173913043478261,-0.0003173913043478261,-0.03421304347826087,0.03357826086956522,0.0,-12
1342,150000,0,1,2,28,-2,-2,-2,-2,-2,-2,5797,434,11021,6253,6257,4152,436,11086,6284,6288,4172,3207,0,5361,-10652,4737,-35,2085,945,0.03574,-0.07101333333333333,0.03158,-0.00023333333333333333,0.0139,0.0063,-12
1343,200000,1,1,1,35,-1,2,-1,-1,-1,-1,1972,582,1891,0,1908,290,0,1891,0,1908,290,3100,1,1972,-1309,1891,-1908,1618,-2810,0.00986,-0.006545,0.009455,-0.00954,0.00809,-0.01405,-3
1344,300000,0,2,2,29,0,0,0,0,0,0,49917,49833,49831,51818,50244,49484,5000,5000,5000,5000,5000,5000,0,44917,44833,44831,46818,45244,44484,0.14972333333333335,0.14944333333333334,0.14943666666666666,0.15606,0.15081333333333333,0.14828,0
1345,50000,0,2,2,29,0,0,-2,-2,-2,-2,30900,0,0,0,0,0,0,0,0,1500,0,0,0,30900,0,0,-1500,0,0,0.618,0.0,0.0,-0.03,0.0,0.0,-8
1346,50000,0,3,2,46,0,0,0,0,0,-1,5942,5444,2464,2521,-1,167,1056,1000,57,0,168,1002,0,4886,4444,2407,2521,-169,-835,0.09772,0.08888,0.04814,0.05042,-0.00338,-0.0167,-1
1347,450000,1,1,1,69,-1,-1,-1,-1,-1,-1,2000,0,1173,0,6265,2374,0,1173,0,6265,2374,708,1,2000,-1173,1173,-6265,3891,1666,0.0044444444444444444,-0.002606666666666667,0.002606666666666667,-0.013922222222222223,0.008646666666666667,0.003702222222222222,-6
1348,20000,0,2,2,36,3,2,2,7,7,7,2400,2400,2400,2400,2400,2400,0,0,0,0,0,0,0,2400,2400,2400,2400,2400,2400,0.12,0.12,0.12,0.12,0.12,0.12,28
1349,380000,0,1,1,50,0,0,0,0,0,0,211463,201613,191343,184267,172328,230031,10000,10000,10000,20000,95000,50000,1,201463,191613,181343,164267,77328,180031,0.5301657894736842,0.5042447368421052,0.47721842105263157,0.4322815789473684,0.20349473684210526,0.4737657894736842,0
1350,200000,0,3,2,40,-2,-2,-2,-2,-2,-2,390,1799,390,390,418,1604,1799,390,390,418,1604,0,0,-1409,1409,0,-28,-1186,1604,-0.007045,0.007045,0.0,-0.00014,-0.00593,0.00802,-12
1351,30000,1,2,1,23,0,0,0,0,0,0,27222,27630,28618,28833,9895,12155,1450,1638,1053,2000,5155,4145,1,25772,25992,27565,26833,4740,8010,0.8590666666666666,0.8664,0.9188333333333333,0.8944333333333333,0.158,0.267,0
1352,150000,1,1,2,29,-1,-1,-1,0,0,0,2356,16836,1094,6382,5288,5288,16836,2000,5288,0,0,0,0,-14480,14836,-4194,6382,5288,5288,-0.09653333333333333,0.09890666666666667,-0.02796,0.04254666666666667,0.03525333333333333,0.03525333333333333,-3
1353,300000,1,1,1,37,-1,-1,0,-1,-1,-1,3144,5688,2297,3115,3172,1589,5734,2018,3138,3187,1597,2394,1,-2590,3670,-841,-72,1575,-805,-0.008633333333333333,0.012233333333333334,-0.0028033333333333335,-0.00024,0.00525,-0.002683333333333333,-5
1354,260000,1,2,1,31,0,0,0,0,0,0,82156,83083,85346,87620,89566,91502,3611,3712,3800,3500,3400,3100,1,78545,79371,81546,84120,86166,88402,0.30209615384615385,0.3052730769230769,0.31363846153846153,0.32353846153846155,0.3314076923076923,0.3400076923076923,0
1355,20000,0,2,1,40,1,2,3,2,3,3,14829,17267,16706,18694,19049,18459,3000,0,2560,955,0,661,1,11829,17267,14146,17739,19049,17798,0.59145,0.86335,0.7073,0.88695,0.95245,0.8899,14
1356,160000,1,2,1,60,-2,-2,-2,-2,-2,-2,16060,1605,4200,2461,0,0,1605,4200,2461,0,0,230,1,14455,-2595,1739,2461,0,-230,0.09034375,-0.01621875,0.01086875,0.01538125,0.0,-0.0014375,-12
1357,50000,0,3,2,47,0,0,0,0,0,0,44681,45736,46658,44441,18559,17781,2100,2009,2013,700,1000,1000,0,42581,43727,44645,43741,17559,16781,0.85162,0.87454,0.8929,0.87482,0.35118,0.33562,0
1358,40000,1,2,2,53,3,2,2,0,0,2,14186,15264,14708,14704,16997,16568,1600,0,500,2500,0,209,0,12586,15264,14208,12204,16997,16359,0.31465,0.3816,0.3552,0.3051,0.424925,0.408975,9
1359,50000,1,3,2,24,1,2,0,0,0,0,50162,48982,43579,43825,28396,27437,0,2207,2300,1006,1000,1100,0,50162,46775,41279,42819,27396,26337,1.00324,0.9355,0.82558,0.85638,0.54792,0.52674,3
1360,30000,0,2,2,26,0,0,0,0,0,0,26301,27376,28359,24844,25364,25935,1500,1450,889,920,992,1000,0,24801,25926,27470,23924,24372,24935,0.8267,0.8642,0.9156666666666666,0.7974666666666667,0.8124,0.8311666666666667,0
1361,360000,0,3,2,54,-2,-2,-2,-2,-2,-2,0,0,0,0,0,0,0,0,0,0,0,0,0,0,0,0,0,0,0,0.0,0.0,0.0,0.0,0.0,0.0,-12
1362,10000,0,2,2,36,0,0,2,0,0,0,6672,8405,8869,8901,9838,6771,2000,800,240,1000,771,1100,0,4672,7605,8629,7901,9067,5671,0.4672,0.7605,0.8629,0.7901,0.9067,0.5671,2
1363,60000,0,1,2,25,-1,0,0,0,0,0,1193,49461,51024,32215,31088,33581,48967,2530,1525,1200,3000,1400,0,-47774,46931,49499,31015,28088,32181,-0.7962333333333333,0.7821833333333333,0.8249833333333333,0.5169166666666667,0.46813333333333335,0.53635,-1
1364,50000,1,2,1,22,0,0,0,0,0,0,48560,49644,47247,42541,19716,20145,2000,2003,1298,1000,800,879,1,46560,47641,45949,41541,18916,19266,0.9312,0.95282,0.91898,0.83082,0.37832,0.38532,0
1365,10000,1,2,2,36,1,2,0,0,0,0,7081,6819,7996,9004,9180,9371,0,1290,1298,474,487,500,0,7081,5529,6698,8530,8693,8871,0.7081,0.5529,0.6698,0.853,0.8693,0.8871,3
1366,30000,0,2,2,21,0,0,0,0,0,0,26587,25917,17072,15994,12017,5614,1385,1270,367,336,112,0,0,25202,24647,16705,15658,11905,5614,0.8400666666666666,0.8215666666666667,0.5568333333333333,0.5219333333333334,0.3968333333333333,0.18713333333333335,0
1367,390000,0,2,2,28,0,0,0,0,0,0,149445,139794,133224,106127,51097,38555,8046,5150,5297,5084,5065,5042,0,141399,134644,127927,101043,46032,33513,0.36256153846153844,0.34524102564102566,0.3280179487179487,0.25908461538461536,0.11803076923076923,0.08593076923076923,0
1368,160000,1,2,1,25,0,0,0,0,0,0,83005,84023,81765,84265,84437,81265,3900,3300,3906,3000,3100,3120,1,79105,80723,77859,81265,81337,78145,0.49440625,0.50451875,0.48661875,0.50790625,0.50835625,0.48840625,0
1369,70000,0,1,2,33,0,0,0,0,0,0,63845,65443,65169,64370,15082,0,3224,1680,3000,142,142,0,0,60621,63763,62169,64228,14940,0,0.8660142857142857,0.9109,0.8881285714285714,0.9175428571428571,0.21342857142857144,0.0,0
1370,340000,1,2,1,31,0,0,0,0,0,0,192860,189272,137255,137180,135783,135201,7332,5008,6367,4800,4941,4696,1,185528,184264,130888,132380,130842,130505,0.5456705882352941,0.5419529411764706,0.38496470588235293,0.38935294117647057,0.38482941176470586,0.38383823529411765,0
1371,100000,1,3,1,55,-2,-2,-2,-2,-2,-2,390,390,390,390,390,390,390,390,390,390,390,390,1,0,0,0,0,0,0,0.0,0.0,0.0,0.0,0.0,0.0,-12
1372,230000,1,1,2,31,1,-2,-1,-1,-2,-1,-9,-9,986,0,0,900,0,995,0,0,900,0,0,-9,-1004,986,0,-900,900,-3.91304347826087e-05,-0.004365217391304348,0.004286956521739131,0.0,-0.00391304347826087,0.00391304347826087,-6
1373,240000,1,4,1,59,0,0,0,0,0,0,233918,235404,236564,241075,146440,132290,8357,10001,10000,10000,5000,20000,1,225561,225403,226564,231075,141440,112290,0.9398375,0.9391791666666667,0.9440166666666666,0.9628125,0.5893333333333334,0.467875,0
1374,90000,1,2,2,32,0,0,0,0,0,0,86076,87567,78646,79212,54659,55902,3012,3100,3116,2000,2100,2100,0,83064,84467,75530,77212,52559,53802,0.9229333333333334,0.9385222222222223,0.8392222222222222,0.8579111111111111,0.5839888888888889,0.5978,0
1375,500000,0,2,1,38,1,2,0,0,2,0,91662,88467,90193,94629,92621,80971,0,4500,7200,8,3403,2311,1,91662,83967,82993,94621,89218,78660,0.183324,0.167934,0.165986,0.189242,0.178436,0.15732,5
1376,150000,0,2,1,24,0,0,-1,-1,-1,0,139125,0,435,0,81824,83101,0,870,0,82259,3018,3102,1,139125,-870,435,-82259,78806,79999,0.9275,-0.0058,0.0029,-0.5483933333333333,0.5253733333333334,0.5333266666666666,-3
1377,160000,1,1,2,30,1,2,2,2,2,0,151270,153276,155301,155152,144602,148199,6000,6085,12534,0,6000,6000,0,145270,147191,142767,155152,138602,142199,0.9079375,0.91994375,0.89229375,0.9697,0.8662625,0.88874375,9
1378,20000,0,3,2,24,0,0,0,0,0,0,19438,16944,17990,19671,19244,19443,1273,1319,2000,674,693,693,0,18165,15625,15990,18997,18551,18750,0.90825,0.78125,0.7995,0.94985,0.92755,0.9375,0
1379,430000,1,1,1,33,-2,-2,-2,-2,-2,-1,1837,373,1198,0,538,77543,373,1198,0,538,77543,584,1,1464,-825,1198,-538,-77005,76959,0.003404651162790698,-0.0019186046511627908,0.002786046511627907,-0.0012511627906976743,-0.1790813953488372,0.17897441860465116,-11
1380,280000,0,2,2,28,-2,-2,-2,-2,-2,-2,1799,1768,1848,-8,1601,-3,1782,1857,0,1609,3,1077,0,17,-89,1848,-1617,1598,-1080,6.0714285714285715e-05,-0.00031785714285714284,0.0066,-0.005775,0.005707142857142857,-0.003857142857142857,-12
1381,220000,1,1,2,33,-1,2,2,0,0,0,1379,1205,825,1783,1205,1205,705,325,1283,507,705,705,0,674,880,-458,1276,500,500,0.0030636363636363634,0.004,-0.0020818181818181816,0.0058,0.0022727272727272726,0.0022727272727272726,3
1382,140000,1,2,2,29,0,0,0,0,0,0,43030,44335,45351,46317,55506,56609,2000,1755,1721,10000,2028,3000,0,41030,42580,43630,36317,53478,53609,0.2930714285714286,0.30414285714285716,0.31164285714285717,0.25940714285714284,0.38198571428571426,0.3829214285714286,0
1383,160000,0,1,1,41,0,0,0,0,-2,-2,97266,99466,102650,0,0,0,3769,5000,0,0,0,0,1,93497,94466,102650,0,0,0,0.58435625,0.5904125,0.6415625,0.0,0.0,0.0,-4
1384,260000,1,1,1,46,-1,-1,-1,-1,-1,-1,451,268,604,664,734,1076,268,604,664,734,1076,1220,1,183,-336,-60,-70,-342,-144,0.0007038461538461539,-0.0012923076923076922,-0.00023076923076923076,-0.0002692307692307692,-0.0013153846153846154,-0.0005538461538461539,-6
1385,240000,0,4,1,40,-2,-2,-2,-2,-2,-2,19295,2054,6984,0,0,0,2054,6984,0,0,0,0,1,17241,-4930,6984,0,0,0,0.0718375,-0.020541666666666666,0.0291,0.0,0.0,0.0,-12
1386,50000,0,3,2,24,-1,0,0,-1,-1,-2,25437,25873,0,100,0,0,2000,0,100,0,0,0,0,23437,25873,-100,100,0,0,0.46874,0.51746,-0.002,0.002,0.0,0.0,-5
1387,470000,1,2,1,27,0,0,0,0,-1,0,152478,62084,54551,14363,97440,90717,3001,4005,2021,97441,5001,5001,1,149477,58079,52530,-83078,92439,85716,0.318036170212766,0.12357234042553192,0.1117659574468085,-0.17676170212765957,0.19667872340425532,0.18237446808510638,-1
1388,450000,1,2,1,44,0,0,0,0,0,0,10716,12254,12815,17782,9074,8490,8000,5000,7000,3000,2000,1626,1,2716,7254,5815,14782,7074,6864,0.006035555555555555,0.01612,0.012922222222222222,0.032848888888888886,0.01572,0.015253333333333334,0
1389,180000,0,1,2,27,0,0,0,0,0,0,13895,14385,13190,17676,14792,11210,5000,3000,8700,1500,600,4000,0,8895,11385,4490,16176,14192,7210,0.049416666666666664,0.06325,0.024944444444444446,0.08986666666666666,0.07884444444444444,0.04005555555555555,0
1390,200000,1,1,1,38,0,0,0,0,0,0,185155,180069,179899,170716,164553,165326,6500,8000,7520,6000,6100,7500,1,178655,172069,172379,164716,158453,157826,0.893275,0.860345,0.861895,0.82358,0.792265,0.78913,0
1391,500000,0,1,1,37,-1,-1,-1,-1,-1,-1,37443,24110,28593,22707,23495,40283,24197,28832,22784,23536,40542,12169,1,13246,-4722,5809,-829,-17047,28114,0.026492,-0.009444,0.011618,-0.001658,-0.034094,0.056228,-6
1392,20000,0,3,2,48,-1,-1,-2,-1,-1,-1,170,-220,-610,390,0,19993,0,0,1390,0,20773,400,0,170,-220,-2000,390,-20773,19593,0.0085,-0.011,-0.1,0.0195,-1.03865,0.97965,-7
1393,110000,1,2,1,43,1,2,2,2,2,2,100987,101941,98364,103189,99578,104412,4600,0,8500,0,7700,3900,1,96387,101941,89864,103189,91878,100512,0.8762454545454545,0.9267363636363637,0.8169454545454545,0.9380818181818181,0.8352545454545455,0.9137454545454545,11
1394,30000,0,1,2,38,1,2,0,0,0,2,24172,23497,24817,25602,26535,26947,0,1715,1500,1500,1000,4670,0,24172,21782,23317,24102,25535,22277,0.8057333333333333,0.7260666666666666,0.7772333333333333,0.8034,0.8511666666666666,0.7425666666666667,5
1395,90000,0,1,1,29,0,0,0,0,0,0,82410,85150,81812,76424,77086,77634,8000,3000,3100,3000,3000,2500,1,74410,82150,78712,73424,74086,75134,0.8267777777777777,0.9127777777777778,0.8745777777777778,0.8158222222222222,0.8231777777777778,0.8348222222222222,0
1396,370000,0,2,1,55,0,0,0,0,0,0,360546,369909,370605,366054,310869,311284,15901,13603,13500,11014,12024,16027,1,344645,356306,357105,355040,298845,295257,0.9314729729729729,0.9629891891891892,0.9651486486486487,0.9595675675675676,0.8076891891891892,0.7979918918918919,0
1397,210000,0,1,2,36,-1,-1,2,-1,-1,-1,931,2562,736,270,-466,1798,2570,0,270,0,3000,0,0,-1639,2562,466,270,-3466,1798,-0.007804761904761905,0.0122,0.002219047619047619,0.0012857142857142856,-0.016504761904761904,0.008561904761904762,-3
1398,170000,1,1,1,30,-2,-2,-2,-1,-1,-1,5280,5020,996,35490,6000,5350,5020,996,35490,6000,5350,12500,1,260,4024,-34494,29490,650,-7150,0.0015294117647058824,0.023670588235294117,-0.20290588235294119,0.17347058823529413,0.003823529411764706,-0.04205882352941177,-9
1399,150000,1,1,1,44,-1,-1,-1,0,0,-1,1365,0,839,693,0,3975,0,839,0,0,3975,0,1,1365,-839,839,693,-3975,3975,0.0091,-0.005593333333333333,0.005593333333333333,0.00462,-0.0265,0.0265,-4
1400,280000,0,1,2,34,0,0,0,0,0,0,212093,220586,214180,226277,216716,232367,18685,15038,23084,11001,20000,10000,0,193408,205548,191096,215276,196716,222367,0.6907428571428571,0.7341,0.6824857142857143,0.7688428571428572,0.7025571428571429,0.7941678571428571,0
1401,270000,0,2,1,49,-1,-1,0,0,0,0,3197,61164,61145,62186,62123,58995,61164,4000,5000,6000,5000,5000,1,-57967,57164,56145,56186,57123,53995,-0.2146925925925926,0.21171851851851853,0.20794444444444443,0.2080962962962963,0.21156666666666665,0.19998148148148148,-2
1402,50000,0,2,2,33,1,2,0,0,0,0,51210,47140,48478,48173,21134,20403,0,3518,3000,2352,2000,2000,0,51210,43622,45478,45821,19134,18403,1.0242,0.87244,0.90956,0.91642,0.38268,0.36806,3
1403,100000,1,2,1,27,-1,2,-1,2,0,0,667,667,6637,6300,12300,0,0,6637,0,6000,0,3022,1,667,-5970,6637,300,12300,-3022,0.00667,-0.0597,0.06637,0.003,0.123,-0.03022,2
1404,140000,1,1,2,31,1,-2,-2,-2,-2,-2,0,241,0,0,0,0,241,0,0,0,0,1419,0,-241,241,0,0,0,-1419,-0.0017214285714285715,0.0017214285714285715,0.0,0.0,0.0,-0.010135714285714286,-9
1405,230000,0,2,2,28,0,0,0,0,0,0,31875,31611,32411,34162,34884,35569,2000,2000,4000,2000,2000,1500,0,29875,29611,28411,32162,32884,34069,0.1298913043478261,0.12874347826086957,0.12352608695652174,0.13983478260869564,0.14297391304347826,0.14812608695652174,0
1406,230000,0,1,1,41,-2,-2,-2,-2,-2,-2,1552,792,19272,1172,1172,2246,792,19272,1172,1172,2246,1172,1,760,-18480,18100,0,-1074,1074,0.0033043478260869567,-0.08034782608695652,0.07869565217391304,0.0,-0.004669565217391304,0.004669565217391304,-12
1407,50000,1,2,2,48,-1,-1,0,0,0,0,879,8061,8290,7838,7998,8161,8061,1398,1000,160,163,9217,0,-7182,6663,7290,7678,7835,-1056,-0.14364,0.13326,0.1458,0.15356,0.1567,-0.02112,-2
1408,110000,0,3,1,51,-1,-1,-1,0,0,0,2132,1946,27162,26693,25243,23783,1946,27162,2000,812,799,933,1,186,-25216,25162,25881,24444,22850,0.001690909090909091,-0.22923636363636363,0.22874545454545456,0.23528181818181818,0.22221818181818181,0.20772727272727273,-3
1409,150000,1,2,1,49,1,-1,-1,-1,-1,-1,0,970,8867,0,600,0,970,8867,0,600,0,0,1,-970,-7897,8867,-600,600,0,-0.006466666666666667,-0.05264666666666667,0.05911333333333333,-0.004,0.004,0.0,-4
1410,50000,0,2,2,44,0,0,0,2,0,0,47674,45472,51447,49895,20317,19460,1764,6739,29,700,704,705,0,45910,38733,51418,49195,19613,18755,0.9182,0.77466,1.02836,0.9839,0.39226,0.3751,2
1411,390000,1,1,1,39,-2,-2,-2,-2,-2,-2,48417,15530,112316,114797,131601,130295,2000,97472,4000,20000,31667,6539,1,46417,-81942,108316,94797,99934,123756,0.11901794871794871,-0.2101076923076923,0.27773333333333333,0.24306923076923076,0.25624102564102563,0.31732307692307693,-12
1412,50000,1,2,2,31,1,-2,-2,-2,-2,-2,0,0,0,0,0,0,0,0,0,0,0,0,0,0,0,0,0,0,0,0.0,0.0,0.0,0.0,0.0,0.0,-9
1413,130000,0,1,2,27,-1,0,0,-2,-2,-2,2219,4141,0,0,0,0,2000,0,0,0,0,0,0,219,4141,0,0,0,0,0.0016846153846153847,0.031853846153846156,0.0,0.0,0.0,0.0,-7
1414,180000,1,1,2,26,2,2,0,0,0,0,182218,173980,262878,128739,130929,130437,0,5000,5000,4738,4915,4661,0,182218,168980,257878,124001,126014,125776,1.0123222222222221,0.9387777777777778,1.4326555555555556,0.6888944444444445,0.7000777777777778,0.6987555555555556,4
1415,60000,1,1,2,26,-2,-2,-2,-2,-2,-2,17873,5959,2933,2933,4933,1983,3000,1000,0,2000,0,13072,0,14873,4959,2933,933,4933,-11089,0.24788333333333334,0.08265,0.048883333333333334,0.01555,0.08221666666666666,-0.18481666666666666,-12
1416,500000,1,2,1,50,0,0,0,2,0,0,290301,296479,306661,306438,298068,293489,11000,15000,10000,10003,10000,11000,1,279301,281479,296661,296435,288068,282489,0.558602,0.562958,0.593322,0.59287,0.576136,0.564978,2
1417,20000,0,2,2,35,0,0,0,0,0,0,17042,17544,15292,16509,12261,14550,1500,1500,1506,452,2500,691,0,15542,16044,13786,16057,9761,13859,0.7771,0.8022,0.6893,0.80285,0.48805,0.69295,0
1418,10000,0,3,2,31,0,0,0,0,0,0,5062,5687,6132,5851,5735,6087,1259,1100,197,362,1000,1000,0,3803,4587,5935,5489,4735,5087,0.3803,0.4587,0.5935,0.5489,0.4735,0.5087,0
1419,20000,0,2,2,25,-1,-1,-1,-1,-1,0,390,390,390,390,390,780,390,390,390,390,390,0,0,0,0,0,0,0,780,0.0,0.0,0.0,0.0,0.0,0.039,-5
1420,500000,1,1,2,40,-2,-2,-2,-2,-2,-2,15929,18155,-131,10527,61751,2926,18222,0,10658,61751,2926,13609,0,-2293,18155,-10789,-51224,58825,-10683,-0.004586,0.03631,-0.021578,-0.102448,0.11765,-0.021366,-12
1421,350000,1,2,1,36,0,0,0,0,0,0,21026,35588,38002,40357,43663,52735,15000,3000,3000,4000,10000,25000,1,6026,32588,35002,36357,33663,27735,0.017217142857142858,0.09310857142857143,0.10000571428571428,0.10387714285714286,0.09618,0.07924285714285714,0
1422,120000,1,2,2,48,0,0,0,0,0,2,72528,74047,75564,77242,81826,83630,2680,2741,2933,6000,3300,0,0,69848,71306,72631,71242,78526,83630,0.5820666666666666,0.5942166666666666,0.6052583333333333,0.5936833333333333,0.6543833333333333,0.6969166666666666,2
1423,20000,1,1,3,22,2,0,0,0,0,0,14033,14993,16244,18300,18100,-1900,1500,1800,2800,0,0,1900,0,12533,13193,13444,18300,18100,-3800,0.62665,0.65965,0.6722,0.915,0.905,-0.19,2
1424,120000,1,2,1,34,0,-1,-1,-1,-1,-1,8505,4086,6389,4520,8708,1520,4086,6389,4520,8708,1520,1520,1,4419,-2303,1869,-4188,7188,0,0.036825,-0.019191666666666666,0.015575,-0.0349,0.0599,0.0,-5
1425,180000,0,2,2,27,0,0,0,0,0,0,147310,152047,143809,112323,112208,113887,7503,30018,4011,3802,4106,4006,0,139807,122029,139798,108521,108102,109881,0.7767055555555555,0.6779388888888889,0.7766555555555555,0.6028944444444444,0.6005666666666667,0.61045,0
1426,230000,1,2,1,46,-1,-1,-1,0,-1,-1,1443,1443,2886,1443,1443,1443,1443,2886,0,1443,1443,1443,1,0,-1443,2886,0,0,0,0.0,-0.006273913043478261,0.012547826086956522,0.0,0.0,0.0,-5
1427,280000,1,1,2,30,-1,-1,-1,-2,-2,-2,26679,52223,25088,9427,2829,198,52223,25100,9427,2838,198,4139,0,-25544,27123,15661,6589,2631,-3941,-0.09122857142857142,0.09686785714285714,0.055932142857142854,0.023532142857142856,0.009396428571428571,-0.014075,-9
1428,110000,1,2,2,40,0,0,0,0,0,0,96950,93571,86595,81077,77747,78913,3255,3056,2802,2813,4000,3500,0,93695,90515,83793,78264,73747,75413,0.8517727272727272,0.8228636363636364,0.7617545454545455,0.7114909090909091,0.6704272727272728,0.6855727272727272,0
1429,310000,1,1,2,30,0,0,0,0,0,0,304329,292848,279138,252703,248895,244026,14027,16800,11600,11000,10000,30000,0,290302,276048,267538,241703,238895,214026,0.936458064516129,0.8904774193548387,0.8630258064516129,0.7796870967741936,0.7706290322580646,0.6904064516129033,0
1430,110000,1,2,1,31,0,0,0,0,0,0,109814,110215,40084,41101,41834,42874,4665,1670,1977,2000,2000,2000,1,105149,108545,38107,39101,39834,40874,0.9559,0.9867727272727272,0.34642727272727275,0.35546363636363637,0.36212727272727274,0.3715818181818182,0
1431,360000,0,1,2,28,-1,-1,2,-1,-1,-1,2711,780,390,390,390,540,780,0,390,390,540,390,0,1931,780,0,0,-150,150,0.0053638888888888885,0.0021666666666666666,0.0,0.0,-0.0004166666666666667,0.0004166666666666667,-3
1432,50000,1,1,2,22,0,0,0,0,0,0,49086,48614,44211,27415,26630,8551,2047,1539,633,634,433,25586,0,47039,47075,43578,26781,26197,-17035,0.94078,0.9415,0.87156,0.53562,0.52394,-0.3407,0
1433,290000,0,2,2,42,0,0,0,0,0,0,76063,72418,65814,60861,60901,53023,4434,3814,2861,1901,2023,3719,0,71629,68604,62953,58960,58878,49304,0.24699655172413792,0.2365655172413793,0.21707931034482758,0.2033103448275862,0.20302758620689657,0.17001379310344827,0
1434,90000,1,4,2,31,1,-2,-2,-2,-2,-2,0,0,0,0,0,0,0,0,0,0,0,0,0,0,0,0,0,0,0,0.0,0.0,0.0,0.0,0.0,0.0,-9
1435,30000,0,3,1,44,-2,-2,-2,-2,-2,-2,2180,0,0,0,0,0,0,0,0,0,0,0,1,2180,0,0,0,0,0,0.07266666666666667,0.0,0.0,0.0,0.0,0.0,-12
1436,410000,1,1,1,46,-2,-2,-2,-2,-2,-2,0,0,0,0,0,0,0,0,0,0,0,0,1,0,0,0,0,0,0,0.0,0.0,0.0,0.0,0.0,0.0,-12
1437,200000,1,1,1,42,-2,-2,-2,-2,-2,-2,0,0,0,0,0,0,0,0,0,0,0,665,1,0,0,0,0,0,-665,0.0,0.0,0.0,0.0,0.0,-0.003325,-12
1438,500000,1,1,2,37,-2,-2,-2,-2,-2,-2,315,2579,3824,813,0,4443,2579,3824,813,0,4443,330,0,-2264,-1245,3011,813,-4443,4113,-0.004528,-0.00249,0.006022,0.001626,-0.008886,0.008226,-12
1439,360000,1,2,2,27,0,0,-1,-1,-1,-2,12389,-5,1145,1169,-1,-1,0,1150,1174,0,0,0,0,12389,-1155,-29,1169,-1,-1,0.03441388888888889,-0.0032083333333333334,-8.055555555555556e-05,0.003247222222222222,-2.777777777777778e-06,-2.777777777777778e-06,-5
1440,50000,1,2,1,30,-1,2,-1,-1,-1,-1,4959,423,3139,2464,6170,0,0,6024,5428,6170,0,0,1,4959,-5601,-2289,-3706,6170,0,0.09918,-0.11202,-0.04578,-0.07412,0.1234,0.0,-3
1441,30000,1,2,1,56,0,0,0,2,0,0,10232,11564,14099,13580,13657,16356,1510,3042,0,600,2942,600,1,8722,8522,14099,12980,10715,15756,0.29073333333333334,0.2840666666666667,0.46996666666666664,0.43266666666666664,0.3571666666666667,0.5252,2
1442,500000,1,2,1,43,0,0,0,-1,-1,-1,42081,46495,39489,12421,11345,11968,16495,15720,12421,11345,11968,11824,1,25586,30775,27068,1076,-623,144,0.051172,0.06155,0.054136,0.002152,-0.001246,0.000288,-3
1443,210000,0,2,2,32,0,0,0,0,0,0,137264,102545,94692,70484,36308,33201,3664,3900,2868,3000,2000,2000,0,133600,98645,91824,67484,34308,31201,0.6361904761904762,0.46973809523809523,0.43725714285714284,0.32135238095238094,0.16337142857142858,0.14857619047619047,0
1444,360000,1,2,1,45,0,0,-2,-2,-1,-1,12040,0,0,0,150,1728,0,0,0,150,1728,0,1,12040,0,0,-150,-1578,1728,0.03344444444444444,0.0,0.0,-0.0004166666666666667,-0.004383333333333334,0.0048,-6
1445,140000,1,2,1,34,0,0,0,0,0,0,47922,49930,51980,54606,55220,56527,2710,2760,3386,2000,2082,2000,1,45212,47170,48594,52606,53138,54527,0.32294285714285714,0.3369285714285714,0.3471,0.37575714285714285,0.37955714285714287,0.38947857142857145,0
1446,200000,0,2,1,37,0,0,0,0,0,0,4757,6170,7408,8250,9250,9750,1500,1500,1000,1000,500,1500,1,3257,4670,6408,7250,8750,8250,0.016285,0.02335,0.03204,0.03625,0.04375,0.04125,0
1447,90000,1,1,2,33,0,0,0,0,0,0,80919,87993,17316,18026,18559,19097,9000,1500,1000,824,1000,857,0,71919,86493,16316,17202,17559,18240,0.7991,0.9610333333333333,0.1812888888888889,0.19113333333333332,0.1951,0.20266666666666666,0
1448,240000,0,1,2,47,1,-2,-2,-2,-2,-2,0,0,0,0,0,0,0,0,0,0,0,0,0,0,0,0,0,0,0,0.0,0.0,0.0,0.0,0.0,0.0,-9
1449,140000,1,1,2,26,0,0,0,0,0,0,131863,136170,139270,137548,96340,94201,6500,6799,5100,3300,3400,7461,0,125363,129371,134170,134248,92940,86740,0.89545,0.9240785714285714,0.9583571428571429,0.9589142857142857,0.6638571428571428,0.6195714285714286,0
1450,70000,1,2,1,40,0,0,0,0,0,0,43045,44088,45102,45861,47951,49252,2036,2050,1809,3000,2251,1627,1,41009,42038,43293,42861,45700,47625,0.5858428571428571,0.6005428571428572,0.6184714285714286,0.6123,0.6528571428571428,0.6803571428571429,0
1451,70000,0,2,1,37,0,0,2,0,0,2,23546,26630,25922,27177,28930,28329,3800,0,2000,2200,0,2100,1,19746,26630,23922,24977,28930,26229,0.2820857142857143,0.38042857142857145,0.3417428571428571,0.3568142857142857,0.4132857142857143,0.3747,4
1452,200000,0,1,1,43,0,0,2,0,0,0,142291,152679,148682,146505,150963,146553,14200,0,7000,7000,6500,11000,1,128091,152679,141682,139505,144463,135553,0.640455,0.763395,0.70841,0.697525,0.722315,0.677765,2
1453,50000,1,2,2,28,0,0,0,0,0,0,48072,49518,49500,19600,20000,0,2518,1500,500,400,0,0,0,45554,48018,49000,19200,20000,0,0.91108,0.96036,0.98,0.384,0.4,0.0,0
1454,500000,1,1,2,31,1,-1,-1,-1,-1,0,29091,5763,15673,9393,69526,37940,5763,15691,9393,69526,5000,20000,0,23328,-9928,6280,-60133,64526,17940,0.046656,-0.019856,0.01256,-0.120266,0.129052,0.03588,-3
1455,100000,1,2,1,41,0,0,0,0,0,0,95326,97972,99147,74548,76284,77841,4825,4600,3000,2940,3000,3000,1,90501,93372,96147,71608,73284,74841,0.90501,0.93372,0.96147,0.71608,0.73284,0.74841,0
1456,350000,0,1,2,31,0,-1,-1,-2,-2,-2,51900,1000,0,0,0,0,1000,0,0,0,0,0,0,50900,1000,0,0,0,0,0.14542857142857143,0.002857142857142857,0.0,0.0,0.0,0.0,-8
1457,20000,1,2,2,23,0,0,2,0,0,0,15675,17462,16895,17470,7500,7500,4492,0,1000,150,0,0,0,11183,17462,15895,17320,7500,7500,0.55915,0.8731,0.79475,0.866,0.375,0.375,2
1458,80000,1,1,2,23,0,0,0,0,0,0,24215,30798,30350,32469,32663,34909,10000,2000,2500,2000,3000,1000,0,14215,28798,27850,30469,29663,33909,0.1776875,0.359975,0.348125,0.3808625,0.3707875,0.4238625,0
1459,260000,1,1,1,42,0,-1,-1,0,-1,-1,8606,3856,12996,8788,15104,16764,3856,13000,0,15104,16764,9118,1,4750,-9144,12996,-6316,-1660,7646,0.01826923076923077,-0.03516923076923077,0.049984615384615384,-0.024292307692307693,-0.006384615384615384,0.02940769230769231,-4
1460,190000,1,4,2,30,0,0,0,0,-1,0,198098,194576,202868,198936,28950,28666,4515,15466,4700,47450,16666,17549,0,193583,179110,198168,151486,12284,11117,1.018857894736842,0.9426842105263158,1.0429894736842105,0.7972947368421053,0.06465263157894736,0.05851052631578947,-1
1461,20000,0,1,2,30,2,2,2,2,0,0,16855,17272,19820,19104,19646,20527,1000,2832,0,658,1151,0,0,15855,14440,19820,18446,18495,20527,0.79275,0.722,0.991,0.9223,0.92475,1.02635,8
1462,450000,1,3,1,36,-2,-2,-2,-2,-2,-2,3996,9120,8528,0,6368,3000,9120,8528,0,6368,3000,3238,1,-5124,592,8528,-6368,3368,-238,-0.011386666666666666,0.0013155555555555555,0.01895111111111111,-0.01415111111111111,0.007484444444444445,-0.0005288888888888889,-12
1463,140000,1,2,1,39,0,0,0,0,0,0,105192,90337,74510,73876,76180,78400,3000,6000,4000,4000,4000,3000,1,102192,84337,70510,69876,72180,75400,0.7299428571428571,0.6024071428571428,0.5036428571428572,0.49911428571428573,0.5155714285714286,0.5385714285714286,0
1464,50000,1,3,2,49,0,0,2,0,0,0,46468,50669,48701,49066,30177,29274,5000,0,2500,1151,1156,1052,0,41468,50669,46201,47915,29021,28222,0.82936,1.01338,0.92402,0.9583,0.58042,0.56444,2
1465,390000,0,2,1,35,0,-1,-1,0,0,0,33808,15275,17331,78340,76892,57954,15347,17375,70077,15103,3290,16153,1,18461,-2100,-52746,63237,73602,41801,0.04733589743589744,-0.005384615384615384,-0.13524615384615385,0.16214615384615386,0.1887230769230769,0.10718205128205129,-2
1466,80000,1,2,2,22,0,0,0,0,0,0,18429,19500,14366,15369,14595,14363,2015,1500,1252,330,1829,207,0,16414,18000,13114,15039,12766,14156,0.205175,0.225,0.163925,0.1879875,0.159575,0.17695,0
1467,240000,1,2,1,34,-2,-2,-2,-2,-2,-2,0,0,0,0,0,0,0,0,0,0,0,0,1,0,0,0,0,0,0,0.0,0.0,0.0,0.0,0.0,0.0,-12
1468,80000,0,2,1,36,3,2,2,4,4,3,600,600,600,600,600,300,0,0,0,0,0,0,1,600,600,600,600,600,300,0.0075,0.0075,0.0075,0.0075,0.0075,0.00375,18
1469,300000,1,2,1,46,1,-2,-1,0,-1,-1,0,0,194,1375,13970,1672,0,194,1181,14039,1679,4156,1,0,-194,-987,-12664,12291,-2484,0.0,-0.0006466666666666667,-0.00329,-0.04221333333333333,0.04097,-0.00828,-4
1470,30000,0,1,2,47,2,0,0,0,2,2,25690,26719,27774,28809,30399,29760,1445,1500,1500,2200,0,1200,0,24245,25219,26274,26609,30399,28560,0.8081666666666667,0.8406333333333333,0.8758,0.8869666666666667,1.0133,0.952,6
1471,400000,1,2,2,43,-2,-2,-2,-2,-2,-2,15000,18400,15000,492,14926,7626,18400,15000,492,15000,7725,3000,0,-3400,3400,14508,-14508,7201,4626,-0.0085,0.0085,0.03627,-0.03627,0.0180025,0.011565,-12
1472,50000,1,1,2,23,0,0,0,0,0,0,22939,23966,24939,23962,24439,25044,1413,1386,1399,876,1000,959,0,21526,22580,23540,23086,23439,24085,0.43052,0.4516,0.4708,0.46172,0.46878,0.4817,0
1473,20000,0,2,2,24,2,2,2,2,2,2,16276,16715,18327,17735,19446,18988,1000,2200,0,2000,0,1200,0,15276,14515,18327,15735,19446,17788,0.7638,0.72575,0.91635,0.78675,0.9723,0.8894,12
1474,50000,1,3,2,47,0,0,0,0,2,0,17569,18592,19621,21748,21262,21682,1613,1642,2769,0,923,950,0,15956,16950,16852,21748,20339,20732,0.31912,0.339,0.33704,0.43496,0.40678,0.41464,2
1475,280000,1,1,2,35,0,0,0,0,0,0,211645,213513,106539,106361,108590,110915,6445,5245,3800,3881,4069,4035,0,205200,208268,102739,102480,104521,106880,0.7328571428571429,0.7438142857142858,0.366925,0.366,0.3732892857142857,0.38171428571428573,0
1476,220000,0,1,1,45,1,2,0,0,0,0,157122,153320,156996,158717,162122,165399,0,7600,5700,6000,6000,12300,1,157122,145720,151296,152717,156122,153099,0.7141909090909091,0.6623636363636364,0.6877090909090909,0.6941681818181819,0.7096454545454546,0.6959045454545455,3
1477,150000,1,3,1,40,-2,-2,-2,-2,-2,-2,0,0,0,0,0,4095,0,0,0,0,4095,0,1,0,0,0,0,-4095,4095,0.0,0.0,0.0,0.0,-0.0273,0.0273,-12
1478,190000,0,1,2,34,2,2,2,2,0,0,154258,166118,170001,165797,167654,178044,14500,8000,0,6100,13100,0,0,139758,158118,170001,159697,154554,178044,0.7355684210526315,0.8322,0.8947421052631579,0.8405105263157895,0.8134421052631579,0.9370736842105263,8
1479,100000,1,2,1,35,0,0,0,0,0,0,106229,98217,42482,43326,44235,45498,3000,1707,1551,1607,2000,2000,1,103229,96510,40931,41719,42235,43498,1.03229,0.9651,0.40931,0.41719,0.42235,0.43498,0
1480,290000,0,1,1,57,1,-2,-2,-2,-2,-2,0,0,0,0,0,0,0,0,0,0,0,0,1,0,0,0,0,0,0,0.0,0.0,0.0,0.0,0.0,0.0,-9
1481,80000,0,3,1,45,0,0,0,0,0,0,26637,26437,26686,28372,28345,27279,1490,2000,2000,3000,5000,865,1,25147,24437,24686,25372,23345,26414,0.3143375,0.3054625,0.308575,0.31715,0.2918125,0.330175,0
1482,200000,0,1,2,28,-1,2,-1,-1,-2,-2,4420,460,99165,0,0,0,0,99165,0,0,0,3090,0,4420,-98705,99165,0,0,-3090,0.0221,-0.493525,0.495825,0.0,0.0,-0.01545,-5
1483,30000,1,2,1,44,2,0,0,0,0,0,21003,22309,23343,24336,24475,24643,1662,1696,1689,1016,893,1100,1,19341,20613,21654,23320,23582,23543,0.6447,0.6871,0.7218,0.7773333333333333,0.7860666666666667,0.7847666666666666,2
1484,240000,0,1,2,28,0,0,0,0,0,0,227346,231891,240146,245552,91382,93177,8308,12000,10373,3403,4000,4000,0,219038,219891,229773,242149,87382,89177,0.9126583333333333,0.9162125,0.9573875,1.0089541666666666,0.36409166666666665,0.37157083333333335,0
1485,10000,0,2,2,22,-1,5,4,3,2,5,10160,9860,9565,9265,11951,12189,0,0,0,3000,1000,0,0,10160,9860,9565,6265,10951,12189,1.016,0.986,0.9565,0.6265,1.0951,1.2189,18
1486,100000,1,1,2,38,2,2,2,2,2,2,37566,37160,39750,40298,40835,41529,500,3500,1500,1500,1500,2000,0,37066,33660,38250,38798,39335,39529,0.37066,0.3366,0.3825,0.38798,0.39335,0.39529,12
1487,120000,1,2,1,34,-1,-1,-1,-1,0,0,326,499,1870,652,326,0,499,1870,652,0,0,1705,1,-173,-1371,1218,652,326,-1705,-0.0014416666666666666,-0.011425,0.01015,0.005433333333333333,0.0027166666666666667,-0.014208333333333333,-4
1488,50000,1,2,2,23,0,0,0,0,-1,2,16139,17261,14354,8713,1781,1615,1400,1000,500,1781,0,0,0,14739,16261,13854,6932,1781,1615,0.29478,0.32522,0.27708,0.13864,0.03562,0.0323,1
1489,460000,1,2,1,39,-1,-1,-1,-1,-1,-1,11403,14015,2978,11402,12072,7090,14029,2978,11402,12802,7090,793,1,-2626,11037,-8424,-1400,4982,6297,-0.005708695652173913,0.023993478260869564,-0.01831304347826087,-0.003043478260869565,0.010830434782608696,0.013689130434782608,-6
1490,200000,1,1,2,27,-1,-1,-1,2,2,2,10603,0,2500,2500,2500,2500,0,2500,0,0,0,0,0,10603,-2500,2500,2500,2500,2500,0.053015,-0.0125,0.0125,0.0125,0.0125,0.0125,3
1491,100000,1,2,1,35,2,0,0,2,2,0,98845,95265,98571,99322,96661,95951,4600,8002,4003,2,4005,4000,1,94245,87263,94568,99320,92656,91951,0.94245,0.87263,0.94568,0.9932,0.92656,0.91951,6
1492,330000,1,1,1,41,1,-2,-2,-2,-2,-2,0,0,0,0,0,0,0,0,0,0,0,0,1,0,0,0,0,0,0,0.0,0.0,0.0,0.0,0.0,0.0,-9
1493,130000,1,1,1,37,2,2,2,2,2,2,41795,43914,44396,45365,46093,47185,3100,1500,2000,1600,2000,2000,1,38695,42414,42396,43765,44093,45185,0.29765384615384616,0.32626153846153844,0.3261230769230769,0.33665384615384614,0.3391769230769231,0.34757692307692306,12
1494,200000,1,1,2,37,0,0,0,0,0,0,75360,57589,54711,44396,25948,14505,2050,15000,6003,845,290,12715,0,73310,42589,48708,43551,25658,1790,0.36655,0.212945,0.24354,0.217755,0.12829,0.00895,0
1495,20000,0,1,2,26,1,2,0,0,0,0,15397,10403,7207,7351,7512,8380,0,1500,264,280,1000,813,0,15397,8903,6943,7071,6512,7567,0.76985,0.44515,0.34715,0.35355,0.3256,0.37835,3
1496,30000,0,2,2,26,1,4,3,2,2,4,24386,23744,23090,22436,26886,30858,0,0,0,5000,5000,0,0,24386,23744,23090,17436,21886,30858,0.8128666666666666,0.7914666666666667,0.7696666666666667,0.5812,0.7295333333333334,1.0286,16
1497,170000,0,3,2,44,0,0,0,0,0,0,167077,170965,172541,159546,137410,136680,12275,10000,8009,6000,30000,5322,0,154802,160965,164532,153546,107410,131358,0.9106,0.9468529411764706,0.967835294117647,0.9032117647058824,0.6318235294117647,0.7726941176470589,0
1498,170000,1,2,2,26,0,0,0,0,0,0,141476,143850,134502,122186,122506,117121,5113,4514,4376,4432,4142,3455,0,136363,139336,130126,117754,118364,113666,0.8021352941176471,0.8196235294117648,0.7654470588235294,0.6926705882352941,0.6962588235294118,0.6686235294117647,0
1499,360000,0,2,2,33,-1,-1,-1,0,-1,-1,9582,2119,10549,4409,2567,6234,2139,10580,110,2578,6265,0,0,7443,-8461,10439,1831,-3698,6234,0.020675,-0.02350277777777778,0.028997222222222223,0.005086111111111111,-0.010272222222222223,0.017316666666666668,-5
1500,280000,0,1,2,28,0,0,0,0,0,0,139719,136052,118076,101457,81124,42347,6000,4000,4000,4000,3000,1000,0,133719,132052,114076,97457,78124,41347,0.47756785714285716,0.4716142857142857,0.40741428571428573,0.3480607142857143,0.2790142857142857,0.14766785714285716,0
1501,50000,1,1,2,27,0,0,0,0,0,0,44402,44977,46546,46033,48656,41674,2000,3000,2400,3023,5000,0,0,42402,41977,44146,43010,43656,41674,0.84804,0.83954,0.88292,0.8602,0.87312,0.83348,0
1502,130000,1,2,1,33,-1,-1,-1,0,0,-2,41573,0,13853,14277,0,0,0,13853,1000,0,0,0,1,41573,-13853,12853,14277,0,0,0.3197923076923077,-0.10656153846153846,0.09886923076923076,0.10982307692307693,0.0,0.0,-5
1503,50000,0,1,2,27,-1,0,0,0,-1,-1,33567,0,28971,30437,14106,794,2034,0,2500,1024,397,21885,0,31533,0,26471,29413,13709,-21091,0.63066,0.0,0.52942,0.58826,0.27418,-0.42182,-3
1504,290000,0,2,1,30,0,0,0,0,0,0,351890,254163,250180,236027,221443,198031,11000,8607,8000,8525,8476,10000,1,340890,245556,242180,227502,212967,188031,1.1754827586206897,0.846744827586207,0.835103448275862,0.7844896551724138,0.7343689655172414,0.6483827586206896,0
1505,150000,0,3,2,27,-1,-1,2,0,0,0,57386,58531,56544,48153,49288,36872,5000,422,2000,2041,2039,751,0,52386,58109,54544,46112,47249,36121,0.34924,0.3873933333333333,0.36362666666666665,0.3074133333333333,0.31499333333333335,0.24080666666666667,0
1506,200000,0,2,1,48,0,0,-2,-2,-2,-2,205150,0,0,0,0,0,0,0,0,0,0,0,1,205150,0,0,0,0,0,1.02575,0.0,0.0,0.0,0.0,0.0,-8
1507,200000,1,2,1,69,0,0,0,0,0,0,106878,100879,102998,105090,107718,88964,4000,3800,3802,4363,3500,3303,1,102878,97079,99196,100727,104218,85661,0.51439,0.485395,0.49598,0.503635,0.52109,0.428305,0
1508,260000,1,2,2,33,-1,-1,-1,-1,-1,0,5188,12357,28656,7497,7685,15434,13000,29022,7500,27769,12000,6200,0,-7812,-16665,21156,-20272,-4315,9234,-0.030046153846153847,-0.06409615384615384,0.08136923076923076,-0.07796923076923076,-0.016596153846153847,0.035515384615384615,-5
1509,50000,0,3,2,41,0,0,2,0,0,0,22358,23257,23192,24073,21759,21959,1900,1000,1500,891,1000,700,0,20458,22257,21692,23182,20759,21259,0.40916,0.44514,0.43384,0.46364,0.41518,0.42518,2
1510,160000,1,2,1,31,-2,-2,-2,-2,-2,-2,11648,780,0,5100,0,0,780,0,5100,0,0,0,1,10868,780,-5100,5100,0,0,0.067925,0.004875,-0.031875,0.031875,0.0,0.0,-12
1511,120000,1,2,2,27,2,2,2,2,0,0,113354,115503,121861,117485,118381,115604,6200,10900,0,5000,4800,4505,0,107154,104603,121861,112485,113581,111099,0.89295,0.8716916666666666,1.0155083333333332,0.937375,0.9465083333333333,0.925825,8
1512,210000,1,1,2,30,0,0,0,0,0,0,7264,8816,10749,5125,5732,9297,2000,2500,2000,1000,4000,4000,0,5264,6316,8749,4125,1732,5297,0.025066666666666668,0.030076190476190475,0.04166190476190476,0.019642857142857142,0.008247619047619047,0.025223809523809523,0
1513,360000,0,1,1,50,-1,-1,-2,-1,-1,-2,1858,0,0,3000,0,0,0,0,3000,0,0,1033,1,1858,0,-3000,3000,0,-1033,0.005161111111111111,0.0,-0.008333333333333333,0.008333333333333333,0.0,-0.0028694444444444444,-8
1514,30000,1,2,1,33,0,0,0,0,0,0,12051,13101,14413,14476,14792,15145,1250,1537,600,550,600,800,1,10801,11564,13813,13926,14192,14345,0.3600333333333333,0.3854666666666667,0.4604333333333333,0.4642,0.4730666666666667,0.4781666666666667,0
1515,180000,0,1,1,41,1,2,2,2,2,0,114952,117567,119314,120882,117450,120398,6000,5100,5000,0,5000,5000,1,108952,112467,114314,120882,112450,115398,0.6052888888888889,0.6248166666666667,0.6350777777777777,0.6715666666666666,0.6247222222222222,0.6411,9
1516,70000,1,2,2,23,-1,-1,-1,-1,0,0,312,1823,326,6598,6405,7248,1837,326,6598,227,1270,1296,0,-1525,1497,-6272,6371,5135,5952,-0.021785714285714287,0.021385714285714286,-0.0896,0.09101428571428571,0.07335714285714286,0.08502857142857143,-4
1517,290000,1,1,2,34,-1,-1,-1,-1,0,-1,1915,6136,0,28642,4098,19024,6151,0,28642,0,19426,0,0,-4236,6136,-28642,28642,-15328,19024,-0.014606896551724138,0.021158620689655173,-0.09876551724137932,0.09876551724137932,-0.0528551724137931,0.0656,-5
1518,60000,0,3,2,29,0,0,0,0,0,0,4511,5529,6544,7093,7973,9038,1096,1111,660,1000,1200,0,0,3415,4418,5884,6093,6773,9038,0.056916666666666664,0.07363333333333333,0.09806666666666666,0.10155,0.11288333333333334,0.15063333333333334,0
1519,500000,0,2,2,33,0,0,0,0,0,0,3311,4254,2234,5404,2375,10078,4019,2019,5025,2011,10046,3017,0,-708,2235,-2791,3393,-7671,7061,-0.001416,0.00447,-0.005582,0.006786,-0.015342,0.014122,0
1520,240000,1,2,1,44,-1,-1,-1,-1,-1,-1,3313,7458,2329,4267,2404,4243,7458,2335,4267,2404,4243,2952,1,-4145,5123,-1938,1863,-1839,1291,-0.017270833333333332,0.021345833333333335,-0.008075,0.0077625,-0.0076625,0.005379166666666667,-6
1521,470000,1,3,1,42,0,0,0,0,0,0,219081,285141,408974,361703,318251,310982,70000,140000,13000,11000,20000,8000,1,149081,145141,395974,350703,298251,302982,0.3171936170212766,0.30881063829787236,0.8424978723404255,0.7461765957446809,0.6345765957446808,0.6446425531914893,0
1522,290000,1,2,1,50,0,0,0,0,0,0,272799,261286,246740,224260,233251,226100,10109,10126,7095,30227,40213,40211,1,262690,251160,239645,194033,193038,185889,0.9058275862068965,0.8660689655172413,0.8263620689655172,0.6690793103448276,0.665648275862069,0.6409965517241379,0
1523,100000,1,3,2,46,0,0,0,0,0,0,94657,81175,63464,45910,46996,42935,3000,2009,3000,2000,2000,1701,0,91657,79166,60464,43910,44996,41234,0.91657,0.79166,0.60464,0.4391,0.44996,0.41234,0
1524,50000,0,2,2,25,2,2,3,3,3,3,1050,1050,1050,1050,1050,1050,0,0,0,0,0,0,0,1050,1050,1050,1050,1050,1050,0.021,0.021,0.021,0.021,0.021,0.021,16
1525,50000,1,1,2,23,0,0,0,0,-1,0,48482,47226,11151,-2897,48211,48154,2500,3002,1500,52000,1900,1800,0,45982,44224,9651,-54897,46311,46354,0.91964,0.88448,0.19302,-1.09794,0.92622,0.92708,-1
1526,230000,1,1,2,42,-2,-2,-2,-2,-2,-2,107,529,135,108,830,2536,529,135,108,830,2536,0,0,-422,394,27,-722,-1706,2536,-0.0018347826086956521,0.0017130434782608695,0.00011739130434782609,-0.0031391304347826087,-0.007417391304347826,0.01102608695652174,-12
1527,360000,0,1,1,41,-2,-2,-2,-2,-2,-2,2988,0,668,0,686,7149,0,668,0,686,7149,150,1,2988,-668,668,-686,-6463,6999,0.0083,-0.0018555555555555556,0.0018555555555555556,-0.0019055555555555555,-0.01795277777777778,0.019441666666666666,-12
1528,30000,1,3,1,46,0,0,0,0,0,2,9847,10857,11877,12891,13960,14082,1181,1201,1215,1284,490,0,1,8666,9656,10662,11607,13470,14082,0.28886666666666666,0.3218666666666667,0.3554,0.3869,0.449,0.4694,2
1529,230000,1,2,2,33,1,-1,-1,-1,-1,-1,-133,611,19640,13242,1782,3106,744,19640,13242,1782,3106,0,0,-877,-19029,6398,11460,-1324,3106,-0.0038130434782608696,-0.08273478260869566,0.027817391304347825,0.04982608695652174,-0.0057565217391304345,0.013504347826086956,-4
1530,200000,1,1,2,41,-1,-1,-1,-1,-1,-1,504,2502,21699,2914,3392,4343,2502,21699,3003,3392,4343,326,0,-1998,-19197,18696,-478,-951,4017,-0.00999,-0.095985,0.09348,-0.00239,-0.004755,0.020085,-6
1531,300000,1,2,2,24,0,0,0,-1,-1,-1,26158,25673,14290,7490,2962,0,5673,7000,7490,2962,0,0,0,20485,18673,6800,4528,2962,0,0.06828333333333333,0.06224333333333333,0.02266666666666667,0.015093333333333334,0.009873333333333333,0.0,-3
1532,240000,0,2,1,44,0,-1,-1,-2,-1,0,8421,14201,-28,-401,5109,7001,14230,0,0,7000,2000,3919,1,-5809,14201,-28,-7401,3109,3082,-0.024204166666666665,0.05917083333333333,-0.00011666666666666667,-0.0308375,0.012954166666666666,0.012841666666666666,-5
1533,420000,0,1,2,31,-2,-2,-2,-2,-2,-2,7712,72910,18030,11831,11562,46623,35527,18442,11943,11620,46856,21802,0,-27815,54468,6087,211,-35294,24821,-0.06622619047619048,0.1296857142857143,0.014492857142857142,0.0005023809523809524,-0.08403333333333333,0.059097619047619045,-12
1534,50000,0,2,2,24,0,0,0,0,0,0,18684,19690,21021,22067,22896,23873,1323,1654,1700,1500,1500,1000,0,17361,18036,19321,20567,21396,22873,0.34722,0.36072,0.38642,0.41134,0.42792,0.45746,0
1535,270000,0,1,1,37,-1,-1,-1,0,-1,-1,396,396,792,396,396,396,396,792,0,396,396,396,1,0,-396,792,0,0,0,0.0,-0.0014666666666666667,0.0029333333333333334,0.0,0.0,0.0,-5
1536,30000,0,2,2,26,1,-1,-1,2,0,0,-185,27478,30642,29361,29022,28409,28924,4000,0,1000,900,800,0,-29109,23478,30642,28361,28122,27609,-0.9703,0.7826,1.0214,0.9453666666666667,0.9374,0.9203,1
1537,120000,0,2,2,32,1,2,2,2,2,2,60316,61763,63154,64524,66345,68104,3000,3000,3000,3000,3000,0,0,57316,58763,60154,61524,63345,68104,0.47763333333333335,0.4896916666666667,0.5012833333333333,0.5127,0.527875,0.5675333333333333,11
1538,270000,1,3,1,30,-1,-1,-2,-2,-1,-1,3842,3934,0,0,3353,764,3934,0,0,3353,764,35532,1,-92,3934,0,-3353,2589,-34768,-0.00034074074074074074,0.01457037037037037,0.0,-0.012418518518518518,0.009588888888888888,-0.12877037037037037,-8
1539,200000,0,2,1,39,-1,-1,2,-1,0,0,162,1879,1707,617,620,0,1879,8,617,3,0,0,1,-1717,1871,1090,614,620,0,-0.008585,0.009355,0.00545,0.00307,0.0031,0.0,-1
1540,440000,1,3,1,49,0,0,0,0,0,0,386288,367400,347445,354373,307773,293357,14453,12611,13022,10572,10270,10722,1,371835,354789,334423,343801,297503,282635,0.8450795454545454,0.8063386363636363,0.7600522727272727,0.7813659090909091,0.6761431818181818,0.6423522727272727,0
1541,120000,1,2,1,30,1,-2,-2,-2,-2,-2,0,0,0,0,0,0,0,0,0,0,0,0,1,0,0,0,0,0,0,0.0,0.0,0.0,0.0,0.0,0.0,-9
1542,360000,0,1,2,30,0,0,0,0,0,0,36590,29751,22581,12936,7970,7970,1400,1000,1000,3000,0,0,0,35190,28751,21581,9936,7970,7970,0.09775,0.07986388888888889,0.05994722222222222,0.0276,0.02213888888888889,0.02213888888888889,0
1543,120000,1,2,2,36,0,0,0,0,0,2,3225,4592,5975,5409,5940,1770,3232,4615,4170,1770,0,7978,0,-7,-23,1805,3639,5940,-6208,-5.833333333333333e-05,-0.00019166666666666667,0.015041666666666667,0.030325,0.0495,-0.05173333333333333,2
1544,120000,1,2,1,31,1,2,2,2,0,0,21134,20502,24832,24135,28723,31258,0,5000,0,5000,3000,0,1,21134,15502,24832,19135,25723,31258,0.17611666666666667,0.12918333333333334,0.20693333333333333,0.15945833333333334,0.21435833333333335,0.26048333333333334,7
1545,110000,0,2,2,24,0,0,0,0,0,0,91915,92168,90705,40086,41449,42260,3800,3818,1426,2000,2000,3261,0,88115,88350,89279,38086,39449,38999,0.8010454545454545,0.8031818181818182,0.8116272727272728,0.3462363636363636,0.35862727272727274,0.35453636363636365,0
1546,10000,0,3,2,22,1,-1,0,0,0,0,0,7492,8589,9365,7740,1000,7492,1224,1000,175,0,0,0,-7492,6268,7589,9190,7740,1000,-0.7492,0.6268,0.7589,0.919,0.774,0.1,0
1547,100000,0,2,1,46,2,-1,-1,-1,-1,-1,390,390,370,-20,780,0,390,370,0,800,0,0,1,0,20,370,-820,780,0,0.0,0.0002,0.0037,-0.0082,0.0078,0.0,-3
1548,190000,0,1,2,30,-1,-1,-1,-1,-1,-1,25953,1590,478,10035,24345,1150,1698,478,10035,24345,1191,14512,0,24255,1112,-9557,-14310,23154,-13362,0.1276578947368421,0.005852631578947369,-0.0503,-0.07531578947368421,0.12186315789473684,-0.07032631578947368,-6
1549,370000,1,1,2,34,0,0,0,0,0,0,206161,203907,178625,164483,157497,141493,10000,7014,6000,6000,6000,4000,0,196161,196893,172625,158483,151497,137493,0.5301648648648649,0.5321432432432432,0.46655405405405403,0.4283324324324324,0.40945135135135136,0.3716027027027027,0
1550,460000,1,1,2,34,-1,-1,-1,-1,-1,-1,14460,8869,21494,12657,5739,10184,8869,23664,12659,5752,10192,7419,0,5591,-14795,8835,6905,-4453,2765,0.012154347826086957,-0.03216304347826087,0.019206521739130435,0.015010869565217392,-0.009680434782608697,0.006010869565217391,-6
1551,570000,0,1,2,29,-1,-1,-1,-1,-1,-1,4119,-1031,5100,5150,5150,5138,0,11500,5200,5150,5138,81438,0,4119,-12531,-100,0,12,-76300,0.007226315789473684,-0.02198421052631579,-0.00017543859649122806,0.0,2.105263157894737e-05,-0.133859649122807,-6
1552,290000,1,1,1,34,-1,-1,-1,-1,-1,-1,3412,1573,11859,2483,1170,20328,1573,11886,2485,1170,20328,375,1,1839,-10313,9374,1313,-19158,19953,0.006341379310344827,-0.035562068965517245,0.03232413793103448,0.004527586206896552,-0.06606206896551724,0.06880344827586207,-6
1553,30000,1,2,1,31,0,0,0,0,0,0,16207,16735,18253,19646,21238,23843,4000,5000,5000,5000,5000,5006,1,12207,11735,13253,14646,16238,18837,0.4069,0.39116666666666666,0.44176666666666664,0.4882,0.5412666666666667,0.6279,0
1554,270000,1,4,2,29,1,-1,-1,-1,-2,-1,-9,3265,6125,0,0,29961,3274,6129,0,0,29961,6216,0,-3283,-2864,6125,0,-29961,23745,-0.012159259259259259,-0.010607407407407407,0.022685185185185187,0.0,-0.11096666666666667,0.08794444444444445,-5
1555,30000,1,2,1,59,0,0,0,0,0,0,27620,27921,28585,29007,29195,21335,1449,1503,1315,893,1000,513,1,26171,26418,27270,28114,28195,20822,0.8723666666666666,0.8806,0.909,0.9371333333333334,0.9398333333333333,0.6940666666666667,0
1556,190000,1,4,2,39,0,0,0,0,0,0,109023,99265,78430,77653,78395,70849,4000,3507,3003,3003,3510,3500,0,105023,95758,75427,74650,74885,67349,0.5527526315789474,0.5039894736842105,0.3969842105263158,0.39289473684210524,0.39413157894736844,0.3544684210526316,0
1557,190000,0,1,2,30,0,0,0,0,0,0,138429,141192,144484,148760,48776,49853,4555,5058,6489,1602,1716,2286,0,133874,136134,137995,147158,47060,47567,0.7046,0.7164947368421053,0.7262894736842105,0.7745157894736842,0.24768421052631578,0.2503526315789474,0
1558,30000,0,1,2,26,1,2,2,0,0,0,24599,23397,22721,22403,21972,22512,1700,0,1700,900,1000,900,0,22899,23397,21021,21503,20972,21612,0.7633,0.7799,0.7007,0.7167666666666667,0.6990666666666666,0.7204,5
1559,10000,0,3,1,57,0,0,0,2,2,0,7525,6952,9356,9533,9233,9295,1276,2680,477,0,360,1000,1,6249,4272,8879,9533,8873,8295,0.6249,0.4272,0.8879,0.9533,0.8873,0.8295,4
1560,80000,1,2,2,23,0,0,0,0,0,0,50456,30342,27591,28166,28330,28524,1432,1476,1441,995,1021,1138,0,49024,28866,26150,27171,27309,27386,0.6128,0.360825,0.326875,0.3396375,0.3413625,0.342325,0
1561,50000,1,1,2,37,0,0,0,-1,0,0,43886,50411,9688,857,3810,4741,2500,7026,1000,3000,1000,1000,0,41386,43385,8688,-2143,2810,3741,0.82772,0.8677,0.17376,-0.04286,0.0562,0.07482,-1
1562,180000,1,3,2,34,1,-2,-2,-2,-1,-1,3700,4696,3763,-3,3667,1598,4696,3763,3,3670,1799,0,0,-996,933,3760,-3673,1868,1598,-0.005533333333333334,0.005183333333333333,0.020888888888888887,-0.020405555555555555,0.010377777777777777,0.008877777777777778,-7
1563,140000,0,1,2,27,0,0,0,0,0,0,130905,122390,122024,112367,67820,66595,6067,6723,4069,5000,3200,3000,0,124838,115667,117955,107367,64620,63595,0.8917,0.8261928571428572,0.8425357142857143,0.7669071428571429,0.4615714285714286,0.45425,0
1564,70000,1,2,1,29,-1,0,0,0,0,0,71232,71262,71509,70695,71189,70554,2751,3600,2694,2800,2743,2700,1,68481,67662,68815,67895,68446,67854,0.9783,0.9666,0.9830714285714286,0.9699285714285715,0.9778,0.9693428571428572,-1
1565,150000,0,3,2,32,1,-1,0,0,0,0,3706,40093,65063,69046,60619,61096,40093,30000,10000,10030,5000,5000,0,-36387,10093,55063,59016,55619,56096,-0.24258,0.06728666666666666,0.36708666666666667,0.39344,0.3707933333333333,0.3739733333333333,0
1566,80000,0,1,2,27,-1,-1,-1,-2,-2,-2,1300,179,0,0,0,0,179,0,0,0,0,0,0,1121,179,0,0,0,0,0.0140125,0.0022375,0.0,0.0,0.0,0.0,-9
1567,250000,1,1,2,42,-1,-1,-1,-1,-1,0,4673,16014,4063,5589,15895,9948,17381,4063,6018,15895,1000,5928,0,-12708,11951,-1955,-10306,14895,4020,-0.050832,0.047804,-0.00782,-0.041224,0.05958,0.01608,-5
1568,20000,0,2,2,36,0,0,0,0,-2,-2,20528,16287,7415,0,0,0,1300,1000,0,0,0,1180,0,19228,15287,7415,0,0,-1180,0.9614,0.76435,0.37075,0.0,0.0,-0.059,-4
1569,70000,1,2,1,41,2,2,2,2,2,2,50241,51145,50022,53390,54579,55722,2000,0,4200,2200,2200,2200,1,48241,51145,45822,51190,52379,53522,0.6891571428571429,0.7306428571428571,0.6546,0.7312857142857143,0.7482714285714286,0.7646,12
1570,20000,1,3,1,56,0,0,0,0,0,0,12685,13634,12115,12356,12623,13905,1188,1201,442,466,1500,421,1,11497,12433,11673,11890,11123,13484,0.57485,0.62165,0.58365,0.5945,0.55615,0.6742,0
1571,160000,1,2,1,43,-1,-1,-1,-1,-1,-1,5617,267,509,15695,515,515,267,509,15695,515,515,515,1,5350,-242,-15186,15180,0,0,0.0334375,-0.0015125,-0.0949125,0.094875,0.0,0.0,-6
1572,230000,1,1,2,36,1,-2,-2,-2,-2,-2,0,0,0,0,0,0,0,0,0,0,0,0,0,0,0,0,0,0,0,0.0,0.0,0.0,0.0,0.0,0.0,-9
1573,20000,0,2,2,24,2,2,4,4,4,4,1650,1650,1650,1650,1650,1650,0,0,0,0,0,0,0,1650,1650,1650,1650,1650,1650,0.0825,0.0825,0.0825,0.0825,0.0825,0.0825,20
1574,360000,1,1,2,33,-1,-1,-1,0,0,-1,1616,3700,6562,3730,420,699,3700,6562,0,0,699,6041,0,-2084,-2862,6562,3730,-279,-5342,-0.0057888888888888886,-0.00795,0.018227777777777777,0.010361111111111111,-0.000775,-0.01483888888888889,-4
1575,30000,1,2,1,47,0,0,0,0,0,0,29187,29254,30206,58287,29522,30103,1505,1457,1016,1207,1600,1000,1,27682,27797,29190,57080,27922,29103,0.9227333333333333,0.9265666666666666,0.973,1.9026666666666667,0.9307333333333333,0.9701,0
1576,170000,0,2,1,40,-1,-1,-1,-1,-1,-1,4599,3409,3790,2578,2100,2400,3409,6530,2578,2100,2400,6665,1,1190,-3121,1212,478,-300,-4265,0.007,-0.018358823529411764,0.007129411764705882,0.002811764705882353,-0.0017647058823529412,-0.025088235294117647,-6
1577,30000,1,1,2,25,0,0,3,2,2,2,24709,28970,28233,27481,29484,30157,5000,0,0,2471,1300,4800,0,19709,28970,28233,25010,28184,25357,0.6569666666666667,0.9656666666666667,0.9411,0.8336666666666667,0.9394666666666667,0.8452333333333333,9
1578,30000,0,3,1,44,4,3,2,2,-2,-2,7221,6962,6700,0,0,0,0,0,0,0,0,0,1,7221,6962,6700,0,0,0,0.2407,0.23206666666666667,0.22333333333333333,0.0,0.0,0.0,7
1579,50000,0,2,2,23,1,2,2,2,0,0,10131,10833,20583,19996,19879,18065,1000,10000,400,700,800,600,0,9131,833,20183,19296,19079,17465,0.18262,0.01666,0.40366,0.38592,0.38158,0.3493,7
1580,110000,1,2,2,32,0,0,2,2,2,2,65299,74565,78516,79829,81603,83206,11000,5800,3200,3200,3100,3000,0,54299,68765,75316,76629,78503,80206,0.49362727272727275,0.6251363636363636,0.6846909090909091,0.6966272727272728,0.7136636363636364,0.7291454545454545,8
1581,80000,1,2,2,25,0,0,0,0,0,0,62242,28610,29425,29990,29153,19863,19885,1700,1169,1044,717,1000,0,42357,26910,28256,28946,28436,18863,0.5294625,0.336375,0.3532,0.361825,0.35545,0.2357875,0
1582,270000,1,1,1,45,-2,-2,-2,-2,-2,-2,0,0,0,0,0,0,0,0,0,0,0,0,1,0,0,0,0,0,0,0.0,0.0,0.0,0.0,0.0,0.0,-12
1583,130000,0,3,3,40,2,0,0,0,0,0,88222,88288,84822,85970,86644,87576,3515,3107,5003,3203,3456,4000,0,84707,85181,79819,82767,83188,83576,0.6515923076923077,0.6552384615384615,0.6139923076923077,0.6366692307692308,0.6399076923076923,0.6428923076923077,2
1584,220000,0,2,2,29,0,0,0,0,0,0,122286,122839,123035,114385,115903,118528,5008,5007,6007,5000,4700,5503,0,117278,117832,117028,109385,111203,113025,0.5330818181818182,0.5356,0.5319454545454545,0.49720454545454545,0.5054681818181819,0.51375,0
1585,50000,0,1,2,29,-1,0,0,2,0,0,20258,22932,22265,23896,26514,28073,3000,0,2000,3000,2000,1500,0,17258,22932,20265,20896,24514,26573,0.34516,0.45864,0.4053,0.41792,0.49028,0.53146,1
1586,180000,1,2,2,30,0,0,0,0,0,0,63182,64274,55112,56394,57577,58564,2166,2002,2200,2242,2100,2330,0,61016,62272,52912,54152,55477,56234,0.33897777777777777,0.34595555555555557,0.2939555555555556,0.30084444444444447,0.30820555555555557,0.3124111111111111,0
1587,200000,1,2,1,29,1,-2,-1,-1,-1,-1,0,0,900,900,900,900,0,900,900,900,900,900,1,0,-900,0,0,0,0,0.0,-0.0045,0.0,0.0,0.0,0.0,-5
1588,200000,0,3,2,26,-1,-1,-1,-1,-1,-1,8355,8355,8355,8355,8355,8355,8355,8355,8355,8355,8355,8285,0,0,0,0,0,0,70,0.0,0.0,0.0,0.0,0.0,0.00035,-6
1589,80000,0,2,2,24,1,-2,-2,-1,2,2,-1461,-1461,-1458,16950,16475,19284,0,3,18950,0,5889,0,0,-1461,-1464,-20408,16950,10586,19284,-0.0182625,-0.0183,-0.2551,0.211875,0.132325,0.24105,0
1590,20000,1,2,1,29,1,2,2,2,2,2,12186,11700,13474,13006,13743,11167,0,2000,0,1055,0,215,1,12186,9700,13474,11951,13743,10952,0.6093,0.485,0.6737,0.59755,0.68715,0.5476,11
1591,80000,1,2,1,42,0,0,0,0,0,2,18172,19559,20437,26591,28350,27758,2000,1500,6500,2200,0,1100,1,16172,18059,13937,24391,28350,26658,0.20215,0.2257375,0.1742125,0.3048875,0.354375,0.333225,2
1592,350000,0,1,2,31,0,0,0,0,0,0,297967,286352,160042,131977,133067,41470,100066,5715,6005,6287,2103,3,0,197901,280637,154037,125690,130964,41467,0.5654314285714286,0.80182,0.44010571428571427,0.3591142857142857,0.37418285714285715,0.11847714285714285,0
1593,20000,0,3,1,26,2,3,2,3,2,0,10449,10135,11926,11448,10970,11636,0,2100,0,0,1000,1000,1,10449,8035,11926,11448,9970,10636,0.52245,0.40175,0.5963,0.5724,0.4985,0.5318,12
1594,420000,1,3,1,36,-2,-2,-1,0,0,0,0,0,277510,279493,285447,291183,0,277510,10000,10000,10000,10500,1,0,-277510,267510,269493,275447,280683,0.0,-0.6607380952380952,0.6369285714285714,0.64165,0.6558261904761905,0.6682928571428571,-5
1595,240000,1,2,2,29,0,0,0,0,0,0,66473,46296,36751,35625,33114,35473,8000,2002,1600,2000,3000,10000,0,58473,44294,35151,33625,30114,25473,0.2436375,0.18455833333333332,0.1464625,0.14010416666666667,0.125475,0.1061375,0
1596,100000,0,1,2,26,0,-1,0,0,-1,0,1544,1049,2067,1944,389,1221,1100,1200,1000,500,1000,1000,0,444,-151,1067,1444,-611,221,0.00444,-0.00151,0.01067,0.01444,-0.00611,0.00221,-2
1597,90000,0,3,3,40,0,0,0,0,0,0,53256,53695,55426,56544,57048,58421,1923,2597,2637,2041,2291,4824,0,51333,51098,52789,54503,54757,53597,0.5703666666666667,0.5677555555555556,0.5865444444444444,0.6055888888888888,0.6084111111111111,0.5955222222222222,0
1598,30000,1,1,1,32,0,0,0,0,0,0,27764,29276,28637,29325,30004,30506,2000,2000,1500,1100,1300,1000,1,25764,27276,27137,28225,28704,29506,0.8588,0.9092,0.9045666666666666,0.9408333333333333,0.9568,0.9835333333333334,0
1599,260000,0,1,1,40,0,0,-1,-1,-1,-1,22325,27508,3923,9059,3360,3657,7590,3945,31086,3377,3667,493,1,14735,23563,-27163,5682,-307,3164,0.05667307692307692,0.09062692307692308,-0.10447307692307692,0.021853846153846154,-0.0011807692307692307,0.012169230769230769,-4
1600,190000,0,1,1,50,2,2,2,2,2,2,36137,37143,38051,38827,39488,40208,1900,1800,1700,1600,1500,1600,1,34237,35343,36351,37227,37988,38608,0.18019473684210527,0.18601578947368422,0.19132105263157895,0.19593157894736843,0.19993684210526316,0.2032,12
1601,400000,1,1,2,27,-1,-1,-1,-1,-1,-1,2691,426,426,27926,0,430,426,426,27926,27500,430,3504,0,2265,0,-27500,426,-430,-3074,0.0056625,0.0,-0.06875,0.001065,-0.001075,-0.007685,-6
1602,70000,1,2,1,44,0,0,0,0,0,0,34135,27683,28311,24094,21317,9736,2020,5000,3011,1500,1000,1000,1,32115,22683,25300,22594,20317,8736,0.4587857142857143,0.32404285714285713,0.36142857142857143,0.3227714285714286,0.29024285714285714,0.1248,0
1603,350000,1,2,1,48,0,0,0,0,0,0,311013,305633,301114,285750,289399,284597,11019,10728,9812,10397,10099,9967,1,299994,294905,291302,275353,279300,274630,0.8571257142857143,0.8425857142857143,0.8322914285714286,0.7867228571428572,0.798,0.7846571428571428,0
1604,30000,1,3,1,23,2,2,0,0,2,2,15955,15410,17149,18362,18919,19161,0,2000,1500,1000,700,0,1,15955,13410,15649,17362,18219,19161,0.5318333333333334,0.447,0.5216333333333333,0.5787333333333333,0.6073,0.6387,8
1605,90000,1,2,2,27,0,0,-1,-1,-2,-2,4403,1995,300,0,0,0,1000,300,0,0,0,0,0,3403,1695,300,0,0,0,0.03781111111111111,0.018833333333333334,0.0033333333333333335,0.0,0.0,0.0,-6
1606,60000,1,2,1,48,0,0,0,0,0,0,50806,50980,51874,51808,16941,17295,2000,2100,1400,600,1000,1000,1,48806,48880,50474,51208,15941,16295,0.8134333333333333,0.8146666666666667,0.8412333333333334,0.8534666666666667,0.2656833333333333,0.27158333333333334,0
1607,480000,0,1,2,33,1,-2,-2,-2,-2,-2,-897,-897,-897,-897,-897,-897,0,0,0,0,0,0,0,-897,-897,-897,-897,-897,-897,-0.00186875,-0.00186875,-0.00186875,-0.00186875,-0.00186875,-0.00186875,-9
1608,200000,1,2,2,39,-2,-2,-2,-2,-2,-2,2880,0,0,0,2894,210,0,0,0,2894,210,2595,0,2880,0,0,-2894,2684,-2385,0.0144,0.0,0.0,-0.01447,0.01342,-0.011925,-12
1609,100000,0,1,2,33,0,0,0,0,0,0,84647,87369,88489,83639,80893,81643,4085,3505,3479,3097,3259,3253,0,80562,83864,85010,80542,77634,78390,0.80562,0.83864,0.8501,0.80542,0.77634,0.7839,0
1610,20000,0,2,1,40,0,0,0,2,0,0,12129,12919,14810,15267,15714,16308,1300,2100,1000,1000,1000,1000,1,10829,10819,13810,14267,14714,15308,0.54145,0.54095,0.6905,0.71335,0.7357,0.7654,2
1611,80000,1,3,1,54,0,0,0,0,0,0,76752,77528,68966,63972,50072,51239,3768,3009,2009,1818,2000,6000,1,72984,74519,66957,62154,48072,45239,0.9123,0.9314875,0.8369625,0.776925,0.6009,0.5654875,0
1612,80000,1,1,2,34,-1,-1,-1,2,0,0,34827,27881,16801,12532,12059,1242,27881,12532,1,0,0,717,0,6946,15349,16800,12532,12059,525,0.086825,0.1918625,0.21,0.15665,0.1507375,0.0065625,-1
1613,50000,0,2,1,59,0,0,0,0,0,0,47069,48479,49520,18990,19539,19791,2169,2210,680,855,726,687,1,44900,46269,48840,18135,18813,19104,0.898,0.92538,0.9768,0.3627,0.37626,0.38208,0
1614,10000,1,2,2,27,1,2,0,0,0,0,5150,4922,5941,6984,7120,7267,0,1257,1300,400,410,420,0,5150,3665,4641,6584,6710,6847,0.515,0.3665,0.4641,0.6584,0.671,0.6847,3
1615,180000,0,2,2,33,0,0,0,0,0,0,103956,103230,105945,111065,122028,125069,4100,4400,10000,12900,5000,5000,0,99856,98830,95945,98165,117028,120069,0.5547555555555556,0.5490555555555555,0.5330277777777778,0.5453611111111111,0.6501555555555556,0.66705,0
1616,50000,0,2,2,44,0,0,0,0,0,0,49120,50823,49844,20239,20241,19921,2504,1590,701,803,1000,671,0,46616,49233,49143,19436,19241,19250,0.93232,0.98466,0.98286,0.38872,0.38482,0.385,0
1617,30000,0,1,2,34,0,0,0,0,2,2,29160,29302,29698,31157,31714,30496,1494,1466,2501,1759,0,15912,0,27666,27836,27197,29398,31714,14584,0.9222,0.9278666666666666,0.9065666666666666,0.9799333333333333,1.0571333333333333,0.4861333333333333,4
1618,20000,1,1,2,22,2,0,0,0,0,2,13718,15033,15751,17068,17891,17463,1550,1268,1585,1408,0,1700,0,12168,13765,14166,15660,17891,15763,0.6084,0.68825,0.7083,0.783,0.89455,0.78815,4
1619,80000,1,2,1,34,1,2,2,2,2,2,46461,47526,46466,48183,49057,51091,2100,0,2800,1800,3000,0,1,44361,47526,43666,46383,46057,51091,0.5545125,0.594075,0.545825,0.5797875,0.5757125,0.6386375,11
1620,100000,1,1,2,25,0,0,0,0,2,0,13201,14671,16120,18588,13272,13549,2000,2000,2786,0,639,700,0,11201,12671,13334,18588,12633,12849,0.11201,0.12671,0.13334,0.18588,0.12633,0.12849,2
1621,100000,0,3,2,48,0,0,0,0,0,0,58430,36846,35538,34958,34039,33650,2000,2000,2000,2000,2000,20000,0,56430,34846,33538,32958,32039,13650,0.5643,0.34846,0.33538,0.32958,0.32039,0.1365,0
1622,30000,0,1,2,24,0,0,0,2,0,0,6003,4912,6214,3311,4430,906,1440,2259,0,1500,425,895,0,4563,2653,6214,1811,4005,11,0.1521,0.08843333333333334,0.20713333333333334,0.060366666666666666,0.1335,0.00036666666666666667,2
1623,300000,1,3,1,31,-1,-1,-1,-1,-1,-1,331,331,331,331,-1,199,332,332,332,0,200,0,1,-1,-1,-1,331,-201,199,-3.3333333333333333e-06,-3.3333333333333333e-06,-3.3333333333333333e-06,0.0011033333333333333,-0.00067,0.0006633333333333334,-6
1624,60000,0,1,2,29,0,0,0,0,0,0,11976,13462,15231,16966,17878,19085,2000,2000,2000,1500,1500,1500,0,9976,11462,13231,15466,16378,17585,0.16626666666666667,0.19103333333333333,0.22051666666666667,0.25776666666666664,0.2729666666666667,0.2930833333333333,0
1625,90000,0,1,2,30,0,0,0,0,0,2,41789,42913,44388,45348,48454,47524,2100,2500,2000,4000,0,2000,0,39689,40413,42388,41348,48454,45524,0.4409888888888889,0.44903333333333334,0.4709777777777778,0.45942222222222223,0.5383777777777777,0.5058222222222222,2
1626,30000,1,3,1,44,0,0,2,2,2,2,25957,28914,29754,28583,29739,28412,3400,1600,0,2220,0,1100,1,22557,27314,29754,26363,29739,27312,0.7519,0.9104666666666666,0.9918,0.8787666666666667,0.9913,0.9104,8
1627,200000,1,1,1,31,-1,-1,-2,-2,-1,-1,1203,0,0,0,5032,0,0,0,0,5032,0,0,1,1203,0,0,-5032,5032,0,0.006015,0.0,0.0,-0.02516,0.02516,0.0,-8
1628,240000,0,1,2,30,-2,-2,-2,-2,-2,-2,0,0,0,0,0,0,0,0,0,0,0,0,0,0,0,0,0,0,0,0.0,0.0,0.0,0.0,0.0,0.0,-12
1629,10000,0,2,2,23,2,0,0,0,0,0,8206,6828,9694,9888,10094,9762,1134,3000,345,356,425,194,0,7072,3828,9349,9532,9669,9568,0.7072,0.3828,0.9349,0.9532,0.9669,0.9568,2
1630,100000,1,2,2,41,-1,-1,-2,-1,0,0,1023,0,0,50063,22767,23399,0,0,50063,900,1000,1000,0,1023,0,-50063,49163,21767,22399,0.01023,0.0,-0.50063,0.49163,0.21767,0.22399,-5
1631,190000,1,1,2,28,-2,-2,-2,-2,-2,-2,0,2278,918,859,1300,514,2278,918,864,1300,514,175,0,-2278,1360,54,-441,786,339,-0.011989473684210526,0.007157894736842105,0.00028421052631578947,-0.0023210526315789472,0.0041368421052631575,0.0017842105263157894,-12
1632,210000,1,2,1,40,-1,-1,2,-1,-1,-1,2216,6142,1108,1499,2447,888,5258,0,1500,2500,1000,1500,1,-3042,6142,-392,-1001,1447,-612,-0.014485714285714286,0.029247619047619047,-0.0018666666666666666,-0.0047666666666666664,0.006890476190476191,-0.0029142857142857143,-3
1633,20000,0,2,2,23,0,0,0,-1,-1,2,17821,19099,0,1728,1953,1780,2000,0,1728,225,0,0,0,15821,19099,-1728,1503,1953,1780,0.79105,0.95495,-0.0864,0.07515,0.09765,0.089,0
1634,100000,0,3,1,30,2,2,2,2,0,0,68436,66783,74555,72759,74131,75603,0,9557,0,2700,2707,3120,1,68436,57226,74555,70059,71424,72483,0.68436,0.57226,0.74555,0.70059,0.71424,0.72483,8
1635,50000,1,1,2,52,2,0,0,0,-2,-1,6379,3257,4166,0,0,318,1091,1000,0,0,318,0,0,5288,2257,4166,0,-318,318,0.10576,0.04514,0.08332,0.0,-0.00636,0.00636,-1
1636,10000,1,2,1,22,-1,-1,-1,0,0,0,390,390,9159,9363,8160,7552,390,9159,700,279,1000,800,1,0,-8769,8459,9084,7160,6752,0.0,-0.8769,0.8459,0.9084,0.716,0.6752,-3
1637,50000,0,1,2,40,1,2,0,0,0,0,25667,26441,27213,28521,28458,29053,1500,1500,1771,1500,1053,1093,0,24167,24941,25442,27021,27405,27960,0.48334,0.49882,0.50884,0.54042,0.5481,0.5592,3
1638,170000,1,2,1,33,-1,-1,-1,-1,-1,-1,1870,0,400,1000,0,1243,0,400,1000,0,1243,6912,1,1870,-400,-600,1000,-1243,-5669,0.011,-0.002352941176470588,-0.0035294117647058825,0.0058823529411764705,-0.007311764705882353,-0.03334705882352941,-6
1639,50000,0,2,2,48,0,0,0,-1,0,0,51631,45223,45461,18354,19118,19404,1800,1005,19763,1000,1000,1000,0,49831,44218,25698,17354,18118,18404,0.99662,0.88436,0.51396,0.34708,0.36236,0.36808,-1
1640,20000,1,2,2,51,-2,-2,-2,-2,-2,-2,0,0,0,0,0,0,0,0,0,0,0,930,0,0,0,0,0,0,-930,0.0,0.0,0.0,0.0,0.0,-0.0465,-12
1641,120000,1,2,1,28,0,0,0,0,0,0,96833,78920,74310,75710,77503,73945,3000,5000,3000,3000,4000,1500,1,93833,73920,71310,72710,73503,72445,0.7819416666666666,0.616,0.59425,0.6059166666666667,0.612525,0.6037083333333333,0
1642,500000,1,1,1,41,-1,-1,-2,-2,-1,-1,680,0,0,0,74731,0,0,0,0,74731,0,0,1,680,0,0,-74731,74731,0,0.00136,0.0,0.0,-0.149462,0.149462,0.0,-8
1643,50000,0,1,2,24,2,2,0,0,0,0,49946,48808,45469,20228,18900,19066,0,2079,693,1080,700,1004,0,49946,46729,44776,19148,18200,18062,0.99892,0.93458,0.89552,0.38296,0.364,0.36124,4
1644,80000,1,3,2,30,0,0,0,-1,0,0,36676,38247,39856,28698,29299,30120,2165,2774,30458,1063,1308,4317,0,34511,35473,9398,27635,27991,25803,0.4313875,0.4434125,0.117475,0.3454375,0.3498875,0.3225375,-1
1645,150000,1,1,2,34,1,-2,-2,-2,-1,2,0,0,0,0,552,252,0,0,0,552,0,13404,0,0,0,0,-552,552,-13152,0.0,0.0,0.0,-0.00368,0.00368,-0.08768,-4
1646,240000,0,3,2,42,0,0,0,0,0,0,159362,227686,177380,126645,128877,121803,146282,7005,4601,5000,5300,6100,0,13080,220681,172779,121645,123577,115703,0.0545,0.9195041666666667,0.7199125,0.5068541666666667,0.5149041666666667,0.48209583333333333,0
1647,100000,0,1,2,27,2,0,0,2,2,2,34694,36014,39321,39145,39494,39896,1900,4200,900,1400,900,6440,0,32794,31814,38421,37745,38594,33456,0.32794,0.31814,0.38421,0.37745,0.38594,0.33456,8
1648,50000,0,1,3,37,0,0,2,0,0,0,45553,49457,47080,45833,45310,6313,6324,0,1200,1000,126,1000,0,39229,49457,45880,44833,45184,5313,0.78458,0.98914,0.9176,0.89666,0.90368,0.10626,2
1649,280000,1,1,1,51,-1,-1,-1,-1,-1,-1,11223,15225,4951,2408,8360,6202,15262,4951,2408,8360,6202,200,1,-4039,10274,2543,-5952,2158,6002,-0.014425,0.036692857142857145,0.009082142857142856,-0.021257142857142856,0.007707142857142857,0.021435714285714287,-6
1650,70000,1,1,1,45,1,2,-1,2,-1,-1,6369,390,3060,780,2079,0,0,3450,0,2079,0,0,1,6369,-3060,3060,-1299,2079,0,0.09098571428571428,-0.04371428571428571,0.04371428571428571,-0.01855714285714286,0.0297,0.0,2
1651,240000,1,1,2,36,-1,-1,2,0,-1,2,5367,6959,6649,5149,13750,5777,6959,15,0,7013,0,726,0,-1592,6944,6649,-1864,13750,5051,-0.006633333333333333,0.028933333333333332,0.027704166666666665,-0.0077666666666666665,0.057291666666666664,0.021045833333333333,1
1652,90000,0,1,2,23,0,0,0,0,0,-1,90888,85293,69482,60244,22640,3270,6000,4008,30055,15050,3270,16488,0,84888,81285,39427,45194,19370,-13218,0.9432,0.9031666666666667,0.4380777777777778,0.5021555555555556,0.21522222222222223,-0.14686666666666667,-1
1653,460000,1,1,2,28,0,0,0,0,-1,0,21333,16560,12570,19403,10063,8628,4560,2500,9456,10063,0,0,0,16773,14060,3114,9340,10063,8628,0.03646304347826087,0.03056521739130435,0.006769565217391305,0.020304347826086956,0.02187608695652174,0.018756521739130436,-1
1654,90000,1,2,1,28,0,0,0,0,0,0,59694,55282,60630,58919,47850,48034,2852,15678,7763,1686,1735,1518,1,56842,39604,52867,57233,46115,46516,0.6315777777777778,0.44004444444444446,0.5874111111111111,0.6359222222222223,0.5123888888888889,0.5168444444444444,0
1655,60000,0,3,1,55,3,2,2,0,0,0,60521,61450,57244,28853,29510,26547,2504,7,1200,1200,1100,1500,1,58017,61443,56044,27653,28410,25047,0.96695,1.02405,0.9340666666666667,0.4608833333333333,0.4735,0.41745,7
1656,230000,0,2,2,58,0,0,0,0,0,0,110163,112499,114837,116400,45643,51083,5600,5700,5000,1855,6400,0,0,104563,106799,109837,114545,39243,51083,0.4546217391304348,0.4643434782608696,0.4775521739130435,0.4980217391304348,0.1706217391304348,0.2221,0
1657,180000,1,1,2,37,0,0,0,0,0,0,34607,43623,46667,31931,33928,35235,10000,5000,15000,5000,2000,5000,0,24607,38623,31667,26931,31928,30235,0.13670555555555555,0.21457222222222222,0.17592777777777777,0.14961666666666668,0.17737777777777777,0.16797222222222222,0
1658,270000,0,1,1,38,-2,-2,-2,-2,-2,-2,0,0,0,0,0,0,0,0,0,0,0,0,1,0,0,0,0,0,0,0.0,0.0,0.0,0.0,0.0,0.0,-12
1659,80000,1,2,2,25,0,0,0,0,0,0,47836,49038,53158,48269,48019,46908,2000,5000,2000,2000,2000,2000,0,45836,44038,51158,46269,46019,44908,0.57295,0.550475,0.639475,0.5783625,0.5752375,0.56135,0
1660,100000,1,1,2,33,0,0,0,0,0,0,75374,44796,47294,38712,39304,40479,2000,5000,1521,1595,2000,2716,0,73374,39796,45773,37117,37304,37763,0.73374,0.39796,0.45773,0.37117,0.37304,0.37763,0
1661,50000,1,2,2,24,0,0,0,0,2,0,8587,9941,10950,11519,11191,11903,1500,1481,1050,0,903,333,0,7087,8460,9900,11519,10288,11570,0.14174,0.1692,0.198,0.23038,0.20576,0.2314,2
1662,350000,0,1,1,31,0,0,0,2,0,0,18685,21057,23291,22812,27418,20203,3000,3000,0,5000,5000,5000,1,15685,18057,23291,17812,22418,15203,0.044814285714285716,0.05159142857142857,0.06654571428571429,0.050891428571428574,0.06405142857142856,0.043437142857142855,2
1663,80000,0,2,1,28,0,0,0,0,0,0,81099,81449,79887,76067,73077,76894,10000,5000,10000,6500,5000,5000,1,71099,76449,69887,69567,68077,71894,0.8887375,0.9556125,0.8735875,0.8695875,0.8509625,0.898675,0
1664,50000,1,2,1,39,0,0,0,0,2,0,10960,12030,13125,14104,13735,14307,1250,1300,1200,0,800,600,1,9710,10730,11925,14104,12935,13707,0.1942,0.2146,0.2385,0.28208,0.2587,0.27414,2
1665,50000,1,2,1,30,0,0,0,2,0,-1,31079,30036,6845,4364,2185,2162,2280,2300,0,44,2200,3000,1,28799,27736,6845,4320,-15,-838,0.57598,0.55472,0.1369,0.0864,-0.0003,-0.01676,1
1666,30000,1,2,1,35,1,-2,-1,0,-1,0,0,0,12403,17849,4935,6491,0,12403,8359,4935,3000,1000,1,0,-12403,4044,12914,1935,5491,0.0,-0.4134333333333333,0.1348,0.43046666666666666,0.0645,0.18303333333333333,-3
1667,80000,0,2,1,39,0,0,0,0,0,0,145905,147860,78545,19212,36800,18900,5107,3269,1400,368,1000,0,1,140798,144591,77145,18844,35800,18900,1.759975,1.8073875,0.9643125,0.23555,0.4475,0.23625,0
1668,200000,0,1,3,50,3,2,2,2,0,0,176077,179769,178358,177340,181281,191644,8000,3000,3400,6800,13600,5900,0,168077,176769,174958,170540,167681,185744,0.840385,0.883845,0.87479,0.8527,0.838405,0.92872,9
1669,450000,1,1,1,36,1,-1,-1,-2,-2,-2,0,2500,2500,0,0,0,2500,2500,0,0,0,0,1,-2500,0,2500,0,0,0,-0.005555555555555556,0.0,0.005555555555555556,0.0,0.0,0.0,-7
1670,50000,1,3,1,31,1,2,2,2,2,2,38102,40025,40071,40906,42100,41269,2830,1000,1800,2000,0,1704,1,35272,39025,38271,38906,42100,39565,0.70544,0.7805,0.76542,0.77812,0.842,0.7913,11
1671,50000,0,2,3,42,2,0,0,2,0,0,47647,50232,50510,32177,29530,29789,3700,3700,0,1072,1500,1132,0,43947,46532,50510,31105,28030,28657,0.87894,0.93064,1.0102,0.6221,0.5606,0.57314,4
1672,200000,0,1,1,41,-1,-1,-1,-1,-1,-1,580,580,580,580,580,580,580,580,580,580,580,699,1,0,0,0,0,0,-119,0.0,0.0,0.0,0.0,0.0,-0.000595,-6
1673,50000,1,2,2,31,-1,-1,-1,-1,-1,-1,422,1334,3962,0,660,1840,1532,3962,0,660,1840,0,0,-1110,-2628,3962,-660,-1180,1840,-0.0222,-0.05256,0.07924,-0.0132,-0.0236,0.0368,-6
1674,360000,1,2,1,49,0,0,0,0,0,0,338321,329178,320709,310208,289883,279709,12323,22023,12023,10023,10823,7523,1,325998,307155,308686,300185,279060,272186,0.90555,0.8532083333333333,0.8574611111111111,0.8338472222222222,0.7751666666666667,0.7560722222222223,0
1675,60000,1,1,2,25,0,0,0,0,0,0,59228,59961,59824,47655,27298,28303,2300,3572,2169,6000,4000,4000,0,56928,56389,57655,41655,23298,24303,0.9488,0.9398166666666666,0.9609166666666666,0.69425,0.3883,0.40505,0
1676,110000,1,3,1,43,0,0,0,0,0,0,48796,49371,19413,20204,16627,14980,2350,1392,1183,511,1151,482,1,46446,47979,18230,19693,15476,14498,0.42223636363636363,0.43617272727272727,0.16572727272727272,0.17902727272727273,0.1406909090909091,0.1318,0
1677,30000,1,1,2,22,-1,-1,-1,0,0,-2,3963,6222,2936,588,0,0,6222,2936,0,0,0,0,0,-2259,3286,2936,588,0,0,-0.0753,0.10953333333333333,0.09786666666666667,0.0196,0.0,0.0,-5
1678,30000,0,1,1,45,1,2,2,2,3,2,25829,25121,27988,30515,29738,29126,0,3600,3300,0,0,1100,1,25829,21521,24688,30515,29738,28026,0.8609666666666667,0.7173666666666667,0.8229333333333333,1.0171666666666668,0.9912666666666666,0.9342,12
1679,310000,1,2,1,48,-2,-2,-2,-2,-2,-2,0,0,0,0,0,0,0,0,0,0,0,0,1,0,0,0,0,0,0,0.0,0.0,0.0,0.0,0.0,0.0,-12
1680,50000,0,3,1,44,0,0,0,0,0,0,15931,17363,18735,19188,17578,16855,2000,2000,1006,1003,1000,1000,1,13931,15363,17729,18185,16578,15855,0.27862,0.30726,0.35458,0.3637,0.33156,0.3171,0
1681,20000,0,3,2,27,0,0,0,0,0,0,13384,14153,15417,16944,18992,15888,1300,1500,2000,2048,0,4500,0,12084,12653,13417,14896,18992,11388,0.6042,0.63265,0.67085,0.7448,0.9496,0.5694,0
1682,590000,0,1,1,41,-2,-2,-2,-2,-2,-2,617,1304,35498,0,0,0,1304,35552,0,0,0,0,1,-687,-34248,35498,0,0,0,-0.001164406779661017,-0.058047457627118645,0.06016610169491526,0.0,0.0,0.0,-12
1683,250000,0,2,1,44,0,0,0,0,0,0,254933,244433,249882,248013,99071,98928,8754,10866,5592,2212,2565,2156,1,246179,233567,244290,245801,96506,96772,0.984716,0.934268,0.97716,0.983204,0.386024,0.387088,0
1684,80000,0,1,2,26,1,-2,-2,-2,-2,-2,0,0,0,0,0,0,0,0,0,0,0,0,0,0,0,0,0,0,0,0.0,0.0,0.0,0.0,0.0,0.0,-9
1685,230000,0,1,2,28,0,0,0,0,0,0,29108,29240,30062,31253,31965,36782,1587,1409,10000,1193,6782,1026,0,27521,27831,20062,30060,25183,35756,0.11965652173913044,0.12100434782608696,0.08722608695652175,0.13069565217391305,0.10949130434782609,0.1554608695652174,0
1686,20000,1,1,2,24,0,0,0,0,0,0,15036,16069,16774,17266,17539,18033,1580,1280,770,700,785,600,0,13456,14789,16004,16566,16754,17433,0.6728,0.73945,0.8002,0.8283,0.8377,0.87165,0
1687,220000,1,3,1,37,-1,-1,2,-1,-1,-1,200,400,200,200,350,350,400,0,200,350,350,200,1,-200,400,0,-150,0,150,-0.0009090909090909091,0.0018181818181818182,0.0,-0.0006818181818181819,0.0,0.0006818181818181819,-3
1688,310000,1,1,2,36,1,-1,-1,-1,-1,-2,-8,1703,-8,1624,0,0,1711,0,1632,0,0,173,0,-1719,1703,-1640,1624,0,-173,-0.005545161290322581,0.005493548387096774,-0.005290322580645161,0.005238709677419355,0.0,-0.0005580645161290322,-5
1689,390000,0,4,2,29,1,2,0,0,0,0,407399,397464,395333,367400,304990,304303,0,14414,14411,76000,15000,13000,0,407399,383050,380922,291400,289990,291303,1.0446128205128205,0.9821794871794872,0.9767230769230769,0.7471794871794872,0.7435641025641025,0.7469307692307692,3
1690,30000,1,2,1,38,-1,-1,2,-1,0,0,2828,4868,3963,4514,3129,675,3963,16,4527,675,0,1015,1,-1135,4852,-564,3839,3129,-340,-0.03783333333333333,0.16173333333333334,-0.0188,0.12796666666666667,0.1043,-0.011333333333333334,-1
1691,20000,1,2,1,22,2,0,0,0,0,2,14414,15424,16448,17462,18305,17871,1554,1578,1592,1435,0,1663,1,12860,13846,14856,16027,18305,16208,0.643,0.6923,0.7428,0.80135,0.91525,0.8104,4
1692,20000,0,2,2,23,2,0,0,2,0,0,15789,16831,20404,19621,14051,0,1610,4183,0,281,0,0,0,14179,12648,20404,19340,14051,0,0.70895,0.6324,1.0202,0.967,0.70255,0.0,4
1693,50000,0,2,1,49,0,0,0,0,0,0,33346,33536,34923,37192,39341,27561,2000,3500,3000,3000,5000,5000,1,31346,30036,31923,34192,34341,22561,0.62692,0.60072,0.63846,0.68384,0.68682,0.45122,0
1694,110000,1,2,2,26,0,0,0,0,0,0,63376,67293,67536,77697,82888,88048,5000,1317,11380,6508,6540,6671,0,58376,65976,56156,71189,76348,81377,0.5306909090909091,0.5997818181818182,0.5105090909090909,0.6471727272727272,0.6940727272727273,0.739790909090909,0
1695,20000,0,3,2,58,0,0,-2,-2,-2,-2,12066,0,0,0,0,0,0,0,0,0,0,0,0,12066,0,0,0,0,0,0.6033,0.0,0.0,0.0,0.0,0.0,-8
1696,50000,1,3,2,41,0,0,0,0,0,0,3048,4063,5081,6090,6211,6342,1074,1092,1101,222,231,231,0,1974,2971,3980,5868,5980,6111,0.03948,0.05942,0.0796,0.11736,0.1196,0.12222,0
1697,40000,0,2,1,35,1,-2,-2,-2,-2,-2,0,0,0,0,0,0,0,0,0,0,0,0,1,0,0,0,0,0,0,0.0,0.0,0.0,0.0,0.0,0.0,-9
1698,240000,1,2,2,27,0,-1,0,-1,0,-1,30589,2225,3708,20694,19771,38603,2239,3700,20739,10003,40115,8756,0,28350,-1475,-17031,10691,-20344,29847,0.118125,-0.006145833333333333,-0.0709625,0.04454583333333333,-0.08476666666666667,0.1243625,-3
1699,20000,0,2,1,31,-1,-1,-1,0,-1,-1,836,390,780,390,390,0,390,780,0,390,0,780,1,446,-390,780,0,390,-780,0.0223,-0.0195,0.039,0.0,0.0195,-0.039,-5
1700,50000,0,3,1,45,1,-2,-2,-2,-2,-2,0,0,0,0,0,0,0,0,0,0,0,0,1,0,0,0,0,0,0,0.0,0.0,0.0,0.0,0.0,0.0,-9
1701,150000,1,4,2,29,0,0,-1,-1,0,0,17196,12991,3305,11164,18803,22891,2012,3310,11164,18800,10000,16910,0,15184,9681,-7859,-7636,8803,5981,0.10122666666666667,0.06454,-0.05239333333333333,-0.05090666666666667,0.058686666666666665,0.03987333333333333,-2
1702,60000,0,2,2,27,2,0,0,2,0,0,58598,56486,60877,56138,56806,57935,2632,5924,0,2200,2200,2290,0,55966,50562,60877,53938,54606,55645,0.9327666666666666,0.8427,1.0146166666666667,0.8989666666666667,0.9101,0.9274166666666667,4
1703,500000,1,2,2,33,-2,-1,0,0,-2,-2,11058,18578,84087,50058,35036,4757,18641,75207,5100,5089,118,1647,0,-7583,-56629,78987,44969,34918,3110,-0.015166,-0.113258,0.157974,0.089938,0.069836,0.00622,-7
1704,120000,0,2,2,36,0,0,2,0,0,2,26490,23333,16721,17400,26087,19577,3246,0,7313,15000,0,7000,0,23244,23333,9408,2400,26087,12577,0.1937,0.19444166666666668,0.0784,0.02,0.21739166666666668,0.10480833333333334,4
1705,360000,1,2,2,39,-1,2,2,-2,-2,-2,655,655,0,0,0,0,0,0,0,0,0,0,0,655,655,0,0,0,0,0.0018194444444444445,0.0018194444444444445,0.0,0.0,0.0,0.0,-3
1706,170000,1,2,1,43,0,0,0,0,0,0,51054,52127,52651,53851,53095,54316,2489,2000,2048,1927,2104,2071,1,48565,50127,50603,51924,50991,52245,0.2856764705882353,0.2948647058823529,0.29766470588235294,0.3054352941176471,0.2999470588235294,0.3073235294117647,0
1707,100000,1,3,1,51,0,0,0,0,0,0,98918,96916,98492,89961,93971,85526,4523,4213,3100,10000,3220,3130,1,94395,92703,95392,79961,90751,82396,0.94395,0.92703,0.95392,0.79961,0.90751,0.82396,0
1708,100000,0,2,2,38,2,0,0,0,0,-1,106989,98751,32099,18811,9960,10000,3910,1733,1000,1149,10000,0,0,103079,97018,31099,17662,-40,10000,1.03079,0.97018,0.31099,0.17662,-0.0004,0.1,1
1709,230000,1,4,1,29,0,0,0,0,0,0,70069,64375,65691,67150,68398,69917,3000,2386,2553,2483,2657,3000,1,67069,61989,63138,64667,65741,66917,0.29160434782608696,0.2695173913043478,0.2745130434782609,0.2811608695652174,0.2858304347826087,0.2909434782608696,0
1710,120000,1,2,2,30,0,0,0,0,0,0,104801,100502,86478,81902,78616,80307,4000,2960,3833,2855,3000,3000,0,100801,97542,82645,79047,75616,77307,0.8400083333333334,0.81285,0.6887083333333334,0.658725,0.6301333333333333,0.644225,0
1711,200000,1,1,2,28,1,2,0,0,0,0,205683,196807,191752,178560,170092,161850,0,9025,8030,5639,6054,5100,0,205683,187782,183722,172921,164038,156750,1.028415,0.93891,0.91861,0.864605,0.82019,0.78375,3
1712,500000,0,2,1,48,-1,-1,-1,-1,-1,-1,28352,35294,74846,37985,33050,22185,35465,75212,38169,33209,22289,22289,1,-7113,-39918,36677,4776,10761,-104,-0.014226,-0.079836,0.073354,0.009552,0.021522,-0.000208,-6
1713,430000,1,2,2,27,0,0,0,0,0,0,401298,433835,399755,357082,363968,346718,40000,15140,15000,12565,15000,13000,0,361298,418695,384755,344517,348968,333718,0.8402279069767442,0.9737093023255814,0.8947790697674418,0.8012023255813954,0.8115534883720931,0.7760883720930233,0
1714,50000,1,1,2,25,0,0,0,0,0,0,41892,43875,45052,44938,40655,40930,3000,2200,2000,2000,2000,3000,0,38892,41675,43052,42938,38655,37930,0.77784,0.8335,0.86104,0.85876,0.7731,0.7586,0
1715,40000,0,1,2,26,0,0,0,0,0,0,21651,19279,19076,15838,17616,11081,5009,5000,1560,7000,497,2000,0,16642,14279,17516,8838,17119,9081,0.41605,0.356975,0.4379,0.22095,0.427975,0.227025,0
1716,150000,0,2,2,23,0,0,-1,0,0,0,151686,147474,7474,8173,87500,89731,3000,120000,823,80000,3684,4500,0,148686,27474,6651,-71827,83816,85231,0.99124,0.18316,0.04434,-0.47884666666666664,0.5587733333333333,0.5682066666666666,-1
1717,360000,1,1,1,31,-2,-2,-2,-2,-2,-2,0,18540,9007,9500,8675,6573,18540,10000,10000,9000,6600,32810,1,-18540,8540,-993,500,2075,-26237,-0.0515,0.02372222222222222,-0.002758333333333333,0.001388888888888889,0.005763888888888889,-0.07288055555555556,-12
1718,240000,0,2,2,46,0,0,0,0,0,0,47379,49274,51171,52716,54229,56191,3000,3000,3000,3000,3000,3000,0,44379,46274,48171,49716,51229,53191,0.1849125,0.19280833333333333,0.2007125,0.20715,0.21345416666666667,0.22162916666666665,0
1719,420000,0,2,2,26,1,2,2,0,0,0,390188,395881,382620,333210,324487,327615,14000,15,13175,11700,11900,12140,0,376188,395866,369445,321510,312587,315475,0.8956857142857143,0.9425380952380953,0.8796309523809523,0.7655,0.7442547619047619,0.7511309523809524,5
1720,60000,0,2,2,39,0,0,2,0,0,0,58538,61359,58147,59399,37746,37794,6000,0,2500,1316,1401,3000,0,52538,61359,55647,58083,36345,34794,0.8756333333333334,1.02265,0.92745,0.96805,0.60575,0.5799,2
1721,30000,0,1,2,24,0,0,0,0,0,0,28495,29632,30629,29357,30143,30419,1900,1800,1045,1250,1100,1100,0,26595,27832,29584,28107,29043,29319,0.8865,0.9277333333333333,0.9861333333333333,0.9369,0.9681,0.9773,0
1722,150000,1,1,2,27,-2,-2,-2,-2,-2,-2,35688,14736,36490,3125,7603,2995,14820,36672,3232,7641,3010,982,0,20868,-21936,33258,-4516,4593,2013,0.13912,-0.14624,0.22172,-0.030106666666666667,0.03062,0.01342,-12
1723,500000,1,1,2,40,-1,-1,-1,-1,-2,-1,5158,5514,14199,1537,1537,5517,5514,14220,1537,1537,5517,550,0,-356,-8706,12662,0,-3980,4967,-0.000712,-0.017412,0.025324,0.0,-0.00796,0.009934,-7
1724,100000,1,2,2,25,1,2,3,4,4,3,53111,55650,59730,61693,59186,57949,4000,5600,3500,0,0,0,0,49111,50050,56230,61693,59186,57949,0.49111,0.5005,0.5623,0.61693,0.59186,0.57949,17
1725,120000,1,3,2,31,1,2,0,0,0,0,122806,119325,112976,63658,38495,38226,15,3500,2000,1500,1500,5000,0,122791,115825,110976,62158,36995,33226,1.0232583333333334,0.9652083333333333,0.9248,0.5179833333333334,0.3082916666666667,0.2768833333333333,3
1726,300000,1,2,2,28,0,0,0,0,0,0,199801,121321,94524,86637,78939,70689,5017,3200,3500,3000,3000,74000,0,194784,118121,91024,83637,75939,-3311,0.64928,0.3937366666666667,0.3034133333333333,0.27879,0.25313,-0.011036666666666667,0
1727,70000,1,3,1,39,0,0,0,0,0,2,124493,125680,129498,131216,136744,133413,4800,5900,6000,9200,0,4859,1,119693,119780,123498,122016,136744,128554,1.7099,1.711142857142857,1.764257142857143,1.7430857142857143,1.9534857142857143,1.8364857142857143,2
1728,50000,0,3,2,26,2,2,2,0,0,0,22578,23720,23046,23314,23801,24354,1800,0,950,862,947,814,0,20778,23720,22096,22452,22854,23540,0.41556,0.4744,0.44192,0.44904,0.45708,0.4708,6
1729,220000,1,1,1,51,-1,-1,-1,2,2,-2,2262,2255,8105,2224,150,1000,2276,8117,0,150,1000,2619,1,-14,-5862,8105,2074,-850,-1619,-6.363636363636364e-05,-0.026645454545454545,0.03684090909090909,0.009427272727272727,-0.003863636363636364,-0.007359090909090909,-1
1730,250000,1,2,1,40,-2,-2,-2,-2,-2,-2,1385,4843,2942,1054,1708,3014,4843,2942,1057,1708,3014,3037,1,-3458,1901,1885,-654,-1306,-23,-0.013832,0.007604,0.00754,-0.002616,-0.005224,-9.2e-05,-12
1731,130000,1,2,2,39,2,2,2,2,0,0,50033,52440,52993,51546,52663,53737,3500,2000,0,2100,2100,2200,0,46533,50440,52993,49446,50563,51537,0.35794615384615386,0.388,0.40763846153846156,0.38035384615384615,0.38894615384615383,0.3964384615384615,8
1732,230000,0,2,2,26,-2,-2,-1,-1,0,0,-8,-8,3243,20172,26446,58598,0,3251,20174,12000,46100,65000,0,-8,-3259,-16931,8172,-19654,-6402,-3.478260869565217e-05,-0.014169565217391305,-0.07361304347826086,0.03553043478260869,-0.08545217391304348,-0.027834782608695652,-6
1733,150000,1,2,2,23,0,0,0,0,0,0,7795,13821,6640,5831,10514,5432,7000,1000,1070,6000,2432,116,0,795,12821,5570,-169,8082,5316,0.0053,0.08547333333333333,0.03713333333333333,-0.0011266666666666667,0.05388,0.03544,0
1734,250000,1,2,2,26,0,0,0,0,0,0,70522,72062,73511,75314,74172,71933,2667,2700,3000,5000,2800,1800,0,67855,69362,70511,70314,71372,70133,0.27142,0.277448,0.282044,0.281256,0.285488,0.280532,0
1735,170000,1,2,1,32,1,2,-1,-1,0,0,9990,4647,1399,6548,1399,0,0,1399,6548,0,0,0,1,9990,3248,-5149,6548,1399,0,0.05876470588235294,0.019105882352941177,-0.030288235294117647,0.03851764705882353,0.008229411764705883,0.0,1
1736,230000,1,3,2,45,0,0,-1,-1,-2,-2,30099,20069,1000,0,0,0,1000,1000,0,0,0,62130,0,29099,19069,1000,0,0,-62130,0.12651739130434783,0.08290869565217392,0.004347826086956522,0.0,0.0,-0.2701304347826087,-6
1737,510000,1,1,1,37,-1,-1,-1,-1,-1,-1,386,733,739,1939,739,2739,763,739,1939,739,2739,1110,1,-377,-6,-1200,1200,-2000,1629,-0.0007392156862745098,-1.1764705882352942e-05,-0.002352941176470588,0.002352941176470588,-0.00392156862745098,0.0031941176470588234,-6
1738,70000,1,1,1,35,2,2,2,2,2,2,51143,53185,55030,56530,55027,58461,3500,3300,3000,0,4500,2500,1,47643,49885,52030,56530,50527,55961,0.6806142857142857,0.7126428571428571,0.7432857142857143,0.8075714285714286,0.7218142857142857,0.7994428571428571,12
1739,140000,1,2,2,28,2,2,2,0,0,2,26450,28823,28171,28740,30454,29930,3007,0,924,2070,0,3000,0,23443,28823,27247,26670,30454,26930,0.16745,0.20587857142857144,0.19462142857142858,0.1905,0.21752857142857143,0.19235714285714287,8
1740,160000,0,1,1,37,0,0,0,0,0,0,16750,9715,5140,5379,3183,5120,1100,1500,1500,1000,2000,4000,1,15650,8215,3640,4379,1183,1120,0.0978125,0.05134375,0.02275,0.02736875,0.00739375,0.007,0
1741,160000,1,2,1,51,2,0,0,0,2,0,65312,67610,69908,78087,75255,78593,4000,4000,10000,0,5000,3000,1,61312,63610,59908,78087,70255,75593,0.3832,0.3975625,0.374425,0.48804375,0.43909375,0.47245625,4
1742,460000,1,1,1,37,1,2,0,0,0,0,268775,262956,268463,273066,278594,284423,0,9737,9060,9200,9480,9627,1,268775,253219,259403,263866,269114,274796,0.5842934782608695,0.5504760869565217,0.5639195652173913,0.5736217391304348,0.5850304347826087,0.5973826086956522,3
1743,50000,1,1,2,24,1,2,2,0,0,2,50789,52158,51051,50959,51121,49344,2500,0,2100,3500,0,2000,0,48289,52158,48951,47459,51121,47344,0.96578,1.04316,0.97902,0.94918,1.02242,0.94688,7
1744,150000,1,1,1,33,1,-1,-1,-1,0,0,-3,350,0,863,863,0,353,0,863,0,0,0,1,-356,350,-863,863,863,0,-0.002373333333333333,0.0023333333333333335,-0.005753333333333333,0.005753333333333333,0.005753333333333333,0.0,-2
1745,50000,1,1,1,39,1,-1,-1,-1,-1,-2,0,13030,0,4402,0,0,13030,0,4402,0,0,0,1,-13030,13030,-4402,4402,0,0,-0.2606,0.2606,-0.08804,0.08804,0.0,0.0,-5
1746,10000,1,2,2,46,0,0,2,2,3,2,2496,4245,4525,5450,5073,4843,1800,500,1000,0,0,800,0,696,3745,3525,5450,5073,4043,0.0696,0.3745,0.3525,0.545,0.5073,0.4043,9
1747,70000,1,2,2,38,1,2,2,2,2,2,21047,22102,22949,23275,23596,23078,1700,1500,1000,1000,0,2100,0,19347,20602,21949,22275,23596,20978,0.2763857142857143,0.2943142857142857,0.31355714285714287,0.3182142857142857,0.33708571428571427,0.2996857142857143,11
1748,300000,0,2,1,45,1,-1,0,0,0,0,114324,238058,236220,233586,234661,233304,244500,8613,8000,11000,8093,6399,1,-130176,229445,228220,222586,226568,226905,-0.43392,0.7648166666666667,0.7607333333333334,0.7419533333333334,0.7552266666666667,0.75635,0
1749,200000,1,2,1,31,-1,2,-1,-1,-1,-1,3850,2025,1926,3263,1580,16874,6,1931,3267,7,17894,2508,1,3844,94,-1341,3256,-16314,14366,0.01922,0.00047,-0.006705,0.01628,-0.08157,0.07183,-3
1750,60000,1,2,1,38,7,6,5,4,3,2,126220,76247,72225,67850,63073,61761,0,880,528,0,0,2380,1,126220,75367,71697,67850,63073,59381,2.103666666666667,1.2561166666666668,1.19495,1.1308333333333334,1.0512166666666667,0.9896833333333334,27
1751,300000,1,1,2,28,0,0,0,0,-1,0,4553,4042,2060,0,78794,80385,1033,1000,0,78794,2900,3000,0,3520,3042,2060,-78794,75894,77385,0.011733333333333333,0.01014,0.006866666666666667,-0.26264666666666664,0.25298,0.25795,-1
1752,50000,1,2,2,42,0,0,0,0,0,0,51521,46015,15057,19825,4264,3690,1451,13609,13327,250,1000,700,0,50070,32406,1730,19575,3264,2990,1.0014,0.64812,0.0346,0.3915,0.06528,0.0598,0
1753,330000,1,1,1,42,-1,-1,-1,-1,-1,-1,899,7445,0,3899,2707,8000,7448,0,3899,2707,8000,0,1,-6549,7445,-3899,1192,-5293,8000,-0.019845454545454545,0.022560606060606062,-0.011815151515151515,0.003612121212121212,-0.01603939393939394,0.024242424242424242,-6
1754,170000,0,4,2,28,0,0,0,0,0,0,169763,166286,162330,110034,97018,96056,6300,8138,4206,3366,3421,3642,0,163463,158148,158124,106668,93597,92414,0.9615470588235294,0.9302823529411764,0.9301411764705882,0.6274588235294117,0.5505705882352941,0.5436117647058823,0
1755,210000,1,2,2,38,-1,-1,-1,-1,-1,-1,1026,3751,4366,5602,21034,1026,3751,4366,5602,21034,1026,1026,0,-2725,-615,-1236,-15432,20008,0,-0.012976190476190476,-0.0029285714285714284,-0.005885714285714286,-0.07348571428571428,0.09527619047619047,0.0,-6
1756,130000,0,2,2,28,0,0,0,0,0,0,101546,88549,74624,76133,77648,79370,3000,2709,2750,2767,2961,2913,0,98546,85840,71874,73366,74687,76457,0.7580461538461538,0.6603076923076923,0.552876923076923,0.5643538461538462,0.5745153846153846,0.5881307692307692,0
1757,480000,1,2,1,38,0,0,0,0,0,0,90258,76099,56776,37484,37906,18387,30000,1708,1292,1010,772,705,1,60258,74391,55484,36474,37134,17682,0.1255375,0.15498125,0.11559166666666666,0.0759875,0.0773625,0.0368375,0
1758,260000,0,1,2,28,1,-1,-1,-1,-1,-1,-1197,37785,3780,3202,3754,848,40000,3780,3202,4000,848,5795,0,-41197,34005,578,-798,2906,-4947,-0.15845,0.13078846153846155,0.002223076923076923,-0.0030692307692307694,0.011176923076923077,-0.019026923076923077,-4
1759,210000,1,2,2,27,0,0,0,0,0,0,46066,38952,29735,15381,12475,10535,1951,3034,3000,3000,3000,92,0,44115,35918,26735,12381,9475,10443,0.21007142857142858,0.17103809523809524,0.12730952380952382,0.058957142857142854,0.04511904761904762,0.04972857142857143,0
1760,500000,0,1,2,32,0,-1,0,0,0,-1,18290,25287,24385,18168,4469,27796,25287,1037,363,89,27796,8000,0,-6997,24250,24022,18079,-23327,19796,-0.013994,0.0485,0.048044,0.036158,-0.046654,0.039592,-2
1761,120000,0,1,1,45,0,0,0,0,0,2,117775,117106,118207,116885,123040,120546,5700,6000,5000,10000,0,4500,1,112075,111106,113207,106885,123040,116046,0.9339583333333333,0.9258833333333333,0.9433916666666666,0.8907083333333333,1.0253333333333334,0.96705,2
1762,170000,0,2,2,32,1,-2,-1,2,2,-2,-1000,-1000,1000,1000,0,0,0,2000,0,0,0,0,0,-1000,-3000,1000,1000,0,0,-0.0058823529411764705,-0.01764705882352941,0.0058823529411764705,0.0058823529411764705,0.0,0.0,0
1763,50000,0,2,1,47,0,0,0,0,0,0,11325,12335,13431,14439,14602,14918,1504,1600,1537,700,700,600,1,9821,10735,11894,13739,13902,14318,0.19642,0.2147,0.23788,0.27478,0.27804,0.28636,0
1764,150000,1,2,1,34,0,0,0,0,0,0,146661,142118,139750,142730,144083,130791,6800,6600,6800,5600,4900,5100,1,139861,135518,132950,137130,139183,125691,0.9324066666666667,0.9034533333333333,0.8863333333333333,0.9142,0.9278866666666666,0.83794,0
1765,150000,1,2,1,38,-2,-2,-2,-2,-2,-2,6829,6460,17154,2729,32550,8509,6719,27654,2729,32550,11467,6943,1,110,-21194,14425,-29821,21083,1566,0.0007333333333333333,-0.14129333333333333,0.09616666666666666,-0.19880666666666666,0.14055333333333334,0.01044,-12
1766,10000,0,2,2,25,0,0,0,0,0,0,5378,6482,7308,5736,6236,-764,1200,1000,115,500,180,5000,0,4178,5482,7193,5236,6056,-5764,0.4178,0.5482,0.7193,0.5236,0.6056,-0.5764,0
1767,60000,0,2,2,33,1,-2,-2,-2,-2,-1,-64,-64,-64,-64,-64,16759,0,0,0,0,17000,13000,0,-64,-64,-64,-64,-17064,3759,-0.0010666666666666667,-0.0010666666666666667,-0.0010666666666666667,-0.0010666666666666667,-0.2844,0.06265,-8
1768,30000,1,1,2,25,1,-2,-2,-2,-2,-2,0,0,0,0,0,0,0,0,0,0,0,0,0,0,0,0,0,0,0,0.0,0.0,0.0,0.0,0.0,0.0,-9
1769,200000,1,2,2,34,0,0,0,-2,-2,-2,19252,10000,0,0,0,0,1000,0,0,0,0,0,0,18252,10000,0,0,0,0,0.09126,0.05,0.0,0.0,0.0,0.0,-6
1770,120000,0,1,1,41,0,0,0,0,0,-1,115467,54921,56542,58023,17421,105771,2000,2500,2800,1000,109000,4200,1,113467,52421,53742,57023,-91579,101571,0.9455583333333333,0.4368416666666667,0.44785,0.4751916666666667,-0.7631583333333334,0.846425,-1
1771,50000,0,3,1,42,0,0,0,0,0,0,50708,44610,44043,28557,27903,29164,1872,1566,983,1027,3000,999,1,48836,43044,43060,27530,24903,28165,0.97672,0.86088,0.8612,0.5506,0.49806,0.5633,0
1772,50000,0,2,1,49,0,0,0,0,0,0,28788,21485,18800,17272,14226,14991,1377,1500,500,2000,1000,2000,1,27411,19985,18300,15272,13226,12991,0.54822,0.3997,0.366,0.30544,0.26452,0.25982,0
1773,240000,1,1,1,44,-2,-2,-2,-2,-2,-2,2771,4756,3496,4708,1522,2407,4756,3496,4708,1522,2407,1576,1,-1985,1260,-1212,3186,-885,831,-0.008270833333333333,0.00525,-0.00505,0.013275,-0.0036875,0.0034625,-12
1774,190000,1,2,1,52,-2,-2,-1,-1,-1,-1,175,1547,6101,4803,5039,0,1547,6101,4803,5039,0,0,1,-1372,-4554,1298,-236,5039,0,-0.0072210526315789475,-0.02396842105263158,0.006831578947368421,-0.0012421052631578946,0.02652105263157895,0.0,-8
1775,50000,0,3,1,46,1,2,2,2,2,2,10960,10487,13108,12601,13391,14027,0,2800,0,1000,1000,0,1,10960,7687,13108,11601,12391,14027,0.2192,0.15374,0.26216,0.23202,0.24782,0.28054,11
1776,500000,1,2,2,23,4,3,2,0,0,0,507726,509229,499936,505507,484612,419643,10000,0,14000,16500,16000,19000,0,497726,509229,485936,489007,468612,400643,0.995452,1.018458,0.971872,0.978014,0.937224,0.801286,9
1777,70000,1,1,2,38,0,0,0,0,0,0,63455,54722,56062,82305,42308,40507,2057,2322,1631,2942,1783,1723,0,61398,52400,54431,79363,40525,38784,0.8771142857142857,0.7485714285714286,0.7775857142857143,1.133757142857143,0.5789285714285715,0.5540571428571428,0
1778,50000,1,2,2,34,-2,-2,-2,-2,-2,-2,588,592,390,390,280,720,592,390,390,280,913,390,0,-4,202,0,110,-633,330,-8e-05,0.00404,0.0,0.0022,-0.01266,0.0066,-12
1779,320000,0,1,1,44,-2,-2,-2,-2,-2,-2,14075,6813,13482,2975,2029,888,6818,13482,2975,2029,888,1332,1,7257,-6669,10507,946,1141,-444,0.022678125,-0.020840625,0.032834375,0.00295625,0.003565625,-0.0013875,-12
1780,130000,0,2,1,50,0,0,2,0,0,2,122079,127725,129558,126907,99773,98086,7700,6000,5800,5800,2895,400,1,114379,121725,123758,121107,96878,97686,0.8798384615384616,0.9363461538461538,0.9519846153846154,0.9315923076923077,0.7452153846153846,0.7514307692307692,4
1781,340000,1,3,2,27,1,2,0,0,0,0,29221,14802,153697,153381,143426,139945,12,145000,5055,5017,5059,7382,0,29209,-130198,148642,148364,138367,132563,0.08590882352941176,-0.38293529411764704,0.43718235294117647,0.43636470588235293,0.40696176470588236,0.38989117647058824,3
1782,310000,1,2,1,40,-2,-2,-2,-2,-2,-2,3268,206,589,1594,28252,15081,206,589,1594,28252,18381,4100,1,3062,-383,-1005,-26658,9871,10981,0.009877419354838709,-0.0012354838709677418,-0.0032419354838709676,-0.08599354838709677,0.031841935483870966,0.03542258064516129,-12
1783,140000,1,1,1,45,-1,-1,-1,-1,-1,-1,316,316,316,316,632,150,316,316,316,632,150,316,1,0,0,0,-316,482,-166,0.0,0.0,0.0,-0.0022571428571428573,0.003442857142857143,-0.0011857142857142858,-6
1784,20000,0,1,2,26,0,-1,-1,-1,-1,-1,1490,3150,10464,0,1690,18156,3150,10464,0,1690,18156,19800,0,-1660,-7314,10464,-1690,-16466,-1644,-0.083,-0.3657,0.5232,-0.0845,-0.8233,-0.0822,-5
1785,20000,1,2,1,24,1,2,3,2,0,0,19242,21821,21197,20400,20000,20000,3200,0,0,0,0,0,1,16042,21821,21197,20400,20000,20000,0.8021,1.09105,1.05985,1.02,1.0,1.0,8
1786,350000,1,1,2,24,2,2,0,0,2,0,86342,84103,86179,91608,86705,90208,0,3500,6800,0,5100,105000,0,86342,80603,79379,91608,81605,-14792,0.24669142857142856,0.2302942857142857,0.22679714285714286,0.26173714285714283,0.23315714285714287,-0.042262857142857144,6
1787,30000,1,1,2,27,1,2,0,0,2,0,28686,27620,28164,30444,29887,29153,0,2000,3000,0,1000,1000,0,28686,25620,25164,30444,28887,28153,0.9562,0.854,0.8388,1.0148,0.9629,0.9384333333333333,5
1788,50000,1,2,1,30,0,0,0,0,0,0,40596,41632,42687,40614,29356,29815,2000,2047,3246,1164,1048,1100,1,38596,39585,39441,39450,28308,28715,0.77192,0.7917,0.78882,0.789,0.56616,0.5743,0
1789,100000,1,2,2,27,3,2,0,0,-1,-1,104489,101123,101600,17046,1075,1442,0,4384,341,1075,1442,1396,0,104489,96739,101259,15971,-367,46,1.04489,0.96739,1.01259,0.15971,-0.00367,0.00046,3
1790,210000,0,2,2,29,0,0,0,0,0,0,118905,118620,78297,36137,33264,29493,5000,4000,2000,2000,2000,2000,0,113905,114620,76297,34137,31264,27493,0.542404761904762,0.5458095238095239,0.3633190476190476,0.16255714285714284,0.14887619047619047,0.13091904761904763,0
1791,80000,1,3,1,29,0,0,0,0,0,0,15008,17434,19145,21807,24442,27038,3000,2000,3000,3000,3000,1000,1,12008,15434,16145,18807,21442,26038,0.1501,0.192925,0.2018125,0.2350875,0.268025,0.325475,0
1792,50000,1,2,2,22,0,0,0,0,0,0,51417,48260,43889,35324,24146,22914,2054,1981,1344,810,828,824,0,49363,46279,42545,34514,23318,22090,0.98726,0.92558,0.8509,0.69028,0.46636,0.4418,0
1793,130000,0,2,2,36,0,0,0,0,0,-1,91016,36706,19802,11515,4261,45718,1848,1394,1015,99,47657,1681,0,89168,35312,18787,11416,-43396,44037,0.6859076923076923,0.27163076923076923,0.14451538461538463,0.08781538461538461,-0.3338153846153846,0.33874615384615386,-1
1794,70000,1,1,2,29,0,0,0,0,0,0,66648,66638,57404,33045,30137,21832,3000,5137,968,2500,6000,5000,0,63648,61501,56436,30545,24137,16832,0.9092571428571429,0.8785857142857143,0.8062285714285714,0.43635714285714283,0.34481428571428574,0.24045714285714287,0
1795,320000,1,2,2,34,0,0,-1,-1,-1,-1,1800,0,312,311,311,8571,0,312,311,311,8571,4204,0,1800,-312,1,0,-8260,4367,0.005625,-0.000975,3.125e-06,0.0,-0.0258125,0.013646875,-4
1796,70000,1,1,2,23,-1,-1,-1,-1,-1,-1,853,3128,4719,100,1610,690,3128,4722,0,1610,0,10909,0,-2275,-1594,4719,-1510,1610,-10219,-0.0325,-0.02277142857142857,0.06741428571428572,-0.02157142857142857,0.023,-0.14598571428571427,-6
1797,170000,1,2,2,47,0,0,0,0,0,0,62927,36885,34289,31518,31338,31838,1566,1606,1325,1015,10000,1111,0,61361,35279,32964,30503,21338,30727,0.3609470588235294,0.20752352941176472,0.19390588235294118,0.1794294117647059,0.12551764705882354,0.1807470588235294,0
1798,20000,1,1,2,29,1,-1,-1,-1,-1,-1,0,2494,3967,1364,600,0,2494,3967,1370,600,0,0,0,-2494,-1473,2597,764,600,0,-0.1247,-0.07365,0.12985,0.0382,0.03,0.0,-4
1799,470000,1,2,1,35,0,0,0,0,0,0,64875,57920,59307,61500,59563,57368,2505,3000,3016,2200,3000,1600,1,62370,54920,56291,59300,56563,55768,0.13270212765957448,0.11685106382978723,0.11976808510638298,0.12617021276595744,0.1203468085106383,0.11865531914893616,0
1800,50000,1,1,2,36,1,2,2,2,2,2,29003,29244,30827,31224,30587,32763,1000,2363,1200,0,2700,1157,0,28003,26881,29627,31224,27887,31606,0.56006,0.53762,0.59254,0.62448,0.55774,0.63212,11
1801,10000,1,2,1,31,0,0,0,0,0,0,15915,9050,9901,9975,9736,8703,2330,2200,1000,333,311,322,1,13585,6850,8901,9642,9425,8381,1.3585,0.685,0.8901,0.9642,0.9425,0.8381,0
1802,80000,0,1,2,28,-2,-2,-2,-2,-2,-2,8598,9467,-270,3697,9455,4144,9467,0,3967,9455,5000,2900,0,-869,9467,-4237,-5758,4455,1244,-0.0108625,0.1183375,-0.0529625,-0.071975,0.0556875,0.01555,-12
1803,20000,0,2,2,24,0,0,0,0,0,0,17850,15528,13597,14088,13723,16318,2019,2000,1003,1000,3000,2000,0,15831,13528,12594,13088,10723,14318,0.79155,0.6764,0.6297,0.6544,0.53615,0.7159,0
1804,60000,1,1,2,23,0,0,0,0,0,0,21972,24612,16711,8549,7635,12258,3126,1392,5033,3601,5200,3647,0,18846,23220,11678,4948,2435,8611,0.3141,0.387,0.19463333333333332,0.08246666666666666,0.04058333333333333,0.14351666666666665,0
1805,240000,1,2,1,28,1,2,2,2,0,0,210333,206332,214981,194817,186895,168541,0,12014,0,5307,5001,4505,1,210333,194318,214981,189510,181894,164036,0.8763875,0.8096583333333334,0.8957541666666666,0.789625,0.7578916666666666,0.6834833333333333,7
1806,240000,1,2,1,32,-1,-1,-1,-1,-1,-1,4101,7101,5500,5500,5500,5463,8500,5500,5500,5500,5463,5500,1,-4399,1601,0,0,37,-37,-0.018329166666666667,0.006670833333333333,0.0,0.0,0.00015416666666666666,-0.00015416666666666666,-6
1807,80000,0,3,2,26,1,2,2,2,2,2,71661,69947,74755,75732,74397,80138,0,6000,2800,0,7000,8,0,71661,63947,71955,75732,67397,80130,0.8957625,0.7993375,0.8994375,0.94665,0.8424625,1.001625,11
1808,160000,1,2,1,29,0,0,0,2,0,0,6252,5073,6854,3759,3164,3000,4000,2230,0,16,16,81,1,2252,2843,6854,3743,3148,2919,0.014075,0.01776875,0.0428375,0.02339375,0.019675,0.01824375,2
1809,260000,1,2,1,35,-1,-1,-1,-1,0,-1,213,213,203,2571,187,5469,214,204,2582,1,5496,427,1,-1,9,-2379,2570,-5309,5042,-3.846153846153846e-06,3.461538461538462e-05,-0.00915,0.009884615384615384,-0.02041923076923077,0.01939230769230769,-5
1810,410000,1,1,2,34,1,-1,-1,-2,-2,-1,0,13621,0,0,0,666,13621,0,0,0,666,0,0,-13621,13621,0,0,-666,666,-0.03322195121951219,0.03322195121951219,0.0,0.0,-0.0016243902439024391,0.0016243902439024391,-6
1811,180000,0,2,2,24,-2,-2,-2,-2,-1,2,2294,1290,2109,600,476,326,1296,2120,901,476,0,326,0,998,-830,1208,124,476,0,0.005544444444444445,-0.004611111111111111,0.006711111111111111,0.0006888888888888888,0.0026444444444444445,0.0,-7
1812,310000,1,3,1,53,-2,-2,-2,-2,-2,-2,1126,2603,-6,1184,7883,193,2635,0,1190,7909,193,3189,1,-1509,2603,-1196,-6725,7690,-2996,-0.004867741935483871,0.008396774193548387,-0.0038580645161290323,-0.021693548387096775,0.024806451612903225,-0.009664516129032259,-12
1813,10000,0,4,2,47,0,0,0,-1,-1,-1,7968,8800,0,2640,695,738,1000,0,2640,695,738,0,0,6968,8800,-2640,1945,-43,738,0.6968,0.88,-0.264,0.1945,-0.0043,0.0738,-3
1814,50000,1,2,2,23,0,0,0,0,2,0,48409,39572,16922,19319,17644,18209,1605,1603,3000,0,1000,1000,0,46804,37969,13922,19319,16644,17209,0.93608,0.75938,0.27844,0.38638,0.33288,0.34418,2
1815,50000,1,1,2,22,0,0,0,0,0,0,8537,9591,10581,10818,11050,10880,1200,1163,400,790,400,380,0,7337,8428,10181,10028,10650,10500,0.14674,0.16856,0.20362,0.20056,0.213,0.21,0
1816,110000,1,2,2,29,0,0,0,0,0,0,113003,113269,110078,112466,111094,109243,5837,5454,5707,4156,4123,4368,0,107166,107815,104371,108310,106971,104875,0.9742363636363637,0.9801363636363636,0.9488272727272727,0.9846363636363636,0.9724636363636364,0.9534090909090909,0
1817,250000,1,3,2,36,-1,0,0,0,0,0,44242,58876,73068,102311,75543,88283,25000,24000,30000,25000,30000,25000,0,19242,34876,43068,77311,45543,63283,0.076968,0.139504,0.172272,0.309244,0.182172,0.253132,-1
1818,350000,1,1,2,31,0,0,0,0,0,2,181550,177978,164481,198545,232543,165288,10000,20000,100048,60000,0,5000,0,171550,157978,64433,138545,232543,160288,0.49014285714285716,0.45136571428571426,0.1840942857142857,0.39584285714285716,0.6644085714285715,0.4579657142857143,2
1819,10000,0,2,1,28,0,0,0,0,0,0,1474,2641,3745,4642,5642,6342,1196,1300,1000,1000,700,1208,1,278,1341,2745,3642,4942,5134,0.0278,0.1341,0.2745,0.3642,0.4942,0.5134,0
1820,250000,1,2,2,24,2,0,0,0,0,0,69770,70954,70681,69497,41367,17004,3562,1914,1517,2000,8001,295,0,66208,69040,69164,67497,33366,16709,0.264832,0.27616,0.276656,0.269988,0.133464,0.066836,2
1821,250000,1,2,1,29,-1,-1,-1,0,0,0,390,0,49140,32699,32949,34150,0,49140,1596,5000,2000,1800,1,390,-49140,47544,27699,30949,32350,0.00156,-0.19656,0.190176,0.110796,0.123796,0.1294,-3
1822,50000,1,3,2,30,0,0,0,0,0,0,48134,52136,19758,5520,5204,4703,5261,1132,2138,172,200,168,0,42873,51004,17620,5348,5004,4535,0.85746,1.02008,0.3524,0.10696,0.10008,0.0907,0
1823,130000,1,2,1,40,0,0,0,0,0,0,133559,129869,118032,95953,73970,107785,5400,6950,4600,4000,2000,2300,1,128159,122919,113432,91953,71970,105485,0.9858384615384616,0.9455307692307693,0.8725538461538461,0.7073307692307692,0.5536153846153846,0.8114230769230769,0
1824,200000,0,1,1,30,2,2,2,2,2,2,2500,2500,2500,2500,2500,2500,0,0,0,0,0,0,1,2500,2500,2500,2500,2500,2500,0.0125,0.0125,0.0125,0.0125,0.0125,0.0125,12
1825,400000,0,1,1,49,-2,-2,-2,-2,-2,-2,749,1503,33956,44258,56526,776,1530,34229,44258,56526,776,2131,1,-781,-32726,-10302,-12268,55750,-1355,-0.0019525,-0.081815,-0.025755,-0.03067,0.139375,-0.0033875,-12
1826,330000,1,1,2,34,0,0,0,0,0,0,173630,178833,187820,190202,194964,199008,8000,12000,7000,8000,7287,7400,0,165630,166833,180820,182202,187677,191608,0.5019090909090909,0.5055545454545455,0.547939393939394,0.5521272727272727,0.5687181818181818,0.580630303030303,0
1827,210000,1,1,2,35,-2,-2,-2,-2,-2,-2,0,0,0,820,0,0,0,0,820,0,0,0,0,0,0,-820,820,0,0,0.0,0.0,-0.003904761904761905,0.003904761904761905,0.0,0.0,-12
1828,20000,0,3,2,38,0,0,0,0,-1,-1,11805,12186,9331,6927,12457,8900,1400,1023,0,12469,598,1,0,10405,11163,9331,-5542,11859,8899,0.52025,0.55815,0.46655,-0.2771,0.59295,0.44495,-2
1829,190000,0,3,2,35,0,0,0,0,0,0,170928,170290,175630,171572,161319,151119,6500,8031,7510,5500,6000,5500,0,164428,162259,168120,166072,155319,145619,0.8654105263157895,0.8539947368421053,0.8848421052631579,0.8740631578947369,0.8174684210526316,0.7664157894736842,0
1830,310000,1,3,1,37,-2,-2,-2,-2,-2,-2,4052,6514,-3484,-3484,-3484,13833,6514,0,0,0,17317,0,1,-2462,6514,-3484,-3484,-20801,13833,-0.007941935483870968,0.021012903225806453,-0.011238709677419354,-0.011238709677419354,-0.0671,0.04462258064516129,-12
1831,150000,1,2,1,37,0,0,0,0,0,0,40680,44960,45976,46890,47873,48833,4960,1765,1679,1739,1757,1795,1,35720,43195,44297,45151,46116,47038,0.23813333333333334,0.28796666666666665,0.2953133333333333,0.30100666666666664,0.30744,0.3135866666666667,0
1832,300000,1,3,2,31,0,0,0,0,0,0,92235,67283,65059,147613,236687,237105,4505,6039,100000,100000,8600,8500,0,87730,61244,-34941,47613,228087,228605,0.2924333333333333,0.20414666666666667,-0.11647,0.15871,0.76029,0.7620166666666667,0
1833,180000,1,1,2,30,-2,-2,-2,-2,-2,-1,1490,3687,1352,960,4921,3031,3687,1352,960,4921,3031,2718,0,-2197,2335,392,-3961,1890,313,-0.012205555555555556,0.012972222222222222,0.0021777777777777776,-0.022005555555555556,0.0105,0.001738888888888889,-11
1834,30000,1,3,1,39,-1,2,-1,-1,-2,-2,1937,640,1751,0,0,0,0,1751,0,0,0,0,1,1937,-1111,1751,0,0,0,0.06456666666666666,-0.037033333333333335,0.058366666666666664,0.0,0.0,0.0,-5
1835,500000,1,2,1,52,0,0,0,0,0,0,588000,277559,288835,281810,273700,269552,17559,36500,20000,36000,20000,80013,1,570441,241059,268835,245810,253700,189539,1.140882,0.482118,0.53767,0.49162,0.5074,0.379078,0
1836,50000,0,3,1,35,0,0,2,0,0,2,35214,37305,34789,8671,9550,8741,3900,2,500,1000,0,500,1,31314,37303,34289,7671,9550,8241,0.62628,0.74606,0.68578,0.15342,0.191,0.16482,4
1837,100000,1,2,2,30,0,0,0,0,-2,-2,23939,23572,24148,0,0,0,1500,1011,0,0,0,0,0,22439,22561,24148,0,0,0,0.22439,0.22561,0.24148,0.0,0.0,0.0,-4
1838,360000,0,1,2,39,-1,-1,-1,-1,-2,-2,2758,1448,3740,0,0,0,1448,3740,0,0,0,3942,0,1310,-2292,3740,0,0,-3942,0.003638888888888889,-0.006366666666666666,0.010388888888888888,0.0,0.0,-0.01095,-8
1839,610000,1,1,2,31,0,0,0,0,0,0,142764,126606,67887,58397,105301,105965,6540,2100,2150,50000,4700,2000,0,136224,124506,65737,8397,100601,103965,0.22331803278688525,0.20410819672131147,0.1077655737704918,0.013765573770491804,0.16491967213114755,0.1704344262295082,0
1840,280000,0,3,1,32,0,0,0,0,0,0,158798,163164,168543,172083,173850,177469,6000,7000,6762,4880,5050,5100,1,152798,156164,161781,167203,168800,172369,0.5457071428571428,0.5577285714285715,0.5777892857142857,0.5971535714285714,0.6028571428571429,0.6156035714285715,0
1841,440000,1,2,2,25,2,2,0,0,0,0,225416,220405,226731,231456,237707,243555,0,10000,10000,10000,10000,10000,0,225416,210405,216731,221456,227707,233555,0.5123090909090909,0.4781931818181818,0.49257045454545456,0.5033090909090909,0.517515909090909,0.5308068181818182,4
1842,200000,0,2,2,29,2,2,4,4,4,4,2500,2500,2500,2500,2500,2500,0,0,0,0,0,0,0,2500,2500,2500,2500,2500,2500,0.0125,0.0125,0.0125,0.0125,0.0125,0.0125,20
1843,200000,1,2,2,26,0,0,-2,-2,-1,0,153900,0,0,0,3533,4053,0,0,0,3533,1000,1500,0,153900,0,0,-3533,2533,2553,0.7695,0.0,0.0,-0.017665,0.012665,0.012765,-5
1844,20000,0,2,1,32,0,0,0,0,0,0,14662,10305,11127,12928,13721,14492,1500,1300,2000,1000,1000,1000,1,13162,9005,9127,11928,12721,13492,0.6581,0.45025,0.45635,0.5964,0.63605,0.6746,0
1845,280000,0,1,2,31,2,0,0,-1,0,0,278510,279845,0,189841,193313,192742,6996,0,189841,6022,6078,5300,0,271514,279845,-189841,183819,187235,187442,0.9696928571428571,0.9994464285714286,-0.6780035714285715,0.6564964285714285,0.6686964285714285,0.6694357142857142,1
1846,20000,1,3,1,39,2,3,2,2,3,2,15307,14769,15232,16677,16119,16548,0,1000,2000,0,1000,1000,1,15307,13769,13232,16677,15119,15548,0.76535,0.68845,0.6616,0.83385,0.75595,0.7774,14
1847,50000,1,2,1,26,1,-2,-1,0,0,0,0,0,1756,2719,4049,5176,0,1756,1000,1537,1200,2000,1,0,-1756,756,1182,2849,3176,0.0,-0.03512,0.01512,0.02364,0.05698,0.06352,-2
1848,30000,1,2,1,43,2,2,2,2,2,2,15246,17838,17272,18131,17711,19007,3141,0,1434,0,1581,1705,1,12105,17838,15838,18131,16130,17302,0.4035,0.5946,0.5279333333333334,0.6043666666666667,0.5376666666666666,0.5767333333333333,12
1849,180000,1,2,2,25,-1,-1,-1,-1,-1,-1,2984,154,2111,1027,596,589,154,2115,1027,596,589,1115,0,2830,-1961,1084,431,7,-526,0.01572222222222222,-0.010894444444444444,0.006022222222222222,0.0023944444444444443,3.888888888888889e-05,-0.0029222222222222223,-6
1850,230000,1,2,2,27,0,0,0,0,0,0,175050,164054,127369,108702,77703,79123,10000,10000,4000,3000,5000,5000,0,165050,154054,123369,105702,72703,74123,0.7176086956521739,0.6698,0.5363869565217392,0.4595739130434783,0.3161,0.32227391304347824,0
1851,330000,0,2,2,33,0,0,0,0,0,0,137974,138692,141674,136790,141469,143453,7000,7000,5000,7004,6015,5012,0,130974,131692,136674,129786,135454,138441,0.39689090909090907,0.3990666666666667,0.41416363636363634,0.3932909090909091,0.41046666666666665,0.41951818181818185,0
1852,20000,1,2,3,52,0,0,0,0,0,0,14591,15616,16628,16958,17314,17664,1265,1277,607,629,638,641,0,13326,14339,16021,16329,16676,17023,0.6663,0.71695,0.80105,0.81645,0.8338,0.85115,0
1853,50000,1,3,1,42,0,0,0,0,0,0,13562,14821,16657,17863,16811,16802,1500,2500,1518,1000,2000,1000,1,12062,12321,15139,16863,14811,15802,0.24124,0.24642,0.30278,0.33726,0.29622,0.31604,0
1854,150000,1,4,2,33,0,0,0,0,0,0,232327,237150,239410,39584,32815,35626,5877,5419,1009,1120,5000,7128,0,226450,231731,238401,38464,27815,28498,1.5096666666666667,1.5448733333333333,1.58934,0.2564266666666667,0.18543333333333334,0.18998666666666666,0
1855,330000,0,1,1,61,-2,-2,-2,-2,-2,-2,14897,19364,906,2342,1702,882,19364,906,2342,1702,882,1940,1,-4467,18458,-1436,640,820,-1058,-0.013536363636363636,0.055933333333333335,-0.004351515151515151,0.0019393939393939393,0.0024848484848484847,-0.003206060606060606,-12
1856,50000,1,3,1,48,0,0,0,0,0,0,4064,5987,7719,8588,9291,11127,2000,2000,1000,1000,2000,2000,1,2064,3987,6719,7588,7291,9127,0.04128,0.07974,0.13438,0.15176,0.14582,0.18254,0
1857,80000,0,2,2,36,2,2,2,0,0,0,48751,49853,48781,50170,51237,52360,2200,0,2500,2500,2100,2000,0,46551,49853,46281,47670,49137,50360,0.5818875,0.6231625,0.5785125,0.595875,0.6142125,0.6295,6
1858,10000,0,2,2,22,0,0,0,0,0,0,8602,8728,9721,9609,9503,9771,1158,1151,339,344,425,195,0,7444,7577,9382,9265,9078,9576,0.7444,0.7577,0.9382,0.9265,0.9078,0.9576,0
1859,20000,1,1,2,27,-1,-1,-1,0,-1,-1,5888,4088,6597,9333,4133,8456,4813,6597,5000,4431,8500,8032,0,1075,-2509,1597,4902,-4367,424,0.05375,-0.12545,0.07985,0.2451,-0.21835,0.0212,-5
1860,200000,0,1,1,49,2,2,2,2,2,2,2500,2500,2500,2500,2500,2500,0,0,0,0,0,0,1,2500,2500,2500,2500,2500,2500,0.0125,0.0125,0.0125,0.0125,0.0125,0.0125,12
1861,250000,1,2,1,35,1,2,2,2,2,2,196192,191745,205681,200988,217830,223254,0,17000,0,20000,9078,8500,1,196192,174745,205681,180988,208752,214754,0.784768,0.69898,0.822724,0.723952,0.835008,0.859016,11
1862,50000,1,1,1,39,-1,-1,-2,-2,-1,-1,2080,-60,-60,-60,6000,228,0,0,0,6060,228,1911,1,2080,-60,-60,-6120,5772,-1683,0.0416,-0.0012,-0.0012,-0.1224,0.11544,-0.03366,-8
1863,250000,1,2,1,40,0,0,0,0,0,0,121558,126367,130658,79361,81196,83040,6500,7000,4000,3000,3000,4000,1,115058,119367,126658,76361,78196,79040,0.460232,0.477468,0.506632,0.305444,0.312784,0.31616,0
1864,80000,0,1,1,53,0,0,0,0,0,-1,39298,40061,40502,15948,15915,390,1809,2030,1476,833,390,390,1,37489,38031,39026,15115,15525,0,0.4686125,0.4753875,0.487825,0.1889375,0.1940625,0.0,-1
1865,50000,0,2,2,36,4,3,2,0,0,0,51689,50567,48454,49843,51355,29276,3,0,2183,2695,29276,4,0,51686,50567,46271,47148,22079,29272,1.03372,1.01134,0.92542,0.94296,0.44158,0.58544,9
1866,150000,0,4,2,28,0,0,0,0,-1,-1,15855,27241,20818,9864,3957,2205,18056,4065,1058,3976,2216,0,0,-2201,23176,19760,5888,1741,2205,-0.014673333333333333,0.15450666666666665,0.13173333333333334,0.039253333333333335,0.011606666666666666,0.0147,-2
1867,60000,1,2,2,45,0,0,0,0,0,0,57711,58760,49576,50802,11110,12543,2500,2384,3000,2000,2000,2000,0,55211,56376,46576,48802,9110,10543,0.9201833333333334,0.9396,0.7762666666666667,0.8133666666666667,0.15183333333333332,0.17571666666666666,0
1868,30000,0,1,2,25,-1,0,0,0,0,0,1581,2282,2964,3360,5038,4833,1046,1044,1072,1750,182,2000,0,535,1238,1892,1610,4856,2833,0.017833333333333333,0.04126666666666667,0.06306666666666666,0.05366666666666667,0.16186666666666666,0.09443333333333333,-1
1869,30000,0,2,1,36,1,3,2,0,0,0,22327,21696,21054,21315,21623,22261,0,0,908,800,1000,1809,1,22327,21696,20146,20515,20623,20452,0.7442333333333333,0.7232,0.6715333333333333,0.6838333333333333,0.6874333333333333,0.6817333333333333,6
1870,20000,1,2,3,44,3,2,2,7,7,7,2400,2400,2400,2400,2400,2400,0,0,0,0,0,0,0,2400,2400,2400,2400,2400,2400,0.12,0.12,0.12,0.12,0.12,0.12,28
1871,90000,1,1,2,30,2,2,3,3,3,3,750,750,750,750,2450,2150,0,0,0,2000,0,0,0,750,750,750,-1250,2450,2150,0.008333333333333333,0.008333333333333333,0.008333333333333333,-0.013888888888888888,0.02722222222222222,0.02388888888888889,16
1872,100000,0,2,2,31,1,2,2,2,3,2,24377,25167,24541,27304,26669,26172,1400,0,3100,0,0,2000,0,22977,25167,21441,27304,26669,24172,0.22977,0.25167,0.21441,0.27304,0.26669,0.24172,12
1873,20000,0,2,2,22,0,0,0,0,0,0,4341,5356,6376,7382,7375,7531,1245,1265,1271,264,275,900,0,3096,4091,5105,7118,7100,6631,0.1548,0.20455,0.25525,0.3559,0.355,0.33155,0
1874,10000,0,3,1,47,0,0,2,0,0,2,6817,9119,8826,8849,9567,9265,2588,0,318,862,0,502,1,4229,9119,8508,7987,9567,8763,0.4229,0.9119,0.8508,0.7987,0.9567,0.8763,4
1875,240000,1,1,2,30,-2,-2,-2,-2,-2,-2,0,0,9625,8864,9248,23353,0,9625,0,9248,23353,1205,0,0,-9625,9625,-384,-14105,22148,0.0,-0.04010416666666667,0.04010416666666667,-0.0016,-0.058770833333333335,0.09228333333333333,-12
1876,20000,0,2,1,51,0,0,0,0,0,0,14681,14777,15025,16504,17950,19558,1562,1200,2000,2000,2000,3000,1,13119,13577,13025,14504,15950,16558,0.65595,0.67885,0.65125,0.7252,0.7975,0.8279,0
1877,160000,1,2,2,27,0,0,0,0,0,0,80964,80337,82182,82586,85145,87049,4000,4000,3500,4000,4000,2500,0,76964,76337,78682,78586,81145,84549,0.481025,0.47710625,0.4917625,0.4911625,0.50715625,0.52843125,0
1878,410000,1,1,2,25,-1,-1,-1,-1,-1,-1,4151,4357,10513,9137,7781,28870,4357,10513,9137,7781,28870,15000,0,-206,-6156,1376,1356,-21089,13870,-0.0005024390243902439,-0.015014634146341464,0.00335609756097561,0.0033073170731707318,-0.05143658536585366,0.03382926829268293,-6
1879,110000,1,1,2,26,0,0,0,0,0,0,113284,110062,100659,93909,78589,52644,5200,4628,4878,3000,2055,1908,0,108084,105434,95781,90909,76534,50736,0.9825818181818182,0.9584909090909091,0.8707363636363636,0.8264454545454546,0.6957636363636364,0.4612363636363636,0
1880,200000,0,1,1,30,0,0,0,0,0,0,182338,123079,124075,99440,104685,54038,4653,5000,5000,6000,5000,10000,1,177685,118079,119075,93440,99685,44038,0.888425,0.590395,0.595375,0.4672,0.498425,0.22019,0
1881,50000,0,2,1,43,0,0,0,0,0,0,48919,48775,48731,48934,29116,28999,1800,2200,1400,582,580,30000,1,47119,46575,47331,48352,28536,-1001,0.94238,0.9315,0.94662,0.96704,0.57072,-0.02002,0
1882,50000,0,2,2,25,0,0,-1,0,0,-1,27206,0,14805,14699,14999,497,0,14805,294,300,498,1003,0,27206,-14805,14511,14399,14501,-506,0.54412,-0.2961,0.29022,0.28798,0.29002,-0.01012,-2
1883,400000,1,2,2,35,-1,2,-1,-1,-1,2,1908,952,333,4928,8235,3317,0,333,4928,8235,0,1708,0,1908,619,-4595,-3307,8235,1609,0.00477,0.0015475,-0.0114875,-0.0082675,0.0205875,0.0040225,0
1884,300000,1,1,2,26,0,0,0,0,0,0,277680,281719,284381,155562,158448,162626,12005,10155,6000,5000,6000,6000,0,265675,271564,278381,150562,152448,156626,0.8855833333333333,0.9052133333333333,0.9279366666666666,0.5018733333333333,0.50816,0.5220866666666667,0
1885,30000,1,2,2,23,0,0,2,2,2,2,18497,21016,22178,21529,23863,22357,3153,1800,0,3000,0,4255,0,15344,19216,22178,18529,23863,18102,0.5114666666666666,0.6405333333333333,0.7392666666666666,0.6176333333333334,0.7954333333333333,0.6034,8
1886,50000,1,3,1,24,0,0,0,0,0,0,44742,45737,46814,47978,48733,50241,1737,1814,1978,1733,2241,1700,1,43005,43923,44836,46245,46492,48541,0.8601,0.87846,0.89672,0.9249,0.92984,0.97082,0
1887,190000,1,3,1,42,0,0,0,0,0,0,113516,116157,115639,115849,118313,119973,6000,5581,4237,4423,5000,8888,1,107516,110576,111402,111426,113313,111085,0.5658736842105263,0.581978947368421,0.5863263157894737,0.5864526315789473,0.5963842105263157,0.5846578947368422,0
1888,360000,0,1,1,29,0,0,0,0,0,-1,55104,52585,45914,8835,3421,2391,2094,1760,204,17,2403,0,1,53010,50825,45710,8818,1018,2391,0.14725,0.14118055555555556,0.1269722222222222,0.024494444444444444,0.0028277777777777776,0.006641666666666666,-1
1889,40000,0,2,2,24,4,3,2,3,2,2,38344,37433,38862,39125,39408,40925,0,2335,1200,1225,2300,1396,0,38344,35098,37662,37900,37108,39529,0.9586,0.87745,0.94155,0.9475,0.9277,0.988225,16
1890,200000,1,1,1,32,1,-2,-2,-2,-2,-1,0,0,0,0,0,900,0,0,0,0,900,880,1,0,0,0,0,-900,20,0.0,0.0,0.0,0.0,-0.0045,0.0001,-8
1891,20000,0,2,2,27,0,0,-1,-1,0,0,7320,7761,631,4481,6481,3465,2000,631,4481,2000,300,3332,0,5320,7130,-3850,2481,6181,133,0.266,0.3565,-0.1925,0.12405,0.30905,0.00665,-2
1892,280000,1,2,2,30,0,0,-1,0,0,0,21489,-86,4414,64183,61001,60601,5,4500,60000,1244,2000,4000,0,21484,-4586,-55586,62939,59001,56601,0.07672857142857142,-0.01637857142857143,-0.19852142857142857,0.22478214285714285,0.21071785714285715,0.20214642857142856,-1
1893,50000,0,2,2,31,0,0,0,-1,0,0,8673,10957,17187,6377,6370,1910,5011,10000,10000,6000,0,3000,0,3662,957,7187,377,6370,-1090,0.07324,0.01914,0.14374,0.00754,0.1274,-0.0218,-1
1894,390000,0,3,1,49,0,0,0,0,0,0,282849,281836,284397,284241,285615,282611,12000,13000,12000,12000,10266,9800,1,270849,268836,272397,272241,275349,272811,0.6944846153846154,0.6893230769230769,0.6984538461538462,0.6980538461538461,0.706023076923077,0.6995153846153846,0
1895,100000,0,2,2,43,0,0,0,0,0,0,47730,47525,47184,46836,46529,47070,1808,1728,1641,1673,1689,1754,0,45922,45797,45543,45163,44840,45316,0.45922,0.45797,0.45543,0.45163,0.4484,0.45316,0
1896,200000,0,1,2,32,-1,-1,-1,-1,-1,2,5494,19614,628,628,1604,668,19614,628,628,1604,0,168,0,-14120,18986,0,-976,1604,500,-0.0706,0.09493,0.0,-0.00488,0.00802,0.0025,-3
1897,60000,1,2,2,31,2,0,0,0,2,2,19921,20993,21736,23172,22661,24087,1700,1400,1800,0,1800,0,0,18221,19593,19936,23172,20861,24087,0.30368333333333336,0.32655,0.33226666666666665,0.3862,0.34768333333333334,0.40145,6
1898,500000,1,2,1,32,-1,0,0,-1,-1,-2,26455,12229,989,2008,-59,11835,7060,1003,2018,59,11894,2,1,19395,11226,-1029,1949,-11953,11833,0.03879,0.022452,-0.002058,0.003898,-0.023906,0.023666,-5
1899,240000,1,2,2,31,-1,-1,-1,-1,-1,-1,7414,2020,-9032,13756,0,3138,2020,1000,23724,0,3138,367,0,5394,1020,-32756,13756,-3138,2771,0.022475,0.00425,-0.13648333333333335,0.05731666666666667,-0.013075,0.011545833333333333,-6
1900,110000,1,1,2,32,-1,0,0,0,0,0,3610,15427,19563,21994,21994,8391,12000,5000,3000,3000,2000,1000,0,-8390,10427,16563,18994,19994,7391,-0.07627272727272727,0.09479090909090909,0.15057272727272727,0.17267272727272728,0.18176363636363638,0.06719090909090909,-1
1901,280000,0,1,1,37,-1,0,0,0,0,0,33687,21575,23926,23102,22734,29434,5000,3000,10000,10000,16934,10234,1,28687,18575,13926,13102,5800,19200,0.10245357142857144,0.06633928571428571,0.049735714285714286,0.04679285714285714,0.020714285714285713,0.06857142857142857,-1
1902,280000,0,1,1,34,0,0,0,0,0,0,188698,353481,152132,138990,136778,137641,6337,6000,4974,5041,5215,7000,1,182361,347481,147158,133949,131563,130641,0.6512892857142857,1.2410035714285714,0.5255642857142857,0.47838928571428574,0.46986785714285717,0.466575,0
1903,440000,0,1,1,54,-1,-1,-1,-1,0,0,8517,0,241,8544,1361,855,0,241,8598,857,4,2227,1,8517,-241,-8357,7687,1357,-1372,0.019356818181818183,-0.0005477272727272728,-0.01899318181818182,0.017470454545454546,0.003084090909090909,-0.003118181818181818,-4
1904,130000,1,2,2,28,2,0,0,0,0,0,7964,8976,9998,11007,11226,11460,1152,1174,1183,402,415,418,0,6812,7802,8815,10605,10811,11042,0.0524,0.060015384615384616,0.0678076923076923,0.08157692307692307,0.08316153846153847,0.08493846153846153,2
1905,110000,0,3,2,26,0,0,0,0,0,0,10183,11971,8164,10895,13503,16227,2000,2000,3000,3000,3000,2000,0,8183,9971,5164,7895,10503,14227,0.07439090909090909,0.09064545454545454,0.04694545454545455,0.07177272727272727,0.09548181818181818,0.12933636363636364,0
1906,370000,0,1,1,40,1,-2,-2,-2,-2,-2,0,0,0,0,0,0,0,0,0,0,0,0,1,0,0,0,0,0,0,0.0,0.0,0.0,0.0,0.0,0.0,-9
1907,60000,0,3,1,46,0,0,0,0,0,0,56869,57976,54398,46937,19085,19506,2110,2131,2010,1000,1000,1000,1,54759,55845,52388,45937,18085,18506,0.91265,0.93075,0.8731333333333333,0.7656166666666666,0.30141666666666667,0.30843333333333334,0
1908,240000,1,1,2,36,1,-1,0,0,0,0,0,18000,18485,17406,19345,21134,18000,2000,2000,2000,3000,2000,0,-18000,16000,16485,15406,16345,19134,-0.075,0.06666666666666667,0.0686875,0.06419166666666666,0.06810416666666666,0.079725,0
1909,200000,0,1,2,26,0,0,-1,0,0,-2,14335,12452,4467,3285,0,0,1213,4467,1000,0,0,0,0,13122,7985,3467,3285,0,0,0.06561,0.039925,0.017335,0.016425,0.0,0.0,-3
1910,380000,0,1,1,37,0,0,0,0,0,0,173252,113001,74275,47723,67463,36751,10069,12712,10000,20000,16751,29000,1,163183,100289,64275,27723,50712,7751,0.4294289473684211,0.2639184210526316,0.16914473684210526,0.07295526315789473,0.13345263157894738,0.020397368421052633,0
1911,360000,0,3,1,56,-1,-1,-1,-1,-1,-1,22000,7746,1198,2087,1026,1026,7772,1198,2097,1026,1026,1019,1,14228,6548,-899,1061,0,7,0.03952222222222222,0.01818888888888889,-0.0024972222222222223,0.002947222222222222,0.0,1.9444444444444445e-05,-6
1912,160000,0,2,1,59,-1,-1,-1,-1,-1,-1,1443,1443,1443,1443,1443,1443,1443,1443,1443,1443,1443,1443,1,0,0,0,0,0,0,0.0,0.0,0.0,0.0,0.0,0.0,-6
1913,210000,0,3,2,28,0,0,0,0,0,0,58340,58644,59855,61013,61097,65089,2107,3000,3000,2500,6000,8000,0,56233,55644,56855,58513,55097,57089,0.2677761904761905,0.2649714285714286,0.2707380952380952,0.27863333333333334,0.2623666666666667,0.27185238095238096,0
1914,180000,1,1,1,35,0,0,0,0,0,0,104335,108156,108874,111568,113817,116422,5500,4000,4500,4200,4500,4500,1,98835,104156,104374,107368,109317,111922,0.5490833333333334,0.5786444444444444,0.5798555555555556,0.5964888888888888,0.6073166666666666,0.6217888888888888,0
1915,210000,1,1,2,30,1,-2,-2,-1,-1,-1,0,0,0,830,0,10533,0,0,830,0,10533,13877,0,0,0,-830,830,-10533,-3344,0.0,0.0,-0.003952380952380952,0.003952380952380952,-0.05015714285714286,-0.015923809523809524,-6
1916,100000,1,2,1,43,0,0,0,0,0,0,98944,75296,78049,48644,54963,57269,4000,5000,3000,9000,4000,5000,1,94944,70296,75049,39644,50963,52269,0.94944,0.70296,0.75049,0.39644,0.50963,0.52269,0
1917,200000,0,2,2,30,0,0,0,0,0,0,179273,182624,188541,179380,41060,41258,6657,10000,8000,2000,2000,2000,0,172616,172624,180541,177380,39060,39258,0.86308,0.86312,0.902705,0.8869,0.1953,0.19629,0
1918,420000,0,4,2,36,1,-2,-1,-1,0,0,944,1819,1133,10415,7792,-3,1819,1143,10429,194,556,0,0,-875,676,-9296,10221,7236,-3,-0.0020833333333333333,0.0016095238095238096,-0.022133333333333335,0.024335714285714287,0.01722857142857143,-7.142857142857143e-06,-3
1919,240000,1,2,2,32,0,0,0,0,0,0,132252,135069,136408,139192,142111,145165,6500,5000,5057,5239,5500,5000,0,125752,130069,131351,133953,136611,140165,0.5239666666666667,0.5419541666666666,0.5472958333333333,0.5581375,0.5692125,0.5840208333333333,0
1920,150000,0,1,2,34,0,0,0,0,0,0,56142,60855,53256,60945,60720,57407,10115,15010,10015,3022,1522,2013,0,46027,45845,43241,57923,59198,55394,0.30684666666666666,0.3056333333333333,0.2882733333333333,0.38615333333333335,0.39465333333333336,0.3692933333333333,0
1921,30000,1,1,1,22,0,0,0,0,0,2,22479,22650,22513,22391,23654,22738,2004,2004,2001,2001,1,1701,1,20475,20646,20512,20390,23653,21037,0.6825,0.6882,0.6837333333333333,0.6796666666666666,0.7884333333333333,0.7012333333333334,2
1922,500000,1,2,1,40,-2,-2,-2,-2,-1,0,240927,18676,9390,-3772,282777,288937,1093,9429,3423,291227,9011,9030,1,239834,9247,5967,-294999,273766,279907,0.479668,0.018494,0.011934,-0.589998,0.547532,0.559814,-9
1923,80000,0,2,1,31,0,0,0,0,0,0,70664,62223,26400,27201,27363,-4000,2036,1500,1201,1500,2000,2000,1,68628,60723,25199,25701,25363,-6000,0.85785,0.7590375,0.3149875,0.3212625,0.3170375,-0.075,0
1924,200000,1,1,2,32,-2,-2,-2,-2,-2,-2,2580,-35,3519,1846,1330,14470,0,3554,1855,1337,14542,2955,0,2580,-3589,1664,509,-13212,11515,0.0129,-0.017945,0.00832,0.002545,-0.06606,0.057575,-12
1925,20000,1,1,2,22,2,2,2,2,2,2,16233,20547,20542,19572,20437,19994,5383,660,0,1538,0,2658,0,10850,19887,20542,18034,20437,17336,0.5425,0.99435,1.0271,0.9017,1.02185,0.8668,12
1926,50000,0,2,1,39,2,2,2,2,2,2,31476,30676,33261,32427,34579,35476,0,3400,0,2700,1600,1500,1,31476,27276,33261,29727,32979,33976,0.62952,0.54552,0.66522,0.59454,0.65958,0.67952,12
1927,20000,0,3,2,24,3,3,2,2,2,2,15846,16283,17325,17542,17756,18023,1000,1600,800,800,700,800,0,14846,14683,16525,16742,17056,17223,0.7423,0.73415,0.82625,0.8371,0.8528,0.86115,14
1928,90000,0,2,1,48,0,0,0,0,0,0,51666,52385,51790,50346,48745,46842,2919,3005,1700,1722,1414,1061,1,48747,49380,50090,48624,47331,45781,0.5416333333333333,0.5486666666666666,0.5565555555555556,0.5402666666666667,0.5259,0.5086777777777778,0
1929,220000,1,2,1,44,2,2,0,0,0,0,195375,185993,184568,168683,158742,161499,10,8304,7356,5300,5550,5050,1,195365,177689,177212,163383,153192,156449,0.8880227272727272,0.8076772727272727,0.805509090909091,0.74265,0.6963272727272727,0.7111318181818181,4
1930,240000,0,1,1,43,0,0,0,0,0,2,67120,68473,69899,71946,75425,74377,2200,2263,2930,5000,0,3000,1,64920,66210,66969,66946,75425,71377,0.2705,0.275875,0.2790375,0.27894166666666664,0.31427083333333333,0.2974041666666667,2
1931,180000,0,2,2,34,0,0,0,0,0,0,167604,162774,148961,78024,72989,75454,6949,6502,3022,3000,3022,2000,0,160655,156272,145939,75024,69967,73454,0.8925277777777778,0.8681777777777778,0.8107722222222222,0.4168,0.3887055555555556,0.40807777777777776,0
1932,180000,1,1,2,38,-2,-2,-2,-2,-2,-2,0,0,0,0,0,0,0,0,0,0,0,0,0,0,0,0,0,0,0,0.0,0.0,0.0,0.0,0.0,0.0,-12
1933,390000,0,2,1,48,0,0,0,0,0,0,32708,34849,34370,4968,5595,5318,3000,1500,1000,1004,2003,5407,1,29708,33349,33370,3964,3592,-89,0.07617435897435898,0.0855102564102564,0.08556410256410256,0.010164102564102565,0.00921025641025641,-0.0002282051282051282,0
1934,30000,0,3,2,25,0,0,0,0,0,0,23075,23996,25407,27312,8810,6355,2000,2500,3000,178,1000,0,0,21075,21496,22407,27134,7810,6355,0.7025,0.7165333333333334,0.7469,0.9044666666666666,0.26033333333333336,0.21183333333333335,0
1935,50000,1,3,2,37,1,3,2,0,0,0,52626,51537,49205,30394,30249,29957,0,24,1500,1000,1201,30592,0,52626,51513,47705,29394,29048,-635,1.05252,1.03026,0.9541,0.58788,0.58096,-0.0127,6
1936,160000,1,1,1,39,0,0,2,0,0,0,43583,50028,48928,49812,50855,52354,7500,0,2000,2000,2500,2100,1,36083,50028,46928,47812,48355,50254,0.22551875,0.312675,0.2933,0.298825,0.30221875,0.3140875,2
1937,70000,0,2,1,39,0,0,0,0,0,-1,70800,72060,69938,16518,14096,830,4025,2095,1000,2000,3000,0,1,66775,69965,68938,14518,11096,830,0.9539285714285715,0.9995,0.9848285714285714,0.2074,0.15851428571428572,0.011857142857142858,-1
1938,240000,1,1,1,34,0,0,0,0,0,0,41484,42522,43538,44402,45333,46551,1709,1725,1589,1646,1972,1263,1,39775,40797,41949,42756,43361,45288,0.16572916666666668,0.1699875,0.1747875,0.17815,0.18067083333333334,0.1887,0
1939,240000,1,2,2,28,0,0,0,0,0,0,121109,124460,126384,126917,90822,83742,6000,5000,4000,4000,4000,3000,0,115109,119460,122384,122917,86822,80742,0.47962083333333333,0.49775,0.5099333333333333,0.5121541666666667,0.36175833333333335,0.336425,0
1940,20000,1,2,1,46,1,2,2,2,0,0,10935,11456,13169,13656,14430,14200,1000,1900,1000,1000,0,8119,1,9935,9556,12169,12656,14430,6081,0.49675,0.4778,0.60845,0.6328,0.7215,0.30405,7
1941,20000,0,3,2,43,-1,0,0,-1,0,0,6085,6607,2800,11052,10522,9150,1045,1028,11052,311,183,0,0,5040,5579,-8252,10741,10339,9150,0.252,0.27895,-0.4126,0.53705,0.51695,0.4575,-2
1942,390000,0,2,2,41,0,0,0,0,-1,-1,22309,21921,18357,17376,835,835,1325,1283,1092,14836,837,4904,0,20984,20638,17265,2540,-2,-4069,0.05380512820512821,0.05291794871794872,0.04426923076923077,0.0065128205128205125,-5.128205128205128e-06,-0.010433333333333333,-2
1943,260000,1,1,2,29,0,0,0,0,0,0,267336,264929,234214,169096,117873,79782,11000,9800,6000,4088,3000,3000,0,256336,255129,228214,165008,114873,76782,0.9859076923076923,0.9812653846153846,0.8777461538461538,0.6346461538461539,0.44181923076923074,0.2953153846153846,0
1944,70000,1,2,2,23,0,0,0,0,0,0,44830,46185,47208,47241,48212,45849,2100,2079,2500,2000,2000,1700,0,42730,44106,44708,45241,46212,44149,0.6104285714285714,0.6300857142857142,0.6386857142857143,0.6463,0.6601714285714285,0.6307,0
1945,20000,0,2,2,43,-1,-1,-1,-1,-1,-1,54,54,54,54,54,54,0,0,0,0,0,2966,0,54,54,54,54,54,-2912,0.0027,0.0027,0.0027,0.0027,0.0027,-0.1456,-6
1946,110000,1,1,1,28,0,0,0,0,0,2,109474,110723,111125,106828,84729,82910,11602,4238,4316,11190,0,3000,1,97872,106485,106809,95638,84729,79910,0.8897454545454545,0.9680454545454545,0.9709909090909091,0.8694363636363637,0.7702636363636364,0.7264545454545455,2
1947,100000,1,3,1,35,-1,0,0,0,0,0,50327,51326,52403,53410,54030,55157,1835,1902,1878,1446,1500,30000,1,48492,49424,50525,51964,52530,25157,0.48492,0.49424,0.50525,0.51964,0.5253,0.25157,-1
1948,320000,1,3,1,35,0,0,0,0,0,0,157249,148123,142852,133583,129049,128325,6000,6048,6000,5000,5000,5000,1,151249,142075,136852,128583,124049,123325,0.472653125,0.443984375,0.4276625,0.401821875,0.387653125,0.385390625,0
1949,200000,1,2,2,33,-2,-2,-2,-2,-2,-2,1502,3806,0,4573,1242,0,3836,0,4573,1242,0,3239,0,-2334,3806,-4573,3331,1242,-3239,-0.01167,0.01903,-0.022865,0.016655,0.00621,-0.016195,-12
1950,500000,1,2,1,33,0,0,0,0,0,-1,48415,50588,32091,19615,23084,4528,15021,1408,392,7000,4528,22021,1,33394,49180,31699,12615,18556,-17493,0.066788,0.09836,0.063398,0.02523,0.037112,-0.034986,-1
1951,140000,1,1,1,37,0,0,0,0,0,0,135134,139178,139900,109665,108129,108067,6703,6120,4015,4042,4057,4012,1,128431,133058,135885,105623,104072,104055,0.9173642857142857,0.9504142857142858,0.9706071428571429,0.75445,0.7433714285714286,0.74325,0
1952,310000,1,2,2,31,0,0,0,0,0,0,14015,15377,16393,14855,12662,9628,2000,1300,1461,1000,2000,2000,0,12015,14077,14932,13855,10662,7628,0.03875806451612903,0.04540967741935484,0.04816774193548387,0.04469354838709677,0.034393548387096774,0.024606451612903226,0
1953,150000,1,2,1,41,-2,-2,-2,-1,-1,-1,1906,4983,12029,13821,1493,2229,5002,12040,13821,1493,2229,2057,1,-3096,-7057,-1792,12328,-736,172,-0.02064,-0.04704666666666667,-0.011946666666666666,0.08218666666666667,-0.004906666666666667,0.0011466666666666667,-9
1954,100000,1,1,2,31,0,0,0,0,0,0,100296,97239,98386,69324,53183,53559,3703,4091,3403,2001,2004,2000,0,96593,93148,94983,67323,51179,51559,0.96593,0.93148,0.94983,0.67323,0.51179,0.51559,0
1955,180000,1,2,1,30,-1,-1,-1,-1,-1,-1,2488,13476,3173,13202,6594,2549,13476,3173,13212,6594,2549,1000,1,-10988,10303,-10039,6608,4045,1549,-0.06104444444444444,0.05723888888888889,-0.05577222222222222,0.03671111111111111,0.022472222222222223,0.008605555555555556,-6
1956,150000,1,2,1,32,-1,-1,-1,-1,-1,-1,3267,3782,316,5469,3360,2399,3782,316,5469,3360,2399,4358,1,-515,3466,-5153,2109,961,-1959,-0.0034333333333333334,0.023106666666666668,-0.03435333333333333,0.01406,0.006406666666666666,-0.01306,-6
1957,100000,0,3,2,29,0,0,0,0,0,-2,47919,30820,28503,6810,-3,-3,2000,1000,1039,12920,0,0,0,45919,29820,27464,-6110,-3,-3,0.45919,0.2982,0.27464,-0.0611,-3e-05,-3e-05,-2
1958,150000,0,1,1,35,-2,-2,-2,-2,-2,-2,5819,805,-48,8029,2188,9157,809,0,8077,2199,9202,2112,1,5010,805,-8125,5830,-7014,7045,0.0334,0.005366666666666666,-0.05416666666666667,0.03886666666666667,-0.04676,0.046966666666666664,-12
1959,80000,1,1,2,27,0,0,-2,-2,-2,-2,80000,0,0,0,0,0,0,0,0,0,0,0,0,80000,0,0,0,0,0,1.0,0.0,0.0,0.0,0.0,0.0,-8
1960,500000,1,2,2,49,-1,-1,-1,0,0,-1,27891,8970,385228,391047,0,150,8982,385228,7821,0,150,363,0,18909,-376258,377407,391047,-150,-213,0.037818,-0.752516,0.754814,0.782094,-0.0003,-0.000426,-4
1961,260000,0,1,2,36,-1,-1,-1,-2,-2,-2,5877,427,-73,-73,-73,-73,10000,0,0,0,0,0,0,-4123,427,-73,-73,-73,-73,-0.01585769230769231,0.0016423076923076923,-0.00028076923076923076,-0.00028076923076923076,-0.00028076923076923076,-0.00028076923076923076,-9
1962,50000,1,2,1,36,1,3,3,2,0,0,17292,18705,18125,17530,18251,19965,2000,0,0,1000,2002,0,1,15292,18705,18125,16530,16249,19965,0.30584,0.3741,0.3625,0.3306,0.32498,0.3993,9
1963,150000,1,1,2,25,-1,-1,0,0,0,-1,3167,13680,12848,8445,6868,1310,13879,4000,0,0,1310,0,0,-10712,9680,12848,8445,5558,1310,-0.07141333333333333,0.06453333333333333,0.08565333333333333,0.0563,0.037053333333333334,0.008733333333333333,-3
1964,30000,1,2,1,27,0,0,0,0,0,0,23134,23302,22844,22101,19535,19580,1712,1400,442,391,500,0,1,21422,21902,22402,21710,19035,19580,0.7140666666666666,0.7300666666666666,0.7467333333333334,0.7236666666666667,0.6345,0.6526666666666666,0
1965,80000,1,1,2,28,0,0,0,0,0,0,70723,72151,73888,75345,75040,75211,3200,3500,3300,2800,2900,2900,0,67523,68651,70588,72545,72140,72311,0.8440375,0.8581375,0.88235,0.9068125,0.90175,0.9038875,0
1966,150000,0,2,3,25,-1,-1,-1,0,0,0,1180,7667,9044,8397,6763,0,7705,9047,8,33,0,0,0,-6525,-1380,9036,8364,6763,0,-0.0435,-0.0092,0.06024,0.05576,0.045086666666666664,0.0,-3
1967,70000,1,2,1,46,2,2,2,2,2,2,24036,25035,25930,26206,26477,27404,1700,1600,1000,1000,1500,0,1,22336,23435,24930,25206,24977,27404,0.3190857142857143,0.3347857142857143,0.35614285714285715,0.3600857142857143,0.3568142857142857,0.39148571428571427,12
1968,500000,1,2,1,44,0,0,0,0,0,0,193136,186610,180153,173454,166546,159651,6610,6480,6230,5900,5720,5420,1,186526,180130,173923,167554,160826,154231,0.373052,0.36026,0.347846,0.335108,0.321652,0.308462,0
1969,40000,1,3,1,49,1,2,2,2,0,0,35771,34896,39322,38319,39531,40224,0,5000,0,2000,1400,2000,1,35771,29896,39322,36319,38131,38224,0.894275,0.7474,0.98305,0.907975,0.953275,0.9556,7
1970,280000,0,1,1,38,-2,-2,-2,-2,-2,-1,101259,7224,11169,2300,0,10551,7259,11055,2311,0,10551,15000,1,94000,-3831,8858,2300,-10551,-4449,0.3357142857142857,-0.013682142857142858,0.03163571428571429,0.008214285714285714,-0.03768214285714286,-0.015889285714285713,-11
1971,300000,0,1,2,33,-1,-1,-1,-1,-1,-1,4499,0,2299,900,1400,0,0,2299,900,1400,0,200,0,4499,-2299,1399,-500,1400,-200,0.014996666666666667,-0.007663333333333334,0.0046633333333333336,-0.0016666666666666668,0.004666666666666667,-0.0006666666666666666,-6
1972,20000,1,2,1,34,0,0,0,0,0,-1,5185,6547,8879,10926,17536,2090,2000,3000,3000,7000,2090,0,1,3185,3547,5879,3926,15446,2090,0.15925,0.17735,0.29395,0.1963,0.7723,0.1045,-1
1973,90000,1,2,2,26,0,0,0,0,0,0,11181,11237,9442,5318,11928,15558,3194,8823,0,7000,6660,10000,0,7987,2414,9442,-1682,5268,5558,0.08874444444444445,0.026822222222222223,0.10491111111111111,-0.01868888888888889,0.05853333333333333,0.06175555555555556,0
1974,20000,1,1,1,37,0,0,0,0,0,0,19921,18100,19146,20098,20191,18216,1594,1640,1592,685,662,827,1,18327,16460,17554,19413,19529,17389,0.91635,0.823,0.8777,0.97065,0.97645,0.86945,0
1975,160000,1,2,1,42,1,-2,-1,-1,-1,-1,0,0,369,0,522,0,0,369,0,522,0,978,1,0,-369,369,-522,522,-978,0.0,-0.00230625,0.00230625,-0.0032625,0.0032625,-0.0061125,-5
1976,130000,0,3,1,46,1,2,0,0,0,0,26582,25956,25144,23235,13277,13895,100,2000,1000,700,1000,2000,1,26482,23956,24144,22535,12277,11895,0.2037076923076923,0.1842769230769231,0.18572307692307694,0.17334615384615384,0.09443846153846154,0.0915,3
1977,50000,0,2,2,22,0,0,0,0,0,0,55100,52440,47080,15718,13674,15145,2372,2149,1203,2000,1716,628,0,52728,50291,45877,13718,11958,14517,1.05456,1.00582,0.91754,0.27436,0.23916,0.29034,0
1978,60000,1,2,1,37,0,0,0,0,0,0,38670,37606,35189,31373,28455,26598,1606,1674,1420,937,1006,1039,1,37064,35932,33769,30436,27449,25559,0.6177333333333334,0.5988666666666667,0.5628166666666666,0.5072666666666666,0.45748333333333335,0.4259833333333333,0
1979,330000,1,1,2,44,2,0,0,2,0,0,238795,243621,259517,253863,257535,262753,10300,21400,0,9400,9542,9766,0,228495,222221,259517,244463,247993,252987,0.6924090909090909,0.6733969696969697,0.7864151515151515,0.7407969696969697,0.7514939393939394,0.7666272727272727,4
1980,30000,1,1,2,41,0,0,0,0,0,0,22346,26357,29043,29419,29848,29306,8816,4021,2000,5000,6000,6000,0,13530,22336,27043,24419,23848,23306,0.451,0.7445333333333334,0.9014333333333333,0.8139666666666666,0.7949333333333334,0.7768666666666667,0
1981,180000,1,1,2,25,0,-1,2,-1,-1,2,7026,10080,3254,1443,7105,2929,10080,0,1443,7105,0,5253,0,-3054,10080,1811,-5662,7105,-2324,-0.016966666666666668,0.056,0.010061111111111111,-0.031455555555555556,0.03947222222222222,-0.012911111111111111,1
1982,120000,1,2,1,43,-2,-2,-2,-2,-2,-2,0,999,0,0,0,0,999,0,0,0,0,0,1,-999,999,0,0,0,0,-0.008325,0.008325,0.0,0.0,0.0,0.0,-12
1983,490000,1,2,1,31,0,0,0,0,0,0,245566,238208,226020,212422,201680,164989,10095,9861,7055,6189,5046,5089,1,235471,228347,218965,206233,196634,159900,0.4805530612244898,0.4660142857142857,0.4468673469387755,0.42088367346938776,0.4012938775510204,0.3263265306122449,0
1984,140000,1,2,1,45,0,0,0,0,-1,-1,106974,109061,7262,7410,1545,0,4924,1000,148,1545,0,0,1,102050,108061,7114,5865,1545,0,0.7289285714285715,0.7718642857142857,0.050814285714285715,0.04189285714285714,0.011035714285714286,0.0,-2
1985,200000,1,2,2,36,0,0,0,0,0,0,199278,201725,203794,189024,191803,195044,7279,8679,6300,6000,6000,22001,0,191999,193046,197494,183024,185803,173043,0.959995,0.96523,0.98747,0.91512,0.929015,0.865215,0
1986,520000,1,2,1,47,-2,-2,-2,-2,-2,-2,76762,107039,19046,7359,16336,20040,107124,19058,7387,16475,20040,98205,1,-30362,87981,11659,-9116,-3704,-78165,-0.05838846153846154,0.16919423076923076,0.022421153846153848,-0.01753076923076923,-0.007123076923076923,-0.1503173076923077,-12
1987,50000,1,2,1,44,0,0,0,0,0,0,45578,41906,35703,22360,23659,27421,3016,5003,3000,3000,5000,924,1,42562,36903,32703,19360,18659,26497,0.85124,0.73806,0.65406,0.3872,0.37318,0.52994,0
1988,110000,1,3,1,55,-1,2,0,0,2,2,4924,4305,4770,5819,4807,5579,0,1087,1532,0,1000,0,1,4924,3218,3238,5819,3807,5579,0.04476363636363637,0.029254545454545453,0.029436363636363636,0.0529,0.03460909090909091,0.050718181818181815,5
1989,60000,0,3,1,38,2,2,2,2,0,0,33044,32232,25086,24404,25212,28147,0,4000,0,1500,3500,2600,1,33044,28232,25086,22904,21712,25547,0.5507333333333333,0.47053333333333336,0.4181,0.3817333333333333,0.36186666666666667,0.42578333333333335,8
1990,50000,0,2,1,53,0,0,0,0,0,0,70820,50813,51131,49099,19739,19905,1998,2374,1130,523,537,633,1,68822,48439,50001,48576,19202,19272,1.37644,0.96878,1.00002,0.97152,0.38404,0.38544,0
1991,20000,0,2,1,55,0,0,0,0,0,0,15793,16823,17848,27843,19352,19938,1300,1302,1320,1137,1000,510,1,14493,15521,16528,26706,18352,19428,0.72465,0.77605,0.8264,1.3353,0.9176,0.9714,0
1992,50000,0,2,2,43,-1,-1,-1,-1,0,-1,396,396,396,792,396,396,396,396,792,0,396,792,0,0,0,-396,792,0,-396,0.0,0.0,-0.00792,0.01584,0.0,-0.00792,-5
1993,210000,1,2,1,36,0,0,0,0,-1,0,4879,5373,6811,10161,2922,1461,3000,3000,5000,2922,0,1461,1,1879,2373,1811,7239,2922,0,0.008947619047619048,0.0113,0.008623809523809523,0.03447142857142857,0.013914285714285714,0.0,-1
1994,230000,1,2,2,23,1,3,2,2,2,2,5263,5021,3579,31053,30334,38203,3,8,30334,0,8507,14,0,5260,5013,-26755,31053,21827,38189,0.022869565217391304,0.021795652173913042,-0.11632608695652175,0.13501304347826087,0.0949,0.1660391304347826,12
1995,30000,1,2,2,23,2,0,0,2,2,2,16089,17127,19108,18503,20100,19629,1300,2272,0,1900,0,1000,0,14789,14855,19108,16603,20100,18629,0.49296666666666666,0.49516666666666664,0.6369333333333334,0.5534333333333333,0.67,0.6209666666666667,8
1996,70000,0,2,2,36,0,0,0,0,0,0,66888,69306,24348,24744,25195,25777,4000,1704,1100,1000,1000,1000,0,62888,67602,23248,23744,24195,24777,0.8984,0.9657428571428571,0.3321142857142857,0.3392,0.34564285714285714,0.35395714285714286,0
1997,150000,1,3,1,50,-1,-1,-1,-1,-1,-1,3644,875,2162,0,5085,2887,875,2162,0,5085,2887,0,1,2769,-1287,2162,-5085,2198,2887,0.01846,-0.00858,0.014413333333333334,-0.0339,0.014653333333333334,0.019246666666666665,-6
1998,30000,1,2,2,23,0,0,0,0,0,0,25287,26501,30300,25806,26149,25478,2011,5000,868,1092,3000,1500,0,23276,21501,29432,24714,23149,23978,0.7758666666666667,0.7167,0.9810666666666666,0.8238,0.7716333333333333,0.7992666666666667,0
1999,60000,1,2,1,37,0,0,0,0,0,0,57694,58656,59750,60602,53838,54609,2800,3000,2800,2100,2123,2100,1,54894,55656,56950,58502,51715,52509,0.9149,0.9276,0.9491666666666667,0.9750333333333333,0.8619166666666667,0.87515,0
2000,280000,1,3,2,33,-1,-1,-1,-1,-1,-1,2186,2186,2184,2542,2186,2109,2196,2194,2554,2196,2119,17555,0,-10,-8,-370,346,67,-15446,-3.571428571428572e-05,-2.857142857142857e-05,-0.0013214285714285715,0.0012357142857142857,0.00023928571428571429,-0.055164285714285714,-6
2001,20000,0,2,1,62,2,0,0,0,0,0,17870,18740,19343,19402,11731,0,1462,1367,682,627,0,0,1,16408,17373,18661,18775,11731,0,0.8204,0.86865,0.93305,0.93875,0.58655,0.0,2
2002,90000,1,2,2,25,0,0,0,0,0,0,78651,79972,81415,81878,83206,85350,3600,3805,3100,3200,4100,2500,0,75051,76167,78315,78678,79106,82850,0.8339,0.8463,0.8701666666666666,0.8742,0.8789555555555556,0.9205555555555556,0
2003,300000,0,1,1,30,-1,-1,-1,-1,-1,-1,649,949,1938,81,671,8067,949,1938,81,671,8067,1513,1,-300,-989,1857,-590,-7396,6554,-0.001,-0.0032966666666666665,0.00619,-0.0019666666666666665,-0.024653333333333333,0.021846666666666667,-6
2004,220000,0,1,2,33,1,-2,-2,-2,-2,-2,0,0,0,0,0,0,0,0,0,0,0,0,0,0,0,0,0,0,0,0.0,0.0,0.0,0.0,0.0,0.0,-9
2005,450000,1,2,1,43,-1,-1,-1,-1,-1,-1,1448,6018,10402,6110,7848,14279,6018,10426,6110,7848,14279,20723,1,-4570,-4408,4292,-1738,-6431,-6444,-0.010155555555555555,-0.009795555555555556,0.009537777777777777,-0.003862222222222222,-0.01429111111111111,-0.01432,-6
2006,360000,1,3,1,36,2,0,0,-2,-2,-2,150527,153900,0,0,0,0,7000,0,0,0,0,0,1,143527,153900,0,0,0,0,0.39868611111111113,0.4275,0.0,0.0,0.0,0.0,-4
2007,100000,1,1,2,28,0,0,0,0,0,0,16601,14414,11307,11139,11361,9816,1539,1124,495,500,758,0,0,15062,13290,10812,10639,10603,9816,0.15062,0.1329,0.10812,0.10639,0.10603,0.09816,0
2008,20000,0,2,2,30,0,0,0,0,0,0,16320,28674,15491,16299,16428,0,1238,1392,1200,329,0,0,0,15082,27282,14291,15970,16428,0,0.7541,1.3641,0.71455,0.7985,0.8214,0.0,0
2009,80000,0,2,2,59,2,2,2,2,2,0,24756,29818,29060,31133,24135,22970,5500,13,4000,5,2005,2005,0,19256,29805,25060,31128,22130,20965,0.2407,0.3725625,0.31325,0.3891,0.276625,0.2620625,10
2010,80000,0,1,2,27,0,0,0,0,-1,0,76817,74554,43727,16307,1755,470,3000,1400,326,1755,0,39080,0,73817,73154,43401,14552,1755,-38610,0.9227125,0.914425,0.5425125,0.1819,0.0219375,-0.482625,-1
2011,120000,0,2,1,38,0,0,0,0,0,0,50441,41960,34024,30564,22702,23175,2000,1361,1000,824,851,812,1,48441,40599,33024,29740,21851,22363,0.403675,0.338325,0.2752,0.24783333333333332,0.18209166666666668,0.18635833333333332,0
2012,60000,0,1,2,27,0,0,0,0,0,0,5370,7268,10131,11644,14430,17180,2000,3000,2000,3000,3000,2000,0,3370,4268,8131,8644,11430,15180,0.05616666666666666,0.07113333333333334,0.13551666666666667,0.14406666666666668,0.1905,0.253,0
2013,170000,0,1,1,38,-1,-1,-1,-1,-1,-1,2430,2430,2430,2430,2430,2430,2430,2430,2430,2430,2430,2599,1,0,0,0,0,0,-169,0.0,0.0,0.0,0.0,0.0,-0.0009941176470588235,-6
2014,70000,0,1,2,49,1,2,0,0,2,2,38228,37318,38061,42545,43346,44105,0,1649,5133,1800,1600,1900,0,38228,35669,32928,40745,41746,42205,0.5461142857142857,0.5095571428571428,0.4704,0.5820714285714286,0.5963714285714286,0.6029285714285715,7
2015,180000,1,3,1,33,-1,-1,-1,-1,-1,-1,478,478,2272,3970,330,0,478,2272,3970,420,0,0,1,0,-1794,-1698,3550,330,0,0.0,-0.009966666666666667,-0.009433333333333334,0.01972222222222222,0.0018333333333333333,0.0,-6
2016,20000,0,2,2,46,0,0,0,-2,-2,-2,19401,20650,0,0,0,0,1650,0,0,0,0,0,0,17751,20650,0,0,0,0,0.88755,1.0325,0.0,0.0,0.0,0.0,-6
2017,80000,1,3,1,38,-1,-1,-1,0,0,-2,330,0,330,330,0,0,0,660,0,0,0,0,1,330,-660,330,330,0,0,0.004125,-0.00825,0.004125,0.004125,0.0,0.0,-5
2018,100000,1,2,1,39,0,0,0,0,0,0,97040,65668,66046,66779,45833,46369,2617,2098,1916,1707,1732,1379,1,94423,63570,64130,65072,44101,44990,0.94423,0.6357,0.6413,0.65072,0.44101,0.4499,0
2019,320000,1,1,2,35,0,0,0,0,0,0,227927,218565,223284,98028,102498,80469,10000,10000,5000,6000,5000,5000,0,217927,208565,218284,92028,97498,75469,0.681021875,0.651765625,0.6821375,0.2875875,0.30468125,0.235840625,0
2020,350000,0,2,2,36,0,0,0,0,0,0,15061,23719,36582,40452,15203,20596,10000,16000,6000,314,10000,7000,0,5061,7719,30582,40138,5203,13596,0.01446,0.022054285714285714,0.08737714285714286,0.11468,0.014865714285714286,0.03884571428571429,0
2021,110000,1,2,2,28,2,2,2,2,2,2,86774,88702,89655,90593,89025,94509,4200,3300,3300,0,7000,2300,0,82574,85402,86355,90593,82025,92209,0.7506727272727273,0.7763818181818182,0.7850454545454545,0.8235727272727272,0.7456818181818182,0.8382636363636363,12
2022,400000,1,2,2,35,2,0,0,0,0,0,61245,109943,222085,223350,213831,210563,50016,120018,10071,8037,8018,8809,0,11229,-10075,212014,215313,205813,201754,0.0280725,-0.0251875,0.530035,0.5382825,0.5145325,0.504385,2
2023,30000,1,1,2,21,1,2,0,0,0,0,33300,30920,31889,30278,26220,29968,0,2326,11406,524,6284,598,0,33300,28594,20483,29754,19936,29370,1.11,0.9531333333333334,0.6827666666666666,0.9918,0.6645333333333333,0.979,3
2024,170000,0,2,1,48,-1,-1,-1,-1,0,0,390,390,390,780,780,0,390,390,780,0,0,0,1,0,0,-390,780,780,0,0.0,0.0,-0.0022941176470588237,0.004588235294117647,0.004588235294117647,0.0,-4
2025,50000,1,1,2,24,3,2,2,2,0,0,8506,10194,10928,10456,11279,12095,2000,1200,0,1000,1000,1000,0,6506,8994,10928,9456,10279,11095,0.13012,0.17988,0.21856,0.18912,0.20558,0.2219,9
2026,360000,1,2,2,29,1,-2,-2,-2,-2,-2,0,0,0,0,0,0,0,0,0,0,0,0,0,0,0,0,0,0,0,0.0,0.0,0.0,0.0,0.0,0.0,-9
2027,70000,0,1,1,40,1,2,2,2,2,2,12026,13531,13017,14299,13927,15692,2000,0,1500,0,2000,0,1,10026,13531,11517,14299,11927,15692,0.14322857142857143,0.1933,0.16452857142857144,0.20427142857142858,0.17038571428571428,0.22417142857142858,11
2028,180000,1,2,2,26,0,0,0,0,0,0,88846,89730,93682,103273,104492,109818,3279,6428,13669,3816,8048,3501,0,85567,83302,80013,99457,96444,106317,0.4753722222222222,0.4627888888888889,0.44451666666666667,0.5525388888888889,0.5358,0.59065,0
2029,120000,1,3,1,46,-1,-1,-2,-2,-2,-2,4940,0,0,0,0,0,0,0,0,0,0,0,1,4940,0,0,0,0,0,0.041166666666666664,0.0,0.0,0.0,0.0,0.0,-10
2030,20000,0,3,1,30,0,0,0,0,-1,0,19131,17834,18790,-27490,20001,17985,1500,1400,0,47700,700,1000,1,17631,16434,18790,-75190,19301,16985,0.88155,0.8217,0.9395,-3.7595,0.96505,0.84925,-1
2031,40000,0,1,2,24,1,2,0,0,0,3,28926,28182,28912,29495,33011,32194,0,1500,1064,4000,0,0,0,28926,26682,27848,25495,33011,32194,0.72315,0.66705,0.6962,0.637375,0.825275,0.80485,6
2032,750000,1,2,1,43,-1,-1,-1,-2,-1,-1,72495,99628,74635,63749,85067,83208,99664,74640,63758,85072,83215,124063,1,-27169,24988,10877,-21323,1852,-40855,-0.03622533333333333,0.03331733333333333,0.014502666666666667,-0.028430666666666667,0.0024693333333333334,-0.05447333333333333,-7
2033,150000,1,1,1,29,0,0,2,0,0,0,18231,20625,17443,21649,22045,18814,3000,2,5000,2000,1500,2107,1,15231,20623,12443,19649,20545,16707,0.10154,0.13748666666666667,0.08295333333333334,0.13099333333333332,0.13696666666666665,0.11138,2
2034,320000,0,1,1,40,-1,-1,-1,-1,0,-1,10853,33968,86024,232017,15622,7463,34151,86466,232242,3199,7500,30,1,-23298,-52498,-146218,228818,8122,7433,-0.07280625,-0.16405625,-0.45693125,0.71505625,0.02538125,0.023228125,-5
2035,220000,1,1,2,30,-1,-1,-1,-1,-1,-1,8939,316,541,4188,3473,7653,316,541,4188,3473,7653,2280,0,8623,-225,-3647,715,-4180,5373,0.03919545454545455,-0.0010227272727272728,-0.01657727272727273,0.00325,-0.019,0.024422727272727273,-6
2036,400000,1,1,2,31,-1,-1,-1,-1,0,0,72551,8572,2190,12881,7497,11563,8657,2190,12881,0,4590,0,0,63894,6382,-10691,12881,2907,11563,0.159735,0.015955,-0.0267275,0.0322025,0.0072675,0.0289075,-4
2037,30000,0,3,2,42,0,0,2,0,0,-1,27742,31130,29105,58840,28840,1319,4600,0,1060,1091,1319,565,0,23142,31130,28045,57749,27521,754,0.7714,1.0376666666666667,0.9348333333333333,1.9249666666666667,0.9173666666666667,0.025133333333333334,1
2038,160000,1,1,1,47,1,2,0,0,2,0,89006,86694,88898,94289,91875,94405,0,4500,7800,0,4000,3700,1,89006,82194,81098,94289,87875,90705,0.5562875,0.5137125,0.5068625,0.58930625,0.54921875,0.56690625,5
2039,90000,1,1,2,27,0,0,0,0,0,0,61799,62561,63069,62643,59265,59046,2400,2518,2514,2100,2500,2500,0,59399,60043,60555,60543,56765,56546,0.6599888888888888,0.6671444444444444,0.6728333333333333,0.6727,0.6307222222222222,0.6282888888888889,0
2040,260000,0,2,1,37,0,0,0,0,0,0,128602,118109,21557,23186,14117,15797,3203,6015,5055,2011,4078,4522,1,125399,112094,16502,21175,10039,11275,0.48230384615384614,0.4311307692307692,0.06346923076923076,0.08144230769230769,0.03861153846153846,0.04336538461538462,0
2041,70000,1,2,2,36,-1,2,2,2,2,2,1156,2254,2044,4152,3023,4014,2044,0,4000,0,2000,0,0,-888,2254,-1956,4152,1023,4014,-0.012685714285714286,0.0322,-0.027942857142857144,0.059314285714285715,0.014614285714285715,0.05734285714285714,9
2042,60000,1,2,2,23,0,0,0,0,0,0,21295,22629,23338,23810,25418,26050,1679,1388,860,2000,1055,2000,0,19616,21241,22478,21810,24363,24050,0.32693333333333335,0.35401666666666665,0.3746333333333333,0.3635,0.40605,0.4008333333333333,0
2043,30000,0,2,2,32,-1,2,2,2,2,2,17578,17988,20374,20738,22253,24748,1000,3000,1000,2170,3000,0,0,16578,14988,19374,18568,19253,24748,0.5526,0.4996,0.6458,0.6189333333333333,0.6417666666666667,0.8249333333333333,9
2044,20000,0,3,2,46,0,0,0,0,0,0,9784,11195,12542,13619,14415,15281,1885,1838,1300,1000,1074,183,0,7899,9357,11242,12619,13341,15098,0.39495,0.46785,0.5621,0.63095,0.66705,0.7549,0
2045,350000,1,1,1,44,-2,-2,-2,-2,-2,-2,8544,0,0,0,8631,277,0,0,0,8631,277,7545,1,8544,0,0,-8631,8354,-7268,0.02441142857142857,0.0,0.0,-0.02466,0.02386857142857143,-0.020765714285714287,-12
2046,150000,1,1,2,33,0,0,0,0,0,0,96066,98277,88202,48179,49426,50534,4400,4000,2000,2000,1900,1700,0,91666,94277,86202,46179,47526,48834,0.6111066666666667,0.6285133333333334,0.57468,0.30786,0.31684,0.32556,0
2047,230000,1,2,1,35,-1,-1,-1,-1,-1,0,7035,2954,13375,-10,8808,6632,2969,13441,0,8818,4,28,1,4066,-10487,13375,-8828,8804,6604,0.017678260869565216,-0.045595652173913044,0.058152173913043476,-0.03838260869565217,0.03827826086956522,0.02871304347826087,-5
2048,500000,0,2,1,35,-2,-2,-2,-2,-2,-2,2295,1384,1384,1384,5590,4542,1384,1384,1384,5590,4542,1000,1,911,0,0,-4206,1048,3542,0.001822,0.0,0.0,-0.008412,0.002096,0.007084,-12
2049,180000,1,2,2,33,-1,-1,-1,0,-1,-1,6314,1795,1190,1079,659,90,1795,1190,0,659,90,8856,0,4519,605,1190,420,569,-8766,0.025105555555555555,0.003361111111111111,0.006611111111111111,0.0023333333333333335,0.003161111111111111,-0.0487,-5
2050,150000,1,3,1,43,0,0,0,2,2,0,142811,139652,111868,107702,103112,103246,6000,10700,1600,0,2800,2500,1,136811,128952,110268,107702,100312,100746,0.9120733333333333,0.85968,0.73512,0.7180133333333333,0.6687466666666667,0.67164,4
2051,50000,0,1,1,57,0,0,0,0,0,0,42624,39943,7218,6946,6808,6542,2173,1248,366,500,384,500,1,40451,38695,6852,6446,6424,6042,0.80902,0.7739,0.13704,0.12892,0.12848,0.12084,0
2052,290000,1,1,2,30,-1,-1,-1,-1,-2,-2,1459,1029,2154,1492,229,943,1078,2154,1518,229,943,189,0,381,-1125,636,1263,-714,754,0.001313793103448276,-0.003879310344827586,0.0021931034482758622,0.004355172413793103,-0.0024620689655172412,0.0026,-8
2053,100000,0,2,1,47,0,0,2,0,0,2,66539,71766,69111,64287,67838,66135,7000,0,2500,5500,0,3000,1,59539,71766,66611,58787,67838,63135,0.59539,0.71766,0.66611,0.58787,0.67838,0.63135,4
2054,50000,1,3,2,23,2,0,0,0,0,0,50653,49348,47995,40226,27828,28411,2190,2027,2204,996,1031,1047,0,48463,47321,45791,39230,26797,27364,0.96926,0.94642,0.91582,0.7846,0.53594,0.54728,2
2055,30000,1,2,2,22,0,0,0,0,0,0,19759,19973,22058,24598,26564,27521,3000,3500,3000,2500,2000,3000,0,16759,16473,19058,22098,24564,24521,0.5586333333333333,0.5491,0.6352666666666666,0.7366,0.8188,0.8173666666666667,0
2056,350000,0,1,2,33,-1,-1,-1,-2,-2,-1,10900,10478,-22,-22,-22,4532,10530,0,0,0,4554,0,0,370,10478,-22,-22,-4576,4532,0.0010571428571428572,0.029937142857142857,-6.285714285714286e-05,-6.285714285714286e-05,-0.013074285714285714,0.012948571428571429,-8
2057,180000,1,3,1,43,1,-1,-1,-1,-1,-1,0,2602,498,498,1835,11337,2602,498,498,1835,10000,380,1,-2602,2104,0,-1337,-8165,10957,-0.014455555555555555,0.01168888888888889,0.0,-0.007427777777777778,-0.04536111111111111,0.06087222222222222,-4
2058,80000,0,2,2,26,0,0,0,0,0,0,76304,78680,79897,27950,28579,29138,4203,3900,1200,1230,1230,1000,0,72101,74780,78697,26720,27349,28138,0.9012625,0.93475,0.9837125,0.334,0.3418625,0.351725,0
2059,90000,1,2,2,25,0,0,0,0,0,0,67004,65533,67475,69136,51217,50490,3000,3000,3000,2000,2000,2000,0,64004,62533,64475,67136,49217,48490,0.7111555555555555,0.6948111111111112,0.7163888888888889,0.7459555555555556,0.5468555555555555,0.5387777777777778,0
2060,370000,1,1,1,31,-2,-1,0,0,0,0,0,229818,234379,239082,244124,243986,229818,8409,8500,8800,8800,14100,1,-229818,221409,225879,230282,235324,229886,-0.6211297297297297,0.5984027027027027,0.6104837837837838,0.6223837837837838,0.6360108108108108,0.6213135135135135,-3
2061,220000,1,1,2,42,-1,-1,-1,-1,-1,-1,26340,31523,35718,24288,25720,48759,31533,20600,24288,25720,48759,23303,0,-5193,10923,11430,-1432,-23039,25456,-0.023604545454545454,0.04965,0.051954545454545455,-0.006509090909090909,-0.10472272727272727,0.11570909090909091,-6
2062,230000,1,2,2,31,-1,-1,0,0,0,0,10190,49777,49159,43668,42352,43099,49777,3002,1388,1511,5000,1600,0,-39587,46775,47771,42157,37352,41499,-0.17211739130434783,0.2033695652173913,0.2077,0.1832913043478261,0.1624,0.1804304347826087,-2
2063,130000,0,2,2,30,-1,2,2,2,-1,-1,780,780,390,0,780,0,390,0,0,780,0,0,0,390,780,390,-780,780,0,0.003,0.006,0.003,-0.006,0.006,0.0,3
2064,190000,1,2,1,55,0,0,0,0,0,0,104344,106814,104047,88269,90264,88823,6003,5009,5750,3500,3500,3200,1,98341,101805,98297,84769,86764,85623,0.5175842105263158,0.5358157894736842,0.5173526315789474,0.44615263157894736,0.45665263157894737,0.45064736842105263,0
2065,50000,1,2,1,35,1,2,2,2,2,2,8917,8625,11475,10999,12311,11973,0,3000,0,1800,0,1950,1,8917,5625,11475,9199,12311,10023,0.17834,0.1125,0.2295,0.18398,0.24622,0.20046,11
2066,130000,1,1,1,35,0,0,0,-1,-1,-1,81313,117866,17740,1330,7095,1190,40000,5000,1330,7095,1190,2090,1,41313,112866,16410,-5765,5905,-900,0.3177923076923077,0.8682,0.12623076923076923,-0.04434615384615385,0.04542307692307692,-0.006923076923076923,-3
2067,180000,1,1,1,35,-1,-1,-2,-2,-2,-2,1651,0,0,0,0,0,0,0,0,0,0,295,1,1651,0,0,0,0,-295,0.009172222222222222,0.0,0.0,0.0,0.0,-0.001638888888888889,-10
2068,230000,1,1,1,39,1,-2,-1,-1,-1,-2,0,0,181,2680,0,0,0,181,2680,0,0,0,1,0,-181,-2499,2680,0,0,0.0,-0.0007869565217391304,-0.010865217391304348,0.011652173913043478,0.0,0.0,-6
2069,140000,1,1,1,40,2,2,2,2,2,2,21952,27540,31785,30980,33162,32497,6300,5000,0,3000,0,3000,1,15652,22540,31785,27980,33162,29497,0.1118,0.161,0.22703571428571429,0.19985714285714284,0.23687142857142857,0.21069285714285715,12
2070,280000,1,2,2,36,0,0,0,0,0,0,183797,168402,161474,152092,145229,148602,6083,5913,5293,5126,5640,5119,0,177714,162489,156181,146966,139589,143483,0.6346928571428572,0.5803178571428571,0.5577892857142858,0.5248785714285714,0.49853214285714287,0.5124392857142858,0
2071,20000,0,3,2,24,0,0,0,0,-1,-1,17895,19598,19701,3486,199,0,2000,1000,400,199,0,0,0,15895,18598,19301,3287,199,0,0.79475,0.9299,0.96505,0.16435,0.00995,0.0,-2
2072,140000,0,2,2,41,-2,-2,-1,-1,-2,-2,-10,-10,1066,0,0,0,0,1076,0,0,0,0,0,-10,-1086,1066,0,0,0,-7.142857142857143e-05,-0.007757142857142857,0.007614285714285714,0.0,0.0,0.0,-10
2073,90000,1,2,1,35,-1,0,0,-1,-1,-1,5488,2380,0,1700,1700,0,1000,0,1700,1700,0,1664,1,4488,2380,-1700,0,1700,-1664,0.04986666666666666,0.026444444444444444,-0.01888888888888889,0.0,0.01888888888888889,-0.018488888888888888,-4
2074,80000,1,2,2,25,0,0,2,2,0,0,47369,49524,48461,45943,46660,46118,4400,1500,1500,1742,1800,2100,0,42969,48024,46961,44201,44860,44018,0.5371125,0.6003,0.5870125,0.5525125,0.56075,0.550225,4
2075,80000,1,2,1,45,0,0,0,0,0,0,28775,28951,26813,27383,27475,27823,1442,1459,1500,1000,1003,1100,1,27333,27492,25313,26383,26472,26723,0.3416625,0.34365,0.3164125,0.3297875,0.3309,0.3340375,0
2076,360000,1,1,1,35,-2,-2,-2,-2,-2,-2,3925,5320,1016,7173,10763,4857,5352,1022,7408,10817,5044,27696,1,-1427,4298,-6392,-3644,5719,-22839,-0.003963888888888889,0.01193888888888889,-0.017755555555555556,-0.010122222222222222,0.01588611111111111,-0.06344166666666666,-12
2077,220000,1,2,1,41,0,0,0,0,0,0,126532,90013,91191,86139,83743,78555,4500,4006,3000,3000,3000,6000,1,122032,86007,88191,83139,80743,72555,0.5546909090909091,0.3909409090909091,0.40086818181818185,0.37790454545454544,0.3670136363636364,0.32979545454545456,0
2078,310000,1,3,1,40,0,0,0,0,0,0,69569,71437,71464,72299,50967,51153,3366,2400,2212,1985,2422,1407,1,66203,69037,69252,70314,48545,49746,0.21355806451612902,0.2227,0.22339354838709677,0.22681935483870969,0.1565967741935484,0.16047096774193548,0
2079,90000,1,2,2,26,2,2,2,0,0,0,87606,91430,88705,65632,49431,50864,7063,7,2054,1800,2864,3197,0,80543,91423,86651,63832,46567,47667,0.8949222222222222,1.0158111111111112,0.9627888888888889,0.7092444444444445,0.5174111111111112,0.5296333333333333,6
2080,190000,0,2,1,33,0,0,0,0,0,-2,98814,102174,105230,17907,-93,-483,5000,5361,1000,0,0,0,1,93814,96813,104230,17907,-93,-483,0.4937578947368421,0.5095421052631579,0.548578947368421,0.09424736842105264,-0.0004894736842105263,-0.0025421052631578946,-2
2081,120000,0,1,2,38,1,-2,-2,-2,-2,-2,-284,-610,-936,-1262,-1588,-1914,0,0,0,0,0,0,0,-284,-610,-936,-1262,-1588,-1914,-0.0023666666666666667,-0.005083333333333333,-0.0078,-0.010516666666666667,-0.013233333333333333,-0.01595,-9
2082,30000,1,3,2,24,0,0,0,0,0,0,27276,26937,26679,27779,28691,29726,2000,2500,2000,2000,2000,2000,0,25276,24437,24679,25779,26691,27726,0.8425333333333334,0.8145666666666667,0.8226333333333333,0.8593,0.8897,0.9242,0
2083,360000,1,2,2,33,-1,-1,-1,-1,0,0,5344,9852,5137,4912,1150,0,9860,8537,4912,0,0,9294,0,-4516,1315,225,4912,1150,-9294,-0.012544444444444445,0.003652777777777778,0.000625,0.013644444444444445,0.0031944444444444446,-0.02581666666666667,-4
2084,80000,1,2,1,48,0,0,0,0,0,0,49526,48304,27864,27033,27617,26761,1740,1800,1500,1000,965,1500,1,47786,46504,26364,26033,26652,25261,0.597325,0.5813,0.32955,0.3254125,0.33315,0.3157625,0
2085,80000,1,2,2,27,0,0,0,0,0,0,73684,68883,45257,45981,46032,46192,2896,1722,1619,1665,1700,1833,0,70788,67161,43638,44316,44332,44359,0.88485,0.8395125,0.545475,0.55395,0.55415,0.5544875,0
2086,50000,1,1,2,22,0,0,-2,-2,-2,-2,2416,0,0,0,0,0,0,0,0,0,0,0,0,2416,0,0,0,0,0,0.04832,0.0,0.0,0.0,0.0,0.0,-8
2087,20000,1,1,2,28,0,-1,-1,2,0,0,4647,3567,20330,13463,9192,7315,5057,17000,0,0,0,1183,0,-410,-13433,20330,13463,9192,6132,-0.0205,-0.67165,1.0165,0.67315,0.4596,0.3066,0
2088,30000,1,2,1,25,1,2,0,0,0,0,30347,28517,29709,29833,29306,29348,0,1800,1000,1041,1138,932,1,30347,26717,28709,28792,28168,28416,1.0115666666666667,0.8905666666666666,0.9569666666666666,0.9597333333333333,0.9389333333333333,0.9472,3
2089,200000,1,1,1,33,2,-1,-1,-1,-1,-1,1076,696,316,1076,316,1226,696,316,1076,316,1226,696,1,380,380,-760,760,-910,530,0.0019,0.0019,-0.0038,0.0038,-0.00455,0.00265,-3
2090,210000,1,2,2,27,0,0,0,0,0,0,83381,85097,86928,89471,91282,93309,3100,3200,4000,3300,3500,3500,0,80281,81897,82928,86171,87782,89809,0.3822904761904762,0.38998571428571427,0.3948952380952381,0.4103380952380952,0.41800952380952383,0.42766190476190474,0
2091,70000,1,2,2,30,2,2,2,0,0,2,14232,15398,14866,15611,16753,16343,1700,0,1300,1400,0,1400,0,12532,15398,13566,14211,16753,14943,0.17902857142857143,0.21997142857142857,0.1938,0.2030142857142857,0.23932857142857142,0.21347142857142856,8
2092,20000,0,1,1,38,0,0,0,2,2,0,15912,17272,20565,20705,20255,19933,1623,3916,750,0,800,850,1,14289,13356,19815,20705,19455,19083,0.71445,0.6678,0.99075,1.03525,0.97275,0.95415,4
2093,140000,0,2,2,41,0,0,0,0,0,2,185948,170133,155737,140586,136641,117308,6088,5677,4797,15414,0,2330,0,179860,164456,150940,125172,136641,114978,1.2847142857142857,1.1746857142857143,1.078142857142857,0.8940857142857143,0.9760071428571429,0.8212714285714285,2
2094,220000,1,2,2,31,0,0,0,0,0,0,75451,78094,80680,81944,83963,85930,4000,4000,3000,3000,3000,3000,0,71451,74094,77680,78944,80963,82930,0.32477727272727275,0.3367909090909091,0.35309090909090907,0.3588363636363636,0.3680136363636364,0.37695454545454543,0
2095,80000,1,2,1,35,0,0,0,0,0,0,9647,10390,10816,9746,9798,10401,1206,1131,322,490,1402,201,1,8441,9259,10494,9256,8396,10200,0.1055125,0.1157375,0.131175,0.1157,0.10495,0.1275,0
2096,260000,1,1,1,34,0,0,0,0,0,0,136914,139380,140836,153026,156108,158893,7000,5188,15000,7500,7000,3000,1,129914,134192,125836,145526,149108,155893,0.49966923076923075,0.5161230769230769,0.4839846153846154,0.5597153846153846,0.5734923076923077,0.5995884615384616,0
2097,20000,1,2,2,24,0,0,0,0,0,0,2004,3193,4050,4129,4367,4613,1211,1068,147,304,467,0,0,793,2125,3903,3825,3900,4613,0.03965,0.10625,0.19515,0.19125,0.195,0.23065,0
2098,280000,0,1,2,37,-2,-2,-2,-2,-2,-2,7523,1567,-8,-8,1680,0,1574,0,0,1688,0,198,0,5949,1567,-8,-1696,1680,-198,0.021246428571428572,0.005596428571428572,-2.857142857142857e-05,-0.006057142857142857,0.006,-0.0007071428571428571,-12
2099,90000,1,2,2,29,0,0,2,0,0,0,83158,91759,88487,88201,87219,86803,12128,0,3301,3136,3156,3244,0,71030,91759,85186,85065,84063,83559,0.7892222222222223,1.0195444444444444,0.9465111111111111,0.9451666666666667,0.9340333333333334,0.9284333333333333,2
2100,50000,0,2,2,25,0,0,0,0,0,0,43785,38971,34836,18488,19716,17932,1795,1660,1272,1500,644,704,0,41990,37311,33564,16988,19072,17228,0.8398,0.74622,0.67128,0.33976,0.38144,0.34456,0
2101,340000,1,1,2,43,1,-2,-2,-2,-2,-2,-212,-212,-212,-212,-212,-212,0,0,0,0,0,154,0,-212,-212,-212,-212,-212,-366,-0.0006235294117647059,-0.0006235294117647059,-0.0006235294117647059,-0.0006235294117647059,-0.0006235294117647059,-0.0010764705882352942,-9
2102,260000,0,3,1,63,0,0,0,0,0,2,261326,264126,244115,248831,263528,258973,9166,9001,9061,19155,1,9858,1,252160,255125,235054,229676,263527,249115,0.9698461538461538,0.98125,0.9040538461538462,0.8833692307692308,1.0135653846153847,0.9581346153846154,2
2103,120000,0,1,2,34,1,2,2,-1,-1,-1,650,625,300,475,300,325,300,0,500,300,500,300,0,350,625,-200,175,-200,25,0.002916666666666667,0.005208333333333333,-0.0016666666666666668,0.0014583333333333334,-0.0016666666666666668,0.00020833333333333335,2
2104,310000,1,1,1,33,-2,-2,-2,-2,-2,-2,2729,0,0,0,0,343,0,0,0,0,343,410,1,2729,0,0,0,-343,-67,0.008803225806451613,0.0,0.0,0.0,-0.0011064516129032258,-0.0002161290322580645,-12
2105,500000,0,1,1,54,2,2,2,0,0,0,518950,539418,519267,518741,516139,514975,39000,0,19000,19000,18000,15000,1,479950,539418,500267,499741,498139,499975,0.9599,1.078836,1.000534,0.999482,0.996278,0.99995,6
2106,250000,0,4,1,35,-2,-2,-2,-2,-2,-2,22839,7745,12035,33604,0,1190,7783,12046,33718,0,1190,590,1,15056,-4301,-21683,33604,-1190,600,0.060224,-0.017204,-0.086732,0.134416,-0.00476,0.0024,-12
2107,140000,1,2,2,24,0,0,2,2,2,2,99012,106817,109646,106420,111130,113204,11000,6000,0,8000,4000,5000,0,88012,100817,109646,98420,107130,108204,0.6286571428571428,0.7201214285714286,0.7831857142857143,0.703,0.7652142857142857,0.7728857142857143,8
2108,210000,0,1,2,32,0,0,0,0,0,0,218742,218317,73874,73219,96844,94731,10000,5000,5000,30000,4500,15000,0,208742,213317,68874,43219,92344,79731,0.9940095238095238,1.0157952380952382,0.3279714285714286,0.2058047619047619,0.4397333333333333,0.37967142857142855,0
2109,140000,0,2,1,41,0,0,0,0,0,0,138325,137142,139110,138262,49675,46121,6000,7000,4228,1505,2000,2000,1,132325,130142,134882,136757,47675,44121,0.9451785714285714,0.9295857142857142,0.9634428571428572,0.9768357142857143,0.3405357142857143,0.31515,0
2110,50000,1,3,3,55,-1,-1,-1,0,0,2,390,390,911,1080,930,390,390,911,559,390,0,390,0,0,-521,352,690,930,0,0.0,-0.01042,0.00704,0.0138,0.0186,0.0,-1
2111,180000,1,2,2,36,0,0,0,0,0,2,161159,151558,154648,156584,166960,164012,7000,7100,6000,13100,0,6000,0,154159,144458,148648,143484,166960,158012,0.8564388888888889,0.8025444444444444,0.8258222222222222,0.7971333333333334,0.9275555555555556,0.8778444444444444,2
2112,80000,0,2,2,25,1,-2,-1,-1,-2,-2,0,0,431,0,0,0,0,431,0,0,0,0,0,0,-431,431,0,0,0,0.0,-0.0053875,0.0053875,0.0,0.0,0.0,-7
2113,20000,0,2,2,24,0,0,0,0,0,0,15730,16776,35036,14694,16914,14074,1313,2110,4000,6000,4000,174,0,14417,14666,31036,8694,12914,13900,0.72085,0.7333,1.5518,0.4347,0.6457,0.695,0
2114,50000,0,3,1,55,2,2,2,0,0,0,19056,18586,17418,15004,15804,17443,1000,1000,1000,1000,4024,2000,1,18056,17586,16418,14004,11780,15443,0.36112,0.35172,0.32836,0.28008,0.2356,0.30886,6
2115,150000,1,2,2,25,0,0,0,0,0,0,151761,149060,151308,152576,152368,142030,5752,6308,16644,12381,9320,5977,0,146009,142752,134664,140195,143048,136053,0.9733933333333333,0.95168,0.89776,0.9346333333333333,0.9536533333333334,0.90702,0
2116,300000,1,2,2,40,-1,-1,-1,-1,-1,-1,10626,10578,12963,989,12238,0,10582,13265,1087,12238,0,0,0,44,-2687,11876,-11249,12238,0,0.00014666666666666666,-0.008956666666666667,0.039586666666666666,-0.037496666666666664,0.040793333333333334,0.0,-6
2117,120000,0,1,1,42,0,0,2,2,2,0,7722,9591,10687,11905,11420,12081,2000,1400,1700,0,1000,700,1,5722,8191,8987,11905,10420,11381,0.047683333333333335,0.06825833333333334,0.07489166666666666,0.09920833333333333,0.08683333333333333,0.09484166666666667,6
2118,130000,1,2,1,29,0,0,0,0,0,0,132214,132361,128904,101785,101849,99296,5500,5904,4785,3849,4296,3139,1,126714,126457,124119,97936,97553,96157,0.9747230769230769,0.9727461538461538,0.9547615384615384,0.7533538461538462,0.7504076923076923,0.7396692307692307,0
2119,180000,1,2,1,25,0,0,0,0,0,-1,33322,29500,28418,16084,14210,711,1900,1864,600,600,711,2576,1,31422,27636,27818,15484,13499,-1865,0.17456666666666668,0.15353333333333333,0.15454444444444446,0.08602222222222222,0.07499444444444445,-0.010361111111111111,-1
2120,180000,1,2,1,40,-1,-1,-1,-1,-1,-1,1552,776,0,1752,70000,10552,776,0,1752,70000,10552,9776,1,776,776,-1752,-68248,59448,776,0.004311111111111111,0.004311111111111111,-0.009733333333333333,-0.3791555555555556,0.33026666666666665,0.004311111111111111,-6
2121,300000,1,1,2,38,-2,-2,-2,-2,-2,-2,13548,13097,3025,4128,1726,-587,2060,2004,2003,1726,692,116422,0,11488,11093,1022,2402,1034,-117009,0.03829333333333333,0.036976666666666665,0.003406666666666667,0.008006666666666667,0.0034466666666666665,-0.39003,-12
2122,150000,0,2,2,35,-1,-1,-1,-1,-1,0,13059,11526,18301,15858,2744,2144,11526,18305,15861,2744,0,19682,0,1533,-6779,2440,13114,2744,-17538,0.01022,-0.045193333333333335,0.016266666666666665,0.08742666666666667,0.018293333333333335,-0.11692,-5
2123,260000,1,2,1,46,-2,-2,-2,-2,-2,-2,0,135,0,0,109,945,135,0,0,109,945,9300,1,-135,135,0,-109,-836,-8355,-0.0005192307692307692,0.0005192307692307692,0.0,-0.00041923076923076923,-0.003215384615384615,-0.032134615384615386,-12
2124,80000,0,2,1,35,0,0,0,0,0,0,79875,77201,78535,79296,75274,78051,4000,3500,3322,3000,5007,3000,1,75875,73701,75213,76296,70267,75051,0.9484375,0.9212625,0.9401625,0.9537,0.8783375,0.9381375,0
2125,20000,1,3,1,45,2,2,3,2,2,0,21646,24390,23719,23936,23253,25871,3400,0,900,0,3000,2000,1,18246,24390,22819,23936,20253,23871,0.9123,1.2195,1.14095,1.1968,1.01265,1.19355,11
2126,230000,1,1,2,27,0,0,0,2,0,0,79108,70757,76049,68989,54450,39862,3187,7100,0,2700,2000,1572,0,75921,63657,76049,66289,52450,38290,0.3300913043478261,0.2767695652173913,0.33064782608695653,0.2882130434782609,0.22804347826086957,0.16647826086956521,2
2127,360000,1,1,2,30,-1,-1,-1,0,0,0,13861,7795,4489,10218,6509,15156,7884,4808,10044,4006,10046,12087,0,5977,2987,-5555,6212,-3537,3069,0.01660277777777778,0.008297222222222221,-0.015430555555555555,0.017255555555555555,-0.009825,0.008525,-3
2128,60000,1,2,1,35,0,0,0,0,0,2,27892,29438,32620,33274,35732,35008,2000,4000,1197,3000,0,1400,1,25892,25438,31423,30274,35732,33608,0.4315333333333333,0.42396666666666666,0.5237166666666667,0.5045666666666667,0.5955333333333334,0.5601333333333334,2
2129,200000,1,2,2,27,0,0,0,0,0,0,125854,127843,131352,130884,132142,118084,4775,6579,4734,4368,4183,4227,0,121079,121264,126618,126516,127959,113857,0.605395,0.60632,0.63309,0.63258,0.639795,0.569285,0
2130,80000,1,3,2,23,0,0,2,2,2,2,71988,76940,68255,55983,59823,51519,6200,2000,2,6278,0,1567,0,65788,74940,68253,49705,59823,49952,0.82235,0.93675,0.8531625,0.6213125,0.7477875,0.6244,8
2131,50000,1,3,2,44,2,2,2,2,2,0,42115,41164,43658,44644,43798,44912,0,3500,2000,0,2000,2000,0,42115,37664,41658,44644,41798,42912,0.8423,0.75328,0.83316,0.89288,0.83596,0.85824,10
2132,260000,1,1,2,27,1,-2,-2,-2,-2,-2,0,0,0,0,0,0,0,0,0,0,0,0,0,0,0,0,0,0,0,0.0,0.0,0.0,0.0,0.0,0.0,-9
2133,140000,0,3,1,58,2,0,0,0,0,0,98985,98702,96753,94310,92182,88818,4520,4034,5050,6034,3202,5000,1,94465,94668,91703,88276,88980,83818,0.67475,0.6762,0.6550214285714285,0.6305428571428572,0.6355714285714286,0.5987,2
2134,230000,1,1,2,33,1,2,-1,0,-1,0,4213,1922,5346,6971,10707,15392,0,5500,4000,11000,5000,5000,0,4213,-3578,1346,-4029,5707,10392,0.018317391304347827,-0.015556521739130434,0.005852173913043478,-0.017517391304347825,0.02481304347826087,0.045182608695652174,1
2135,50000,0,2,1,52,0,0,0,0,0,0,46436,41290,40251,15273,14229,15001,2300,2000,1000,1000,1000,1000,1,44136,39290,39251,14273,13229,14001,0.88272,0.7858,0.78502,0.28546,0.26458,0.28002,0
2136,200000,1,1,1,34,1,-2,-2,-2,-2,-2,0,0,0,0,0,0,0,0,0,0,0,0,1,0,0,0,0,0,0,0.0,0.0,0.0,0.0,0.0,0.0,-9
2137,50000,0,2,2,37,0,0,0,0,0,0,48206,48659,47248,48241,49196,50296,2120,1750,1700,1800,2023,2113,0,46086,46909,45548,46441,47173,48183,0.92172,0.93818,0.91096,0.92882,0.94346,0.96366,0
2138,210000,1,2,2,29,0,0,0,0,0,0,86598,88304,90648,93164,94167,97672,4000,4000,4000,10000,5000,3000,0,82598,84304,86648,83164,89167,94672,0.3933238095238095,0.40144761904761905,0.4126095238095238,0.3960190476190476,0.42460476190476193,0.4508190476190476,0
2139,230000,0,1,1,41,-1,-1,-1,-2,-2,-2,9360,9650,0,0,0,0,9650,0,0,0,0,0,1,-290,9650,0,0,0,0,-0.0012608695652173913,0.041956521739130434,0.0,0.0,0.0,0.0,-9
2140,500000,1,2,1,31,-1,-1,-1,0,0,0,2181,5625,60201,45299,40940,16923,5700,60207,1000,838,4476,24236,1,-3519,-54582,59201,44461,36464,-7313,-0.007038,-0.109164,0.118402,0.088922,0.072928,-0.014626,-3
2141,400000,1,1,2,46,0,-1,2,-1,0,0,2030,10520,6073,8591,6611,17080,10540,18,8591,0,10990,0,0,-8510,10502,-2518,8591,-4379,17080,-0.021275,0.026255,-0.006295,0.0214775,-0.0109475,0.0427,0
2142,300000,0,2,2,36,-1,0,0,-1,-1,-1,15536,17923,27007,360,257,21140,10000,10140,360,257,21346,360,0,5536,7783,26647,103,-21089,20780,0.018453333333333332,0.025943333333333332,0.08882333333333334,0.00034333333333333335,-0.07029666666666666,0.06926666666666667,-4
2143,210000,1,1,2,29,-1,-1,-1,-1,0,0,1383,484,971,3764,2221,266,484,980,4000,266,0,1913,0,899,-496,-3029,3498,2221,-1647,0.004280952380952381,-0.002361904761904762,-0.014423809523809525,0.016657142857142856,0.010576190476190477,-0.007842857142857143,-4
2144,50000,1,2,1,42,0,0,0,0,0,0,47867,40937,28868,44751,27557,29125,2083,1840,31000,977,2003,1214,1,45784,39097,-2132,43774,25554,27911,0.91568,0.78194,-0.04264,0.87548,0.51108,0.55822,0
2145,30000,1,3,1,28,0,0,0,2,2,0,12430,13419,15897,16340,15780,16127,1200,2700,1000,0,600,1400,1,11230,10719,14897,16340,15180,14727,0.37433333333333335,0.3573,0.49656666666666666,0.5446666666666666,0.506,0.4909,4
2146,10000,1,1,1,27,2,0,0,0,0,2,4920,5937,6945,7088,8108,8264,1256,1264,407,1291,435,0,1,3664,4673,6538,5797,7673,8264,0.3664,0.4673,0.6538,0.5797,0.7673,0.8264,4
2147,150000,1,2,1,39,2,2,0,0,0,0,156713,152744,150785,140166,143125,151741,0,5694,5014,5215,11016,0,1,156713,147050,145771,134951,132109,151741,1.0447533333333334,0.9803333333333333,0.9718066666666667,0.8996733333333333,0.8807266666666667,1.0116066666666668,4
2148,50000,1,2,2,22,0,0,2,0,0,0,30631,30479,28301,26829,27173,26424,4809,0,1200,1500,943,1142,0,25822,30479,27101,25329,26230,25282,0.51644,0.60958,0.54202,0.50658,0.5246,0.50564,2
2149,200000,0,2,1,30,0,0,0,0,0,0,113676,116355,117802,116296,60792,30808,6000,5000,6000,3000,1611,55000,1,107676,111355,111802,113296,59181,-24192,0.53838,0.556775,0.55901,0.56648,0.295905,-0.12096,0
2150,290000,1,1,1,52,0,0,0,2,2,2,85532,69025,85735,79698,71981,63168,12000,20000,0,5500,0,10000,1,73532,49025,85735,74198,71981,53168,0.2535586206896552,0.16905172413793104,0.29563793103448277,0.25585517241379313,0.2482103448275862,0.18333793103448276,6
2151,150000,0,1,2,27,0,0,0,0,0,0,56918,58368,59830,60134,26607,0,3000,3000,2000,0,0,0,0,53918,55368,57830,60134,26607,0,0.35945333333333335,0.36912,0.38553333333333334,0.4008933333333333,0.17738,0.0,0
2152,280000,1,2,1,50,-1,-1,-1,-1,-1,-1,25040,41270,570,1068,48313,10252,41275,570,1074,48313,10252,19226,1,-16235,40700,-504,-47245,38061,-8974,-0.05798214285714286,0.14535714285714285,-0.0018,-0.16873214285714286,0.13593214285714286,-0.03205,-6
2153,200000,1,1,1,52,-1,-1,-1,-1,-1,-1,16964,317,1169,3175,153,0,317,1169,3178,153,0,0,1,16647,-852,-2009,3022,153,0,0.083235,-0.00426,-0.010045,0.01511,0.000765,0.0,-6
2154,140000,1,2,1,40,0,0,0,0,0,0,98221,97548,98457,102811,104605,106917,3600,5000,6000,5000,4000,10000,1,94621,92548,92457,97811,100605,96917,0.6758642857142857,0.6610571428571429,0.6604071428571429,0.69865,0.7186071428571429,0.6922642857142857,0
2155,50000,1,3,1,37,0,0,0,0,0,0,49080,49240,48751,30250,29570,26969,2228,2000,1370,949,922,2500,1,46852,47240,47381,29301,28648,24469,0.93704,0.9448,0.94762,0.58602,0.57296,0.48938,0
2156,170000,1,1,2,29,-2,-2,-2,-1,0,0,0,0,0,10232,9677,0,0,0,10232,194,0,0,0,0,0,-10232,10038,9677,0,0.0,0.0,-0.06018823529411765,0.05904705882352941,0.056923529411764706,0.0,-7
2157,340000,0,2,1,42,0,0,0,0,0,0,76166,83909,169911,130718,131684,126223,10000,115000,5000,6000,10000,10000,1,66166,-31091,164911,124718,121684,116223,0.19460588235294118,-0.09144411764705883,0.48503235294117647,0.3668176470588235,0.3578941176470588,0.3418323529411765,0
2158,50000,1,2,1,55,0,0,0,0,0,0,23605,27856,16386,15511,15664,19761,5856,3386,5411,5664,5761,3866,1,17749,24470,10975,9847,9903,15895,0.35498,0.4894,0.2195,0.19694,0.19806,0.3179,0
2159,160000,1,2,1,36,-1,-1,-1,-1,-1,-1,2447,206,805,666,740,539,206,886,679,740,539,0,1,2241,-680,126,-74,201,539,0.01400625,-0.00425,0.0007875,-0.0004625,0.00125625,0.00336875,-6
2160,130000,1,2,2,25,0,0,0,0,0,0,128976,131763,128300,89007,90126,98665,7100,6000,4200,3500,10000,0,0,121876,125763,124100,85507,80126,98665,0.9375076923076923,0.9674076923076923,0.9546153846153846,0.6577461538461539,0.6163538461538461,0.7589615384615385,0
2161,200000,1,3,1,39,-1,0,0,0,0,0,145687,146519,144315,130807,124688,122518,7627,4631,5066,5033,5007,5125,1,138060,141888,139249,125774,119681,117393,0.6903,0.70944,0.696245,0.62887,0.598405,0.586965,-1
2162,500000,0,2,1,45,-1,-1,-1,-1,-1,-1,102690,15518,18909,31449,8253,25707,15599,19001,31603,8289,25832,2357,1,87091,-3483,-12694,23160,-17579,23350,0.174182,-0.006966,-0.025388,0.04632,-0.035158,0.0467,-6
2163,180000,0,2,2,38,-1,-1,-1,-1,-1,-1,9409,10395,5382,3155,1877,4673,10423,5393,3159,1881,4678,1353,0,-1014,5002,2223,1274,-2801,3320,-0.005633333333333333,0.027788888888888887,0.01235,0.0070777777777777775,-0.01556111111111111,0.018444444444444444,-6
2164,570000,1,1,1,39,-2,-2,-2,-2,-2,-2,2394,3872,3635,5130,7563,4889,3882,3653,5145,7573,4894,4232,1,-1488,219,-1510,-2443,2669,657,-0.0026105263157894737,0.00038421052631578946,-0.002649122807017544,-0.004285964912280702,0.004682456140350877,0.0011526315789473684,-12
2165,80000,0,3,1,41,0,0,0,0,0,0,90894,93167,81146,80674,63110,40376,4000,3200,2606,2431,1779,1000,1,86894,89967,78540,78243,61331,39376,1.086175,1.1245875,0.98175,0.9780375,0.7666375,0.4922,0
2166,180000,0,3,2,47,0,0,0,0,2,0,67011,69935,72031,77597,72079,66310,4000,4000,7501,0,3001,10000,0,63011,65935,64530,77597,69078,56310,0.3500611111111111,0.36630555555555555,0.3585,0.43109444444444445,0.38376666666666664,0.31283333333333335,2
2167,350000,0,2,2,32,0,0,0,0,0,0,262576,237656,222586,205845,174438,157061,10013,10029,10009,5609,6000,10000,0,252563,227627,212577,200236,168438,147061,0.7216085714285714,0.6503628571428571,0.6073628571428571,0.5721028571428571,0.48125142857142855,0.4201742857142857,0
2168,110000,1,2,2,27,1,-2,-2,-2,-2,-2,0,0,0,0,0,0,0,0,0,0,0,0,0,0,0,0,0,0,0,0.0,0.0,0.0,0.0,0.0,0.0,-9
2169,110000,0,1,1,40,1,-2,-1,0,-1,-1,0,0,2066,2000,216,216,0,2066,0,216,216,66,1,0,-2066,2066,1784,0,150,0.0,-0.01878181818181818,0.01878181818181818,0.01621818181818182,0.0,0.0013636363636363637,-4
2170,20000,1,3,1,33,1,-2,-2,-2,-2,-2,0,0,0,0,0,0,0,0,0,0,0,0,1,0,0,0,0,0,0,0.0,0.0,0.0,0.0,0.0,0.0,-9
2171,200000,0,1,2,33,-1,-1,-1,0,-1,-1,12202,1964,12181,5908,1114,8314,4994,12181,2000,1114,8314,1114,0,7208,-10217,10181,4794,-7200,7200,0.03604,-0.051085,0.050905,0.02397,-0.036,0.036,-5
2172,80000,1,2,2,25,0,0,0,0,0,0,81477,81058,80510,81565,81232,81422,3100,2931,3600,2908,3117,3071,0,78377,78127,76910,78657,78115,78351,0.9797125,0.9765875,0.961375,0.9832125,0.9764375,0.9793875,0
2173,60000,0,1,1,34,0,0,0,0,0,0,37749,38785,39803,40837,41783,42689,1948,1966,2000,1600,1600,1600,1,35801,36819,37803,39237,40183,41089,0.5966833333333333,0.61365,0.63005,0.65395,0.6697166666666666,0.6848166666666666,0
2174,70000,1,2,2,22,0,0,0,0,0,0,72473,72189,71867,64534,33683,32857,3500,3427,3100,1200,1700,1307,0,68973,68762,68767,63334,31983,31550,0.9853285714285714,0.9823142857142857,0.9823857142857143,0.9047714285714286,0.4569,0.45071428571428573,0
2175,50000,0,3,2,34,-1,2,2,-2,-2,-2,780,780,0,0,0,0,0,0,0,0,0,0,0,780,780,0,0,0,0,0.0156,0.0156,0.0,0.0,0.0,0.0,-3
2176,580000,1,2,1,34,1,2,0,0,0,0,420115,405932,437254,477809,486721,498316,0,38001,50000,16881,18887,16846,1,420115,367931,387254,460928,467834,481470,0.7243362068965518,0.6343637931034483,0.6676793103448276,0.794703448275862,0.8066103448275862,0.8301206896551724,3
2177,380000,0,2,1,39,-2,-2,-2,-1,-1,-2,0,4107,2517,710,0,0,4107,2517,716,0,0,1183,1,-4107,1590,1801,710,0,-1183,-0.010807894736842105,0.004184210526315789,0.004739473684210526,0.0018684210526315789,0.0,-0.003113157894736842,-10
2178,50000,1,2,1,27,0,0,0,0,0,0,45632,42750,39776,33164,34781,30231,1837,2500,1390,2007,2000,2000,1,43795,40250,38386,31157,32781,28231,0.8759,0.805,0.76772,0.62314,0.65562,0.56462,0
2179,20000,1,3,1,43,4,3,2,2,0,0,20461,19833,20502,19461,19244,20130,0,1700,0,800,1600,1000,1,20461,18133,20502,18661,17644,19130,1.02305,0.90665,1.0251,0.93305,0.8822,0.9565,11
2180,540000,1,1,2,34,-1,-1,-1,-1,-1,-1,1784,892,946,946,946,946,892,1000,946,946,946,946,0,892,-108,0,0,0,0,0.0016518518518518518,-0.0002,0.0,0.0,0.0,0.0,-6
2181,80000,1,2,1,30,0,0,0,0,0,2,42755,45053,46104,48327,53549,52457,3000,1800,3000,6000,2900,2000,1,39755,43253,43104,42327,50649,50457,0.4969375,0.5406625,0.5388,0.5290875,0.6331125,0.6307125,2
2182,50000,0,2,2,26,-1,0,0,0,0,0,6945,7185,3412,4158,6158,2133,2000,2000,1000,2000,2000,2000,0,4945,5185,2412,2158,4158,133,0.0989,0.1037,0.04824,0.04316,0.08316,0.00266,-1
2183,90000,1,2,1,26,0,0,0,0,-1,-1,47121,49332,47590,50000,780,0,3000,2000,3000,780,0,2808,1,44121,47332,44590,49220,780,-2808,0.49023333333333335,0.5259111111111111,0.49544444444444447,0.5468888888888889,0.008666666666666666,-0.0312,-2
2184,190000,1,1,2,38,0,0,0,0,0,0,39468,33983,35042,35699,36410,38067,2151,1910,1558,1269,2209,123347,0,37317,32073,33484,34430,34201,-85280,0.19640526315789475,0.16880526315789474,0.17623157894736843,0.18121052631578946,0.18000526315789472,-0.4488421052631579,0
2185,180000,1,2,1,39,1,-2,-2,-2,-2,-2,0,0,0,0,0,0,0,0,0,0,0,0,1,0,0,0,0,0,0,0.0,0.0,0.0,0.0,0.0,0.0,-9
2186,140000,0,2,1,42,0,0,0,0,0,0,127939,100372,84587,65589,69117,65911,5059,14659,5000,8000,5000,10000,1,122880,85713,79587,57589,64117,55911,0.8777142857142857,0.6122357142857143,0.5684785714285714,0.41135,0.4579785714285714,0.3993642857142857,0
2187,500000,1,1,2,35,0,0,0,0,0,0,3994,11230,10925,11795,14384,15806,11160,1244,1114,2703,3435,402,0,-7166,9986,9811,9092,10949,15404,-0.014332,0.019972,0.019622,0.018184,0.021898,0.030808,0
2188,310000,1,1,2,25,0,0,0,0,0,0,140483,141796,145125,148388,152132,155887,4000,4500,4500,5000,5000,5000,0,136483,137296,140625,143388,147132,150887,0.44026774193548385,0.44289032258064515,0.4536290322580645,0.46254193548387096,0.47461935483870965,0.48673225806451614,0
2189,150000,1,1,2,30,0,0,0,0,0,0,150311,138240,138887,144170,149970,145262,5500,3400,5883,5800,2905,2799,0,144811,134840,133004,138370,147065,142463,0.9654066666666666,0.8989333333333334,0.8866933333333333,0.9224666666666667,0.9804333333333334,0.9497533333333333,0
2190,220000,0,3,1,30,2,-1,-1,-1,-1,-1,780,390,0,780,0,780,390,0,780,0,780,390,1,390,390,-780,780,-780,390,0.0017727272727272728,0.0017727272727272728,-0.0035454545454545456,0.0035454545454545456,-0.0035454545454545456,0.0017727272727272728,-3
2191,50000,1,2,2,37,0,0,0,-1,0,0,4793,3594,0,5369,3746,9408,3000,0,5369,0,9000,10000,0,1793,3594,-5369,5369,-5254,-592,0.03586,0.07188,-0.10738,0.10738,-0.10508,-0.01184,-1
2192,20000,1,2,2,24,0,0,0,0,0,0,14367,16130,18136,18258,19478,19866,2001,2600,701,1500,705,1000,0,12366,13530,17435,16758,18773,18866,0.6183,0.6765,0.87175,0.8379,0.93865,0.9433,0
2193,360000,1,3,1,56,1,-2,-2,-2,-2,-2,0,0,0,0,0,0,0,0,0,0,0,253,1,0,0,0,0,0,-253,0.0,0.0,0.0,0.0,0.0,-0.0007027777777777778,-9
2194,50000,0,2,1,41,0,0,0,0,0,0,19339,20424,20086,18600,19153,19289,1703,1306,810,1000,900,900,1,17636,19118,19276,17600,18253,18389,0.35272,0.38236,0.38552,0.352,0.36506,0.36778,0
2195,270000,1,1,2,27,-1,-1,-1,0,-1,-1,2016,1183,1307,800,4098,1181,2000,2500,0,4100,1200,5000,0,16,-1317,1307,-3300,2898,-3819,5.925925925925926e-05,-0.004877777777777778,0.004840740740740741,-0.012222222222222223,0.010733333333333333,-0.014144444444444444,-5
2196,50000,0,1,2,28,0,0,-1,-1,-1,-2,23266,16093,19906,11132,0,0,5224,19906,11132,0,0,0,0,18042,-3813,8774,11132,0,0,0.36084,-0.07626,0.17548,0.22264,0.0,0.0,-5
2197,230000,1,1,2,30,-1,-1,-1,-1,-1,-1,754,-441,4410,0,711,5650,0,4851,0,711,5650,0,0,754,-5292,4410,-711,-4939,5650,0.0032782608695652174,-0.023008695652173915,0.01917391304347826,-0.003091304347826087,-0.02147391304347826,0.024565217391304347,-6
2198,500000,0,1,1,53,-2,-2,-2,-2,-2,-2,13331,13307,15734,-101,27145,1479,13941,16392,470,27916,1994,12670,1,-610,-3085,15264,-28017,25151,-11191,-0.00122,-0.00617,0.030528,-0.056034,0.050302,-0.022382,-12
2199,30000,0,1,1,31,1,2,2,2,2,2,14107,14779,14252,16205,15647,17091,1200,0,2200,0,1700,0,1,12907,14779,12052,16205,13947,17091,0.43023333333333336,0.4926333333333333,0.40173333333333333,0.5401666666666667,0.4649,0.5697,11
2200,50000,0,2,2,31,0,0,0,0,0,-1,49024,48778,96487,43639,5290,41302,1813,2079,2650,106,41302,2000,0,47211,46699,93837,43533,-36012,39302,0.94422,0.93398,1.87674,0.87066,-0.72024,0.78604,-1
2201,500000,1,2,2,32,0,-1,-1,-1,0,0,13631,3840,7527,77166,74397,77055,3840,7527,77166,3397,4055,2266,0,9791,-3687,-69639,73769,70342,74789,0.019582,-0.007374,-0.139278,0.147538,0.140684,0.149578,-3
2202,80000,0,1,2,27,0,0,0,0,0,-1,74413,76817,74554,43727,16307,1755,7000,3000,1400,326,1755,0,0,67413,73817,73154,43401,14552,1755,0.8426625,0.9227125,0.914425,0.5425125,0.1819,0.0219375,-1
2203,230000,0,2,1,34,1,-2,-1,2,2,0,0,0,33,33,33,1133,0,33,0,0,1100,704,1,0,-33,33,33,-1067,429,0.0,-0.0001434782608695652,0.0001434782608695652,0.0001434782608695652,-0.004639130434782608,0.0018652173913043478,2
2204,260000,1,2,1,35,0,0,-1,0,0,0,9286,7926,33379,35877,21946,32150,2036,33393,6094,3530,12357,20060,1,7250,-25467,27285,32347,9589,12090,0.027884615384615386,-0.09795,0.1049423076923077,0.12441153846153846,0.03688076923076923,0.0465,-1
2205,400000,1,1,2,29,-1,-1,-2,-2,-2,-2,1158,95,0,0,0,0,95,0,0,0,0,0,0,1063,95,0,0,0,0,0.0026575,0.0002375,0.0,0.0,0.0,0.0,-10
2206,240000,1,1,2,30,-1,-1,-1,-1,-1,-1,498,-2,20517,0,11423,0,0,20519,0,11423,0,0,0,498,-20521,20517,-11423,11423,0,0.002075,-0.08550416666666667,0.0854875,-0.04759583333333333,0.04759583333333333,0.0,-6
2207,230000,0,3,1,45,0,0,0,0,0,0,203135,208225,178559,172772,175057,177113,10000,6528,6000,6500,7000,10000,1,193135,201697,172559,166272,168057,167113,0.8397173913043479,0.8769434782608696,0.7502565217391305,0.7229217391304348,0.7306826086956522,0.7265782608695652,0
2208,150000,1,2,2,34,-1,-1,-1,-1,-1,-1,1467,698,4102,713,810,5438,701,4137,719,817,5467,9587,0,766,-3439,3383,-104,-4657,-4149,0.0051066666666666665,-0.022926666666666668,0.022553333333333335,-0.0006933333333333333,-0.031046666666666667,-0.02766,-6
2209,500000,1,2,2,31,-2,-2,-2,-2,-2,-2,-9,-9,-9,-9,1796,-90,0,0,0,1805,0,18268,0,-9,-9,-9,-1814,1796,-18358,-1.8e-05,-1.8e-05,-1.8e-05,-0.003628,0.003592,-0.036716,-12
2210,500000,1,1,2,31,0,0,0,0,0,0,258257,247282,197247,188044,210940,201108,25239,18011,13014,45049,20102,89442,0,233018,229271,184233,142995,190838,111666,0.466036,0.458542,0.368466,0.28599,0.381676,0.223332,0
2211,90000,1,1,2,24,0,0,0,0,0,0,53173,19825,20840,21023,20776,21055,1324,1339,1638,890,763,769,0,51849,18486,19202,20133,20013,20286,0.5761,0.2054,0.21335555555555555,0.2237,0.22236666666666666,0.2254,0
2212,220000,0,2,1,47,-2,-2,-2,-2,-2,-2,7625,8325,1497,0,0,7625,8334,1497,0,0,7625,2226,1,-709,6828,1497,0,-7625,5399,-0.003222727272727273,0.031036363636363636,0.006804545454545455,0.0,-0.03465909090909091,0.024540909090909092,-12
2213,70000,0,1,2,36,2,2,2,2,2,2,50016,48941,51809,50675,54839,53803,0,4000,0,5000,0,4000,0,50016,44941,51809,45675,54839,49803,0.7145142857142858,0.6420142857142858,0.7401285714285715,0.6525,0.7834142857142857,0.7114714285714285,12
2214,300000,1,1,1,59,-1,-1,-1,-1,-1,-1,12982,10114,10195,34010,20854,64741,11138,10217,34039,20854,64741,39441,1,1844,-103,-23844,13156,-43887,25300,0.006146666666666667,-0.00034333333333333335,-0.07948,0.043853333333333334,-0.14629,0.08433333333333333,-6
2215,30000,1,2,2,23,0,0,0,2,0,0,10550,11670,13469,14045,14509,16962,1300,2000,1100,1000,2700,500,0,9250,9670,12369,13045,11809,16462,0.30833333333333335,0.32233333333333336,0.4123,0.43483333333333335,0.39363333333333334,0.5487333333333333,2
2216,360000,1,2,1,45,0,-1,-1,-1,-1,-1,20137,3332,3542,6487,3437,4875,3332,3752,6487,3437,4875,24181,1,16805,-420,-2945,3050,-1438,-19306,0.04668055555555556,-0.0011666666666666668,-0.008180555555555555,0.008472222222222223,-0.0039944444444444446,-0.05362777777777778,-5
2217,130000,1,2,2,22,0,-1,-1,0,-1,0,8570,527,11249,7816,16578,16129,527,11249,1200,16578,0,33232,0,8043,-10722,10049,-8762,16578,-17103,0.06186923076923077,-0.08247692307692307,0.0773,-0.0674,0.12752307692307693,-0.13156153846153845,-3
2218,450000,1,2,2,34,-2,-2,-2,-2,-2,-2,3752,513,0,4376,0,0,513,0,4376,0,0,0,0,3239,513,-4376,4376,0,0,0.007197777777777778,0.00114,-0.009724444444444445,0.009724444444444445,0.0,0.0,-12
2219,30000,1,3,2,29,2,0,0,2,2,2,23136,24205,28318,28755,29442,30003,1744,4857,1200,1300,1200,1100,0,21392,19348,27118,27455,28242,28903,0.7130666666666666,0.6449333333333334,0.9039333333333334,0.9151666666666667,0.9414,0.9634333333333334,8
2220,250000,1,2,2,26,0,0,0,2,2,2,124353,132251,148597,135715,76113,26366,10000,19888,2500,10302,17500,3000,0,114353,112363,146097,125413,58613,23366,0.457412,0.449452,0.584388,0.501652,0.234452,0.093464,6
2221,80000,1,4,1,30,-2,-2,-2,-2,-2,-2,0,0,0,0,0,0,0,0,0,0,0,0,1,0,0,0,0,0,0,0.0,0.0,0.0,0.0,0.0,0.0,-12
2222,20000,1,1,3,22,0,0,0,0,0,-2,14993,16244,18300,18100,-1900,0,1800,2800,0,0,1900,0,0,13193,13444,18300,18100,-3800,0,0.65965,0.6722,0.915,0.905,-0.19,0.0,-2
2223,120000,0,2,2,49,0,0,0,0,0,0,38878,39917,32048,29131,30288,30192,2000,2000,2000,3000,3000,5000,0,36878,37917,30048,26131,27288,25192,0.3073166666666667,0.315975,0.2504,0.21775833333333333,0.2274,0.20993333333333333,0
2224,270000,0,4,2,32,-2,-2,-2,-2,-2,-2,24089,51408,27067,40359,51264,34874,52398,27787,40569,53500,35051,120391,0,-28309,23621,-13502,-13141,16213,-85517,-0.10484814814814815,0.08748518518518518,-0.05000740740740741,-0.04867037037037037,0.06004814814814815,-0.31672962962962964,-12
2225,20000,0,1,2,27,0,0,0,0,0,0,39628,20571,19089,19658,19453,19108,1610,1323,1600,830,700,674,0,38018,19248,17489,18828,18753,18434,1.9009,0.9624,0.87445,0.9414,0.93765,0.9217,0
2226,80000,0,2,1,31,2,0,0,-2,-2,-2,81712,78535,0,0,0,0,3271,0,0,0,0,0,1,78441,78535,0,0,0,0,0.9805125,0.9816875,0.0,0.0,0.0,0.0,-4
2227,90000,1,2,2,23,0,0,0,0,0,0,87727,89402,88118,87852,49042,49251,3160,3688,4559,1665,1707,1807,0,84567,85714,83559,86187,47335,47444,0.9396333333333333,0.9523777777777778,0.9284333333333333,0.9576333333333333,0.5259444444444444,0.5271555555555556,0
2228,160000,1,3,1,53,-1,-1,-1,-1,-1,-1,2475,2475,5175,2475,3975,8175,2475,5175,2475,3975,8175,138,1,0,-2700,2700,-1500,-4200,8037,0.0,-0.016875,0.016875,-0.009375,-0.02625,0.05023125,-6
2229,50000,0,3,1,54,0,0,0,0,0,2,37238,38387,39589,19533,20535,19690,1771,1973,1307,1699,0,705,1,35467,36414,38282,17834,20535,18985,0.70934,0.72828,0.76564,0.35668,0.4107,0.3797,2
2230,150000,1,3,1,43,0,0,0,0,0,0,90606,93496,94196,91550,89586,88300,4348,3229,3150,3348,3244,8778,1,86258,90267,91046,88202,86342,79522,0.5750533333333333,0.60178,0.6069733333333334,0.5880133333333334,0.5756133333333333,0.5301466666666667,0
2231,360000,1,2,1,40,-1,-1,-1,-1,-1,0,4343,725,4268,2085,26896,18455,725,4268,2085,13448,7455,4759,1,3618,-3543,2183,-11363,19441,13696,0.01005,-0.009841666666666667,0.006063888888888889,-0.03156388888888889,0.054002777777777775,0.03804444444444444,-5
2232,250000,0,2,1,53,0,0,2,0,0,0,177537,198017,192962,156134,161603,166631,25000,0,7000,8000,8000,5000,1,152537,198017,185962,148134,153603,161631,0.610148,0.792068,0.743848,0.592536,0.614412,0.646524,2
2233,120000,1,2,1,37,-1,-1,-2,-2,-2,-2,18486,0,0,0,0,0,0,0,0,0,0,0,1,18486,0,0,0,0,0,0.15405,0.0,0.0,0.0,0.0,0.0,-10
2234,160000,1,2,2,36,-2,-2,-1,-1,-1,-1,2992,1300,8899,6257,-1197,12151,1300,12038,10696,613,14262,0,0,1692,-10738,-1797,5644,-15459,12151,0.010575,-0.0671125,-0.01123125,0.035275,-0.09661875,0.07594375,-8
2235,50000,0,2,1,41,1,4,3,2,2,2,32141,31350,30575,29784,31288,32634,0,0,0,2000,2000,0,1,32141,31350,30575,27784,29288,32634,0.64282,0.627,0.6115,0.55568,0.58576,0.65268,14
2236,50000,1,2,2,29,2,2,2,0,0,2,5804,6855,6599,6577,7120,6857,1300,0,236,650,0,810,0,4504,6855,6363,5927,7120,6047,0.09008,0.1371,0.12726,0.11854,0.1424,0.12094,8
2237,120000,1,2,1,34,1,-2,-2,-2,-2,-2,0,0,0,0,0,0,0,0,0,0,0,0,1,0,0,0,0,0,0,0.0,0.0,0.0,0.0,0.0,0.0,-9
2238,50000,0,3,1,50,2,0,0,0,0,0,8917,10080,11106,12109,12206,13915,1468,1494,1497,594,2066,0,1,7449,8586,9609,11515,10140,13915,0.14898,0.17172,0.19218,0.2303,0.2028,0.2783,2
2239,80000,0,2,1,37,2,2,2,2,2,2,58024,59300,59831,60554,61938,63269,2800,2100,2300,2500,2500,500,1,55224,57200,57531,58054,59438,62769,0.6903,0.715,0.7191375,0.725675,0.742975,0.7846125,12
2240,20000,0,2,1,45,4,3,2,0,0,0,21605,20987,20200,19600,19600,20000,0,0,0,0,400,0,1,21605,20987,20200,19600,19200,20000,1.08025,1.04935,1.01,0.98,0.96,1.0,9
2241,30000,1,2,2,27,0,0,0,0,2,2,8476,9677,10715,13218,12709,17463,1500,1500,3000,0,5000,0,0,6976,8177,7715,13218,7709,17463,0.23253333333333334,0.2725666666666667,0.25716666666666665,0.4406,0.2569666666666667,0.5821,4
2242,30000,0,1,1,30,0,0,0,0,0,0,10024,12855,14634,16378,16961,19669,3000,2000,2000,1000,3000,1000,1,7024,10855,12634,15378,13961,18669,0.23413333333333333,0.36183333333333334,0.42113333333333336,0.5126,0.46536666666666665,0.6223,0
2243,360000,0,3,1,62,0,0,0,0,0,2,234825,242378,235716,171573,95455,91687,15000,12000,10000,10000,0,10000,1,219825,230378,225716,161573,95455,81687,0.610625,0.6399388888888888,0.6269888888888889,0.4488138888888889,0.2651527777777778,0.22690833333333332,2
2244,240000,0,2,1,39,1,2,0,0,0,0,245338,234661,234364,235982,239281,244329,0,10200,10200,8725,9068,9068,1,245338,224461,224164,227257,230213,235261,1.0222416666666667,0.9352541666666667,0.9340166666666667,0.9469041666666667,0.9592208333333333,0.9802541666666666,3
2245,380000,1,2,1,33,1,-1,-1,-1,-1,0,0,73,32510,474,25877,45038,73,32789,474,25877,20000,10000,1,-73,-32716,32036,-25403,5877,35038,-0.00019210526315789473,-0.08609473684210527,0.08430526315789473,-0.06685,0.01546578947368421,0.09220526315789473,-3
2246,260000,0,4,1,37,0,0,0,0,0,0,9801,11115,11930,12954,14246,15733,1485,1300,1229,1521,1728,1610,1,8316,9815,10701,11433,12518,14123,0.03198461538461538,0.03775,0.041157692307692305,0.04397307692307692,0.048146153846153845,0.05431923076923077,0
2247,20000,1,2,2,28,1,2,0,0,0,0,20583,19942,16614,15941,13205,6009,0,1358,1065,327,187,325,0,20583,18584,15549,15614,13018,5684,1.02915,0.9292,0.77745,0.7807,0.6509,0.2842,3
2248,290000,1,1,2,46,0,-1,-1,-1,-1,0,289002,1332,21429,2228,156721,157203,1343,21542,2239,156733,7219,17512,0,287659,-20210,19190,-154505,149502,139691,0.9919275862068966,-0.0696896551724138,0.06617241379310344,-0.5327758620689655,0.5155241379310345,0.48169310344827587,-4
2249,80000,1,3,1,40,0,0,0,-1,0,0,80855,78074,38360,60060,59322,59973,2800,2700,61400,2312,2800,2800,1,78055,75374,-23040,57748,56522,57173,0.9756875,0.942175,-0.288,0.72185,0.706525,0.7146625,-1
2250,100000,1,2,2,35,0,0,0,0,0,0,98118,99577,95736,98679,67007,67485,3500,4000,5700,2507,2500,3000,0,94618,95577,90036,96172,64507,64485,0.94618,0.95577,0.90036,0.96172,0.64507,0.64485,0
2251,200000,0,2,1,43,2,3,2,2,2,2,94529,92126,94772,92368,101837,103764,0,5000,0,12000,3700,0,1,94529,87126,94772,80368,98137,103764,0.472645,0.43563,0.47386,0.40184,0.490685,0.51882,13
2252,50000,0,3,1,39,0,0,0,0,0,0,43127,44413,45697,46873,47188,48532,2000,2000,2000,2000,2000,2000,1,41127,42413,43697,44873,45188,46532,0.82254,0.84826,0.87394,0.89746,0.90376,0.93064,0
2253,210000,1,1,2,34,1,2,2,-1,-1,-2,3824,2045,0,322,150,546,0,0,322,150,546,0,0,3824,2045,-322,172,-396,546,0.01820952380952381,0.009738095238095238,-0.0015333333333333334,0.0008190476190476191,-0.0018857142857142857,0.0026,1
2254,20000,1,2,2,22,0,0,0,0,0,0,15499,16505,35110,19495,19019,18134,1270,1320,2260,784,1000,2000,0,14229,15185,32850,18711,18019,16134,0.71145,0.75925,1.6425,0.93555,0.90095,0.8067,0
2255,50000,1,3,1,47,0,0,0,0,2,0,29336,30502,31161,25294,24843,19576,1641,1300,1629,0,1000,1007,1,27695,29202,29532,25294,23843,18569,0.5539,0.58404,0.59064,0.50588,0.47686,0.37138,2
2256,300000,0,2,1,66,0,0,0,0,0,0,259513,257866,261088,257288,256369,212395,10000,15000,9500,11000,9000,6000,1,249513,242866,251588,246288,247369,206395,0.83171,0.8095533333333333,0.8386266666666666,0.82096,0.8245633333333333,0.6879833333333333,0
2257,200000,1,2,2,36,0,0,0,0,0,0,131694,122349,112715,102542,92335,81667,4269,3891,3488,3250,2755,2530,0,127425,118458,109227,99292,89580,79137,0.637125,0.59229,0.546135,0.49646,0.4479,0.395685,0
2258,400000,1,1,1,32,-2,-2,-2,-2,-2,-2,3616,0,3328,3328,3828,4893,0,6656,3328,3828,4893,4687,1,3616,-6656,0,-500,-1065,206,0.00904,-0.01664,0.0,-0.00125,-0.0026625,0.000515,-12
2259,180000,0,1,2,26,-2,-2,-2,-2,-2,-1,-106,-200,-200,-200,0,4709,0,0,0,200,4709,0,0,-106,-200,-200,-400,-4709,4709,-0.0005888888888888889,-0.0011111111111111111,-0.0011111111111111111,-0.0022222222222222222,-0.02616111111111111,0.02616111111111111,-11
2260,360000,1,2,1,43,-2,-2,-2,-2,-2,-2,0,0,0,0,0,0,0,0,0,0,0,0,1,0,0,0,0,0,0,0.0,0.0,0.0,0.0,0.0,0.0,-12
2261,180000,1,3,3,40,0,0,0,0,0,0,30712,27597,25427,21230,17357,13303,1774,3000,892,1000,620,440,0,28938,24597,24535,20230,16737,12863,0.16076666666666667,0.13665,0.13630555555555557,0.11238888888888889,0.09298333333333333,0.07146111111111111,0
2262,230000,0,3,1,39,0,0,0,0,-1,-1,53672,75305,56484,38363,4867,2736,25000,5000,5000,4867,2736,0,1,28672,70305,51484,33496,2131,2736,0.1246608695652174,0.30567391304347824,0.22384347826086956,0.14563478260869564,0.009265217391304348,0.011895652173913043,-2
2263,350000,1,3,2,28,-2,-2,-2,-2,-2,-2,0,0,0,0,0,0,0,0,0,0,0,0,0,0,0,0,0,0,0,0.0,0.0,0.0,0.0,0.0,0.0,-12
2264,10000,0,2,1,33,0,0,0,0,0,0,10146,9352,9919,10400,10123,19813,1158,1200,1137,335,351,1000,1,8988,8152,8782,10065,9772,18813,0.8988,0.8152,0.8782,1.0065,0.9772,1.8813,0
2265,230000,0,1,2,26,0,0,0,0,0,0,42314,37735,32358,114443,111520,105779,1804,2713,106028,3827,5060,30000,0,40510,35022,-73670,110616,106460,75779,0.1761304347826087,0.1522695652173913,-0.32030434782608697,0.4809391304347826,0.4628695652173913,0.3294739130434783,0
2266,230000,1,2,1,44,-1,-1,-1,-1,-1,-1,5630,390,5090,19394,205,0,390,5090,19394,0,3916,3916,1,5240,-4700,-14304,19394,-3711,-3916,0.022782608695652174,-0.02043478260869565,-0.06219130434782609,0.08432173913043478,-0.016134782608695653,-0.01702608695652174,-6
2267,50000,0,2,2,26,0,0,0,0,0,0,47974,48527,49381,9999,8793,9138,2500,2000,324,1000,1000,500,0,45474,46527,49057,8999,7793,8638,0.90948,0.93054,0.98114,0.17998,0.15586,0.17276,0
2268,20000,1,2,2,23,1,2,2,2,2,2,6218,6959,8635,8350,9063,8771,1000,1800,0,1000,0,1000,0,5218,5159,8635,7350,9063,7771,0.2609,0.25795,0.43175,0.3675,0.45315,0.38855,11
2269,340000,1,4,2,30,0,0,0,0,0,-1,47001,47664,38192,39234,20960,360,2000,2000,2000,3000,360,360,0,45001,45664,36192,36234,20600,0,0.13235588235294118,0.13430588235294116,0.10644705882352941,0.10657058823529411,0.060588235294117644,0.0,-1
2270,80000,0,1,2,26,0,0,0,0,0,0,79565,78617,79229,77858,79566,74746,3481,3000,3000,3000,3000,1656,0,76084,75617,76229,74858,76566,73090,0.95105,0.9452125,0.9528625,0.935725,0.957075,0.913625,0
2271,80000,1,3,3,43,0,0,-2,-2,-1,-1,3408,-11,-11,-11,2429,905,0,0,0,2440,905,9213,0,3408,-11,-11,-2451,1524,-8308,0.0426,-0.0001375,-0.0001375,-0.0306375,0.01905,-0.10385,-6
2272,80000,1,3,1,32,-2,-2,-2,-2,-2,-2,0,0,0,0,0,0,0,0,0,0,0,0,1,0,0,0,0,0,0,0.0,0.0,0.0,0.0,0.0,0.0,-12
2273,130000,0,1,2,33,1,-2,-2,-1,0,0,0,0,0,8495,6480,0,0,0,8495,0,0,0,0,0,0,-8495,8495,6480,0,0.0,0.0,-0.06534615384615385,0.06534615384615385,0.049846153846153846,0.0,-4
2274,280000,0,1,1,28,1,2,0,0,0,2,285249,276229,277026,280771,270992,111885,5,10031,10021,7111,34,171574,1,285244,266198,267005,273660,270958,-59689,1.0187285714285714,0.9507071428571429,0.9535892857142857,0.9773571428571428,0.9677071428571429,-0.213175,5
2275,50000,0,1,2,55,0,-1,-1,-1,-1,0,11045,3115,7161,5351,791,47774,3115,7161,5351,791,46983,2025,0,7930,-4046,1810,4560,-46192,45749,0.1586,-0.08092,0.0362,0.0912,-0.92384,0.91498,-4
2276,20000,1,2,2,25,0,0,0,0,0,0,18519,20195,19638,17198,14253,18475,2000,1376,1121,460,6000,624,0,16519,18819,18517,16738,8253,17851,0.82595,0.94095,0.92585,0.8369,0.41265,0.89255,0
2277,200000,1,3,1,44,1,-2,-2,-2,-2,-2,0,0,0,0,0,0,0,0,0,0,0,0,1,0,0,0,0,0,0,0.0,0.0,0.0,0.0,0.0,0.0,-9
2278,280000,1,1,2,28,0,0,0,0,0,-1,51439,44605,45426,38563,29669,24892,20000,10000,0,0,24892,106941,0,31439,34605,45426,38563,4777,-82049,0.11228214285714286,0.12358928571428572,0.1622357142857143,0.137725,0.017060714285714287,-0.29303214285714285,-1
2279,20000,0,2,2,24,0,0,0,0,0,0,17924,18475,19539,19396,11643,11578,1400,1380,1181,1000,500,500,0,16524,17095,18358,18396,11143,11078,0.8262,0.85475,0.9179,0.9198,0.55715,0.5539,0
2280,150000,1,1,2,27,0,0,0,0,0,0,51032,69242,65366,62283,60942,55878,30000,20142,3759,7022,20000,10000,0,21032,49100,61607,55261,40942,45878,0.14021333333333333,0.3273333333333333,0.4107133333333333,0.36840666666666666,0.27294666666666667,0.3058533333333333,0
2281,100000,1,2,1,30,0,0,0,0,0,2,100963,99679,101023,93514,79361,77373,3700,3700,4148,6000,0,3000,1,97263,95979,96875,87514,79361,74373,0.97263,0.95979,0.96875,0.87514,0.79361,0.74373,2
2282,150000,1,2,2,34,0,0,0,0,0,0,18631,18831,15729,11907,14103,14413,3000,3000,1353,5000,3000,5000,0,15631,15831,14376,6907,11103,9413,0.10420666666666667,0.10554,0.09584,0.046046666666666666,0.07402,0.06275333333333333,0
2283,200000,1,1,1,40,-2,-2,-2,-2,-2,-2,2552,8064,32082,6914,1905,3244,8084,32105,7186,1905,3244,9768,1,-5532,-24041,24896,5009,-1339,-6524,-0.02766,-0.120205,0.12448,0.025045,-0.006695,-0.03262,-12
2284,170000,0,4,1,56,0,0,0,0,0,0,86229,134760,132615,131213,129293,128379,55000,5012,5000,4516,5000,5000,1,31229,129748,127615,126697,124293,123379,0.1837,0.7632235294117647,0.7506764705882353,0.7452764705882353,0.7311352941176471,0.7257588235294118,0
2285,50000,1,1,2,23,0,0,0,0,0,0,48064,49362,48038,8760,9646,7747,2091,1310,1000,1000,277,296,0,45973,48052,47038,7760,9369,7451,0.91946,0.96104,0.94076,0.1552,0.18738,0.14902,0
2286,230000,1,1,2,31,-2,-2,-2,-1,-1,-1,0,0,196,533,1238,957,0,196,533,1238,957,1187,0,0,-196,-337,-705,281,-230,0.0,-0.0008521739130434783,-0.0014652173913043479,-0.0030652173913043477,0.0012217391304347827,-0.001,-9
2287,80000,1,2,1,29,0,0,0,0,0,0,78293,79555,77025,76991,79066,75356,3161,4000,3000,3500,3100,5700,1,75132,75555,74025,73491,75966,69656,0.93915,0.9444375,0.9253125,0.9186375,0.949575,0.8707,0
2288,80000,1,1,2,25,0,0,0,0,0,0,3409,4489,5345,5454,5598,178,1144,1000,109,144,0,0,0,2265,3489,5236,5310,5598,178,0.0283125,0.0436125,0.06545,0.066375,0.069975,0.002225,0
2289,30000,1,1,2,27,0,0,0,0,0,2,20234,20476,21991,22544,24061,23428,2000,3000,2000,2000,1000,0,0,18234,17476,19991,20544,23061,23428,0.6078,0.5825333333333333,0.6663666666666667,0.6848,0.7687,0.7809333333333334,2
2290,60000,1,2,1,30,2,0,0,0,0,0,60558,59361,60167,58078,59198,60677,3500,3000,1000,2000,2000,1000,1,57058,56361,59167,56078,57198,59677,0.9509666666666666,0.93935,0.9861166666666666,0.9346333333333333,0.9533,0.9946166666666667,2
2291,80000,1,1,2,37,-1,-1,-1,-1,-1,-1,6734,1990,4500,4640,3966,3410,1990,4500,4640,3966,3410,879,0,4744,-2510,-140,674,556,2531,0.0593,-0.031375,-0.00175,0.008425,0.00695,0.0316375,-6
2292,200000,0,1,1,27,2,2,2,2,0,0,177998,174350,158632,154522,135375,142526,14600,7000,0,6000,11500,24,1,163398,167350,158632,148522,123875,142502,0.81699,0.83675,0.79316,0.74261,0.619375,0.71251,8
2293,260000,0,3,2,52,1,-2,-2,-2,-2,-2,0,0,0,0,0,0,0,0,0,0,0,4012,0,0,0,0,0,0,-4012,0.0,0.0,0.0,0.0,0.0,-0.01543076923076923,-9
2294,360000,1,1,1,46,0,-1,0,0,0,0,42094,10594,31532,46342,56571,65268,10600,30000,20000,15000,10000,10000,1,31494,-19406,11532,31342,46571,55268,0.08748333333333333,-0.053905555555555554,0.03203333333333333,0.08706111111111112,0.1293638888888889,0.15352222222222223,-1
2295,130000,0,2,2,41,0,0,0,0,0,0,124391,126032,123746,123107,42897,39378,4442,5200,5012,2500,5000,2000,0,119949,120832,118734,120607,37897,37378,0.9226846153846154,0.9294769230769231,0.9133384615384615,0.9277461538461539,0.2915153846153846,0.28752307692307694,0
2296,150000,0,1,2,35,0,0,0,0,0,0,114997,118821,121362,124687,125223,98890,4884,5100,6000,3142,3300,3323,0,110113,113721,115362,121545,121923,95567,0.7340866666666667,0.75814,0.76908,0.8103,0.81282,0.6371133333333333,0
2297,180000,1,2,1,36,-1,-1,-1,-1,-1,-1,1000,92,92,603,1760,826,92,92,603,1760,826,826,1,908,0,-511,-1157,934,0,0.005044444444444444,0.0,-0.002838888888888889,-0.006427777777777778,0.005188888888888889,0.0,-6
2298,180000,1,2,2,32,1,-2,-2,-2,-2,-2,0,0,0,0,0,0,0,0,0,0,0,0,0,0,0,0,0,0,0,0.0,0.0,0.0,0.0,0.0,0.0,-9
2299,50000,1,3,1,44,0,0,0,0,0,0,45858,46315,47435,48290,49257,49345,2000,1865,1720,1687,1732,2007,1,43858,44450,45715,46603,47525,47338,0.87716,0.889,0.9143,0.93206,0.9505,0.94676,0
2300,210000,1,1,1,32,-1,0,-1,-1,-1,-1,7544,5525,6876,2692,5560,2866,5255,7067,2696,5560,2866,8680,1,2289,-1542,4180,-2868,2694,-5814,0.0109,-0.007342857142857143,0.019904761904761904,-0.013657142857142857,0.012828571428571429,-0.027685714285714286,-5
2301,90000,1,1,2,28,1,2,0,0,0,2,52061,50472,46226,40920,29863,19674,79,5000,10009,10000,0,7000,0,51982,45472,36217,30920,29863,12674,0.5775777777777777,0.5052444444444445,0.4024111111111111,0.34355555555555556,0.3318111111111111,0.1408222222222222,5
2302,210000,0,2,1,42,-1,-1,-1,-1,-1,-1,3096,5260,3298,2972,975,3441,5260,3298,2972,975,3441,1666,1,-2164,1962,326,1997,-2466,1775,-0.010304761904761905,0.009342857142857142,0.0015523809523809524,0.00950952380952381,-0.011742857142857143,0.008452380952380953,-6
2303,300000,1,1,1,38,-1,-1,-1,-2,-2,-2,1008,228,0,0,0,0,228,0,0,888,0,0,1,780,228,0,-888,0,0,0.0026,0.00076,0.0,-0.00296,0.0,0.0,-9
2304,30000,0,2,2,25,0,0,0,0,0,0,8864,10062,11581,12580,13716,14828,1500,2000,1500,1500,1500,2000,0,7364,8062,10081,11080,12216,12828,0.24546666666666667,0.2687333333333333,0.33603333333333335,0.36933333333333335,0.4072,0.4276,0
2305,110000,1,2,2,29,2,0,0,0,0,0,99876,72548,74379,75878,78503,80451,3000,3000,3000,3500,3000,3000,0,96876,69548,71379,72378,75503,77451,0.8806909090909091,0.6322545454545454,0.6489,0.6579818181818182,0.686390909090909,0.7041,2
2306,120000,1,2,2,27,-1,-1,-1,2,-1,-1,1184,1066,5079,2528,4007,7457,1066,5079,0,4007,7457,2819,0,118,-4013,5079,-1479,-3450,4638,0.0009833333333333332,-0.03344166666666667,0.042325,-0.012325,-0.02875,0.03865,-3
2307,320000,1,1,2,29,0,0,0,0,0,0,198441,202806,207050,201114,190921,191781,10000,10000,10000,10000,7000,10000,0,188441,192806,197050,191114,183921,181781,0.588878125,0.60251875,0.61578125,0.59723125,0.574753125,0.568065625,0
2308,360000,1,1,2,43,1,-1,-1,-1,-1,-1,0,10121,390,2809,390,390,10121,780,2809,390,390,390,0,-10121,9341,-2419,2419,0,0,-0.02811388888888889,0.025947222222222222,-0.0067194444444444446,0.0067194444444444446,0.0,0.0,-4
2309,220000,1,1,2,32,0,0,0,0,0,0,33710,33702,31682,33407,35128,37826,8959,1300,2000,2000,3000,20000,0,24751,32402,29682,31407,32128,17826,0.11250454545454545,0.14728181818181818,0.13491818181818183,0.14275909090909092,0.14603636363636363,0.08102727272727273,0
2310,200000,1,2,1,38,-2,-2,-2,-2,-2,-2,1430,6002,2400,2185,6718,2298,6002,2400,2185,6718,2298,2851,1,-4572,3602,215,-4533,4420,-553,-0.02286,0.01801,0.001075,-0.022665,0.0221,-0.002765,-12
2311,70000,0,1,2,50,0,0,0,0,0,0,56551,34489,32669,31429,31749,21385,1900,1630,890,1300,762,1000,0,54651,32859,31779,30129,30987,20385,0.7807285714285714,0.46941428571428573,0.45398571428571427,0.4304142857142857,0.44267142857142855,0.2912142857142857,0
2312,360000,0,1,2,29,1,-1,-1,-1,-1,-1,-4316,60054,187734,17328,10658,77898,65000,188000,17384,20000,78000,46677,0,-69316,-127946,170350,-2672,-67342,31221,-0.19254444444444443,-0.35540555555555553,0.4731944444444444,-0.007422222222222222,-0.18706111111111112,0.086725,-4
2313,100000,0,2,2,26,0,0,0,0,0,0,73070,74847,97369,98232,97752,0,10000,43000,5000,3000,0,0,0,63070,31847,92369,95232,97752,0,0.6307,0.31847,0.92369,0.95232,0.97752,0.0,0
2314,180000,0,2,2,26,0,0,0,0,0,0,67276,65363,68877,48958,45255,41870,3000,10000,2000,1500,1500,1600,0,64276,55363,66877,47458,43755,40270,0.3570888888888889,0.30757222222222225,0.37153888888888886,0.26365555555555553,0.24308333333333335,0.2237222222222222,0
2315,130000,0,1,2,32,-1,-1,-1,-2,-2,-1,32236,41510,-1523,-1523,-1523,48477,10000,0,0,0,50000,5000,0,22236,41510,-1523,-1523,-51523,43477,0.17104615384615385,0.3193076923076923,-0.011715384615384615,-0.011715384615384615,-0.3963307692307692,0.3344384615384615,-8
2316,140000,1,2,2,26,0,0,0,0,-1,-1,12436,14910,13780,13710,488,-1450,3380,1200,2000,500,0,0,0,9056,13710,11780,13210,488,-1450,0.06468571428571429,0.09792857142857143,0.08414285714285714,0.09435714285714286,0.0034857142857142856,-0.010357142857142856,-2
2317,200000,0,1,2,33,0,0,0,0,2,0,197272,196700,194403,197746,190198,192015,8600,7700,11100,0,5600,5640,0,188672,189000,183303,197746,184598,186375,0.94336,0.945,0.916515,0.98873,0.92299,0.931875,2
2318,120000,0,1,2,33,1,-2,-2,-1,-1,-2,0,0,0,600,0,0,0,0,600,0,0,0,0,0,0,-600,600,0,0,0.0,0.0,-0.005,0.005,0.0,0.0,-7
2319,50000,1,2,1,34,3,3,2,2,2,2,47904,48240,48602,46289,44837,44535,2000,2001,499,2000,2000,1500,1,45904,46239,48103,44289,42837,43035,0.91808,0.92478,0.96206,0.88578,0.85674,0.8607,14
2320,140000,0,2,2,34,1,2,2,0,0,0,94153,100214,97720,98997,101439,103840,8500,0,3800,4200,4250,4100,0,85653,100214,93920,94797,97189,99740,0.6118071428571429,0.7158142857142857,0.6708571428571428,0.6771214285714285,0.6942071428571429,0.7124285714285714,5
2321,200000,0,1,2,39,-2,-2,-2,-2,-2,-2,-200,-200,-200,0,60800,0,0,0,200,60800,0,0,0,-200,-200,-400,-60800,60800,0,-0.001,-0.001,-0.002,-0.304,0.304,0.0,-12
2322,90000,1,2,2,47,0,0,0,-2,-2,-2,17247,11691,0,0,0,0,1000,0,0,0,0,0,0,16247,11691,0,0,0,0,0.18052222222222222,0.1299,0.0,0.0,0.0,0.0,-6
2323,360000,1,2,2,27,0,-1,-1,-1,-1,0,13102,5628,1480,2330,2286,4385,5655,1480,2330,2550,3000,3000,0,7447,4148,-850,-220,-714,1385,0.02068611111111111,0.011522222222222222,-0.002361111111111111,-0.0006111111111111111,-0.0019833333333333335,0.0038472222222222224,-4
2324,30000,0,2,2,37,0,0,0,0,-1,0,31404,32302,27951,28475,29085,26810,1500,1476,1000,31000,1000,995,0,29904,30826,26951,-2525,28085,25815,0.9968,1.0275333333333334,0.8983666666666666,-0.08416666666666667,0.9361666666666667,0.8605,-1
2325,30000,0,2,1,37,0,0,0,2,2,2,19625,20673,23702,23026,27798,27219,1671,3700,0,5335,0,2054,1,17954,16973,23702,17691,27798,25165,0.5984666666666667,0.5657666666666666,0.7900666666666667,0.5897,0.9266,0.8388333333333333,6
2326,60000,1,2,1,51,0,0,0,0,0,0,57252,57771,47778,37858,36467,34419,2501,2032,2005,1507,1501,1502,1,54751,55739,45773,36351,34966,32917,0.9125166666666666,0.9289833333333334,0.7628833333333334,0.60585,0.5827666666666667,0.5486166666666666,0
2327,60000,1,2,1,44,1,2,0,0,0,0,61049,57244,47551,36795,30596,28354,0,2400,2100,1300,1300,1300,1,61049,54844,45451,35495,29296,27054,1.0174833333333333,0.9140666666666667,0.7575166666666666,0.5915833333333333,0.4882666666666667,0.4509,3
2328,320000,1,3,1,44,1,-1,2,2,-1,-1,-1,507,507,-900,3750,3216,508,0,0,5330,3216,2041,1,-509,507,507,-6230,534,1175,-0.001590625,0.001584375,0.001584375,-0.01946875,0.00166875,0.003671875,2
2329,180000,1,2,1,33,0,0,0,0,0,-1,30781,31202,31188,32979,22526,13338,2000,1408,2979,2526,13338,15186,1,28781,29794,28209,30453,9188,-1848,0.15989444444444445,0.1655222222222222,0.15671666666666667,0.16918333333333332,0.05104444444444445,-0.010266666666666667,-1
2330,230000,1,3,1,47,-1,-1,-1,-1,-1,-1,6200,5482,15900,1678,0,764,5482,15900,1678,0,764,0,1,718,-10418,14222,1678,-764,764,0.0031217391304347824,-0.04529565217391304,0.061834782608695654,0.007295652173913043,-0.0033217391304347825,0.0033217391304347825,-6
2331,50000,1,2,2,32,0,0,2,0,0,0,40253,40757,33922,30097,29013,28167,5806,6,1000,1000,1200,1100,0,34447,40751,32922,29097,27813,27067,0.68894,0.81502,0.65844,0.58194,0.55626,0.54134,2
2332,70000,0,1,2,30,0,0,0,0,2,0,68971,69872,66932,69043,70252,55732,2700,3100,3900,2500,2500,2500,0,66271,66772,63032,66543,67752,53232,0.9467285714285715,0.9538857142857143,0.9004571428571428,0.9506142857142857,0.9678857142857142,0.7604571428571428,2
2333,20000,0,2,2,27,1,3,2,2,2,2,19443,18851,19248,18648,20040,19464,0,1000,0,2000,0,817,0,19443,17851,19248,16648,20040,18647,0.97215,0.89255,0.9624,0.8324,1.002,0.93235,12
2334,200000,1,1,2,34,-1,-1,-1,-1,-1,-2,2603,11381,0,1000,0,0,11381,0,1000,0,0,0,0,-8778,11381,-1000,1000,0,0,-0.04389,0.056905,-0.005,0.005,0.0,0.0,-7
2335,200000,1,1,2,47,-1,-1,-1,-1,-1,-1,30177,2039,174406,133073,45373,973,2061,175000,133100,46000,1000,0,0,28116,-172961,41306,87073,44373,973,0.14058,-0.864805,0.20653,0.435365,0.221865,0.004865,-6
2336,140000,1,2,2,32,2,0,0,2,2,2,103181,107446,125702,124182,124155,137176,6000,20000,2000,3500,15000,6000,0,97181,87446,123702,120682,109155,131176,0.69415,0.6246142857142857,0.8835857142857143,0.8620142857142857,0.7796785714285714,0.9369714285714286,8
2337,90000,1,2,1,23,0,0,0,0,0,0,12770,14241,14895,25195,23769,2269,2500,1200,10500,7000,1000,0,1,10270,13041,4395,18195,22769,2269,0.11411111111111111,0.1449,0.04883333333333333,0.20216666666666666,0.2529888888888889,0.02521111111111111,0
2338,60000,1,2,1,39,-1,-1,-1,-2,-2,-1,12545,1217,0,0,0,465,1217,0,0,0,465,0,1,11328,1217,0,0,-465,465,0.1888,0.020283333333333334,0.0,0.0,-0.00775,0.00775,-8
2339,20000,1,2,1,28,-1,-1,0,0,0,0,1424,10094,15018,15991,18442,18827,10094,10000,1549,3000,790,1000,1,-8670,94,13469,12991,17652,17827,-0.4335,0.0047,0.67345,0.64955,0.8826,0.89135,-2
2340,180000,1,2,2,27,2,2,2,2,0,0,126195,127881,128491,124080,126154,130064,6000,4575,0,4600,6000,3100,0,120195,123306,128491,119480,120154,126964,0.66775,0.6850333333333334,0.7138388888888889,0.6637777777777778,0.6675222222222222,0.7053555555555555,8
2341,30000,0,3,1,52,0,0,0,0,0,0,28541,28889,30050,29797,18464,12235,1502,2002,1025,1230,1042,0,1,27039,26887,29025,28567,17422,12235,0.9013,0.8962333333333333,0.9675,0.9522333333333334,0.5807333333333333,0.4078333333333333,0
2342,400000,1,1,1,33,-2,-2,-2,-2,-2,-2,-4,1054,1420,-20,-20,-20,1058,1427,0,0,0,0,1,-1062,-373,1420,-20,-20,-20,-0.002655,-0.0009325,0.00355,-5e-05,-5e-05,-5e-05,-12
2343,30000,0,2,1,33,2,2,0,0,0,0,42646,30060,28391,26156,25377,27422,2159,1500,1000,1000,3800,0,1,40487,28560,27391,25156,21577,27422,1.3495666666666666,0.952,0.9130333333333334,0.8385333333333334,0.7192333333333333,0.9140666666666667,4
2344,50000,1,2,2,23,0,0,0,0,0,0,49100,47910,32842,19748,19403,19536,15000,2024,5004,1000,1000,1000,0,34100,45886,27838,18748,18403,18536,0.682,0.91772,0.55676,0.37496,0.36806,0.37072,0
2345,160000,1,1,2,33,2,2,2,2,2,2,132510,128981,138289,134773,142913,146003,0,13000,200,10500,5600,5200,0,132510,115981,138089,124273,137313,140803,0.8281875,0.72488125,0.86305625,0.77670625,0.85820625,0.88001875,12
2346,200000,0,2,1,37,0,0,0,0,0,0,149303,156632,136685,137432,138059,126615,30000,30000,4148,15100,8029,15004,1,119303,126632,132537,122332,130030,111611,0.596515,0.63316,0.662685,0.61166,0.65015,0.558055,0
2347,140000,1,2,1,49,-1,-1,-2,-2,-2,-1,2457,0,0,0,0,579,0,0,0,0,579,1968,1,2457,0,0,0,-579,-1389,0.01755,0.0,0.0,0.0,-0.004135714285714286,-0.00992142857142857,-9
2348,400000,1,2,2,36,0,0,0,0,0,0,69376,61204,50773,39676,30680,27761,2255,1421,1381,770,731,600,0,67121,59783,49392,38906,29949,27161,0.1678025,0.1494575,0.12348,0.097265,0.0748725,0.0679025,0
2349,50000,0,3,2,36,2,2,7,7,7,7,2400,2400,2400,2400,2400,2400,0,0,0,0,0,0,0,2400,2400,2400,2400,2400,2400,0.048,0.048,0.048,0.048,0.048,0.048,32
2350,290000,0,2,2,43,0,0,0,0,-1,-1,124362,111594,58039,3818,1318,0,5100,2507,1500,2000,0,1333,0,119262,109087,56539,1818,1318,-1333,0.41124827586206897,0.37616206896551724,0.19496206896551724,0.0062689655172413795,0.004544827586206897,-0.004596551724137931,-2
2351,50000,1,3,1,45,0,0,0,-2,-1,-1,4410,4055,0,0,6553,19653,4050,0,0,6553,13100,0,1,360,4055,0,-6553,-6547,19653,0.0072,0.0811,0.0,-0.13106,-0.13094,0.39306,-4
2352,180000,1,2,2,48,-1,-1,-1,-1,-1,-1,10000,10000,10000,10000,20000,10338,10000,10000,10000,20000,10338,20894,0,0,0,0,-10000,9662,-10556,0.0,0.0,0.0,-0.05555555555555555,0.053677777777777776,-0.058644444444444443,-6
2353,30000,1,1,2,27,0,0,0,0,0,0,30342,29337,29956,29782,27290,27865,1500,1485,2000,1000,1014,4413,0,28842,27852,27956,28782,26276,23452,0.9614,0.9284,0.9318666666666666,0.9594,0.8758666666666667,0.7817333333333333,0
2354,260000,1,2,1,48,0,0,0,0,0,0,85378,71870,72994,57382,58522,59748,2664,2376,2084,2095,2169,2182,1,82714,69494,70910,55287,56353,57566,0.3181307692307692,0.2672846153846154,0.2727307692307692,0.21264230769230769,0.21674230769230768,0.2214076923076923,0
2355,120000,1,2,1,41,0,0,0,0,0,0,118131,116607,108720,92649,89533,89204,4211,3710,3184,3200,3200,3133,1,113920,112897,105536,89449,86333,86071,0.9493333333333334,0.9408083333333334,0.8794666666666666,0.7454083333333333,0.7194416666666666,0.7172583333333333,0
2356,20000,1,2,1,29,0,0,2,3,3,2,16196,17825,20234,20510,19897,19900,2200,3000,900,0,500,0,1,13996,14825,19334,20510,19397,19900,0.6998,0.74125,0.9667,1.0255,0.96985,0.995,10
2357,140000,0,2,2,36,1,2,2,2,2,2,44570,45563,46115,47053,48150,49009,2000,1600,2000,2000,1800,0,0,42570,43963,44115,45053,46350,49009,0.30407142857142855,0.31402142857142856,0.31510714285714286,0.32180714285714285,0.33107142857142857,0.3500642857142857,11
2358,110000,1,2,2,33,0,0,0,0,0,0,103195,102713,103034,103112,94403,96072,5200,3804,4500,3400,3500,7700,0,97995,98909,98534,99712,90903,88372,0.8908636363636364,0.8991727272727272,0.8957636363636363,0.9064727272727273,0.8263909090909091,0.8033818181818182,0
2359,120000,1,3,2,50,-1,-1,-1,0,0,0,6574,1374,45802,53231,25888,27114,1374,45812,10000,900,3000,3000,0,5200,-44438,35802,52331,22888,24114,0.043333333333333335,-0.3703166666666667,0.29835,0.43609166666666666,0.19073333333333334,0.20095,-3
2360,300000,1,3,1,40,-2,-2,-2,-2,-2,-2,0,0,0,0,0,0,0,0,0,0,0,0,1,0,0,0,0,0,0,0.0,0.0,0.0,0.0,0.0,0.0,-12
2361,100000,1,1,1,38,0,0,0,0,0,0,66762,68566,65132,48738,51020,51948,5000,2436,3000,3000,2000,3000,1,61762,66130,62132,45738,49020,48948,0.61762,0.6613,0.62132,0.45738,0.4902,0.48948,0
2362,50000,0,1,2,25,0,0,0,-2,-2,-2,50401,46275,0,0,0,0,5000,0,0,0,0,0,0,45401,46275,0,0,0,0,0.90802,0.9255,0.0,0.0,0.0,0.0,-6
2363,360000,1,2,2,34,0,0,0,0,0,0,282674,277569,246380,236139,241056,246297,12200,10500,8500,8750,9200,9800,0,270474,267069,237880,227389,231856,236497,0.7513166666666666,0.7418583333333333,0.6607777777777778,0.6316361111111111,0.6440444444444444,0.6569361111111112,0
2364,180000,1,1,2,40,-2,-2,-2,-2,-2,-2,0,0,1040,258,0,0,0,1040,258,0,0,0,0,0,-1040,782,258,0,0,0.0,-0.0057777777777777775,0.004344444444444444,0.0014333333333333333,0.0,0.0,-12
2365,500000,1,2,1,45,1,-1,-1,-1,-2,-2,0,1376,3719,-200,-200,-200,1376,3723,1319,0,0,0,1,-1376,-2347,2400,-200,-200,-200,-0.002752,-0.004694,0.0048,-0.0004,-0.0004,-0.0004,-6
2366,20000,0,2,1,42,1,2,0,0,0,0,17614,17042,18052,18562,18814,19500,0,1300,810,700,1000,900,1,17614,15742,17242,17862,17814,18600,0.8807,0.7871,0.8621,0.8931,0.8907,0.93,3
2367,200000,1,1,1,29,0,0,0,0,0,2,21326,30928,124497,126854,139660,145455,10000,95000,4552,15002,8000,0,1,11326,-64072,119945,111852,131660,145455,0.05663,-0.32036,0.599725,0.55926,0.6583,0.727275,2
2368,260000,0,3,1,36,-1,0,0,0,0,0,154462,153799,77156,73658,70273,67100,7425,2795,2779,2947,3400,5000,1,147037,151004,74377,70711,66873,62100,0.5655269230769231,0.5807846153846153,0.2860653846153846,0.2719653846153846,0.25720384615384617,0.23884615384615385,-1
2369,180000,1,2,2,31,0,0,0,0,0,0,176731,177490,178659,138243,138023,137923,6814,7756,4788,5100,5500,5100,0,169917,169734,173871,133143,132523,132823,0.9439833333333333,0.9429666666666666,0.96595,0.7396833333333334,0.7362388888888889,0.7379055555555556,0
2370,80000,1,2,2,24,2,2,2,2,2,2,23787,23124,26700,27064,27685,27091,0,4300,1100,1200,0,2500,0,23787,18824,25600,25864,27685,24591,0.2973375,0.2353,0.32,0.3233,0.3460625,0.3073875,12
2371,50000,0,3,1,47,1,3,2,0,0,-1,4759,4540,4284,2946,1473,1473,0,0,0,0,1473,1473,1,4759,4540,4284,2946,0,0,0.09518,0.0908,0.08568,0.05892,0.0,0.0,5
2372,340000,0,2,1,38,0,0,-1,-1,-1,0,8347,5190,612,1429,19513,19650,2000,612,1429,19513,3000,3000,1,6347,4578,-817,-18084,16513,16650,0.01866764705882353,0.013464705882352941,-0.002402941176470588,-0.05318823529411765,0.04856764705882353,0.04897058823529412,-3
2373,400000,1,1,1,28,-1,-1,2,0,0,0,6500,405016,391178,392932,394410,410127,405016,0,14000,13560,28000,0,1,-398516,405016,377178,379372,366410,410127,-0.99629,1.01254,0.942945,0.94843,0.916025,1.0253175,0
2374,470000,1,2,1,49,0,-1,-1,-1,-1,-1,3388,1359,7650,6682,1942,0,1359,7650,6682,1942,0,5870,1,2029,-6291,968,4740,1942,-5870,0.0043170212765957445,-0.013385106382978724,0.0020595744680851065,0.010085106382978723,0.004131914893617021,-0.012489361702127659,-5
2375,30000,0,1,2,28,2,0,0,0,0,0,22329,23665,47968,24784,25784,2901,2000,1400,2000,1000,1000,1000,0,20329,22265,45968,23784,24784,1901,0.6776333333333333,0.7421666666666666,1.5322666666666667,0.7928,0.8261333333333334,0.06336666666666667,2
2376,90000,1,2,1,25,-1,-1,0,0,0,0,7766,13788,15459,43380,46632,14177,93788,10000,33000,5300,5000,2913,1,-86022,3788,-17541,38080,41632,11264,-0.9558,0.04208888888888889,-0.1949,0.4231111111111111,0.46257777777777775,0.12515555555555555,-2
2377,50000,0,2,1,57,0,0,0,0,0,0,46540,48520,47875,48110,18576,15339,2770,2100,1300,700,1000,1000,1,43770,46420,46575,47410,17576,14339,0.8754,0.9284,0.9315,0.9482,0.35152,0.28678,0
2378,150000,0,2,1,37,2,2,2,2,2,2,106628,100750,86686,78497,67612,55050,7400,0,4800,1800,0,2100,1,99228,100750,81886,76697,67612,52950,0.66152,0.6716666666666666,0.5459066666666667,0.5113133333333333,0.4507466666666667,0.353,12
2379,410000,0,2,1,45,-2,-2,-2,-2,-2,-2,597,2326,7670,1761,6930,0,2329,7670,1761,6930,0,2675,1,-1732,-5344,5909,-5169,6930,-2675,-0.004224390243902439,-0.013034146341463415,0.014412195121951219,-0.012607317073170731,0.016902439024390245,-0.006524390243902439,-12
2380,300000,0,1,2,36,0,0,0,0,0,0,295433,301521,308038,306154,295664,290329,13000,13116,11000,11000,12000,9300,0,282433,288405,297038,295154,283664,281029,0.9414433333333333,0.96135,0.9901266666666667,0.9838466666666666,0.9455466666666666,0.9367633333333333,0
2381,20000,1,2,1,48,1,-2,-2,-2,-2,-1,0,0,0,0,0,1473,0,0,0,0,1473,930,1,0,0,0,0,-1473,543,0.0,0.0,0.0,0.0,-0.07365,0.02715,-8
2382,200000,1,3,2,49,1,-2,-1,-1,-1,-2,0,0,3614,714,0,0,0,3614,721,0,0,6728,0,0,-3614,2893,714,0,-6728,0.0,-0.01807,0.014465,0.00357,0.0,-0.03364,-6
2383,220000,1,2,1,37,2,0,-1,-1,0,0,2345,2572,15,947,631,715,1007,16,1578,0,400,1,1,1338,2556,-1563,947,231,714,0.006081818181818182,0.011618181818181817,-0.0071045454545454545,0.004304545454545454,0.00105,0.0032454545454545453,0
2384,300000,1,1,2,29,-1,-1,-1,-1,-1,-2,3438,28,342,25022,0,0,28,342,25081,0,0,0,0,3410,-314,-24739,25022,0,0,0.011366666666666667,-0.0010466666666666667,-0.08246333333333333,0.08340666666666667,0.0,0.0,-7
2385,280000,0,1,1,47,-1,-1,-1,-1,-1,-1,3587,3187,3190,1982,3590,3590,3200,3203,1992,3608,3600,3602,1,387,-16,1198,-1626,-10,-12,0.0013821428571428572,-5.714285714285714e-05,0.0042785714285714285,-0.005807142857142857,-3.571428571428572e-05,-4.2857142857142856e-05,-6
2386,150000,1,2,2,37,0,0,0,0,0,0,80463,82513,84271,43832,33963,34638,3348,3490,1402,1233,1240,1284,0,77115,79023,82869,42599,32723,33354,0.5141,0.52682,0.55246,0.2839933333333333,0.21815333333333334,0.22236,0
2387,10000,0,2,1,49,1,-1,-1,-1,-1,-2,-20,780,0,780,0,0,800,0,780,0,0,0,1,-820,780,-780,780,0,0,-0.082,0.078,-0.078,0.078,0.0,0.0,-5
2388,260000,1,2,2,29,0,0,0,0,0,0,16496,15610,7486,5692,5206,6159,8027,3000,3000,3000,1000,2000,0,8469,12610,4486,2692,4206,4159,0.03257307692307692,0.0485,0.017253846153846154,0.010353846153846154,0.01617692307692308,0.015996153846153847,0
2389,210000,1,1,2,27,0,0,0,0,0,0,21275,18405,76779,67518,66364,65038,2079,67000,2300,2365,2000,2000,0,19196,-48595,74479,65153,64364,63038,0.09140952380952382,-0.2314047619047619,0.3546619047619048,0.31025238095238095,0.3064952380952381,0.3001809523809524,0
2390,100000,1,1,1,39,0,0,0,2,2,2,2998,3885,7298,7032,7913,7642,1100,3500,0,1000,0,5000,1,1898,385,7298,6032,7913,2642,0.01898,0.00385,0.07298,0.06032,0.07913,0.02642,6
2391,500000,1,1,1,39,0,0,0,0,0,0,418958,439432,440324,440565,440050,438953,39432,20000,20000,20000,20000,20000,1,379526,419432,420324,420565,420050,418953,0.759052,0.838864,0.840648,0.84113,0.8401,0.837906,0
2392,200000,1,1,2,32,-2,-2,-2,-2,0,0,0,0,-10542,148287,146948,148772,0,1685,326974,5200,5500,6000,0,0,-1685,-337516,143087,141448,142772,0.0,-0.008425,-1.68758,0.715435,0.70724,0.71386,-8
2393,20000,0,3,1,36,8,7,6,5,4,3,24166,23845,23214,22583,21662,21031,0,0,0,0,0,0,1,24166,23845,23214,22583,21662,21031,1.2083,1.19225,1.1607,1.12915,1.0831,1.05155,33
2394,300000,1,1,2,30,-1,-1,-1,2,-1,-1,452,-6,835,665,2386,456,3,1466,70,2397,457,1003,0,449,-1472,765,-1732,1929,-547,0.0014966666666666668,-0.004906666666666667,0.00255,-0.0057733333333333334,0.00643,-0.0018233333333333333,-3
2395,100000,1,2,1,36,0,0,0,0,0,0,100050,96652,97974,97486,95479,92817,4500,4600,4500,3500,3500,3500,1,95550,92052,93474,93986,91979,89317,0.9555,0.92052,0.93474,0.93986,0.91979,0.89317,0
2396,160000,1,1,1,37,-1,-1,-1,-1,-1,-1,9293,5875,9121,2412,2271,2187,5902,9128,2412,2271,2187,4792,1,3391,-3253,6709,141,84,-2605,0.02119375,-0.02033125,0.04193125,0.00088125,0.000525,-0.01628125,-6
2397,30000,1,2,2,23,1,2,0,0,2,2,27171,27429,26571,28128,27548,29536,1000,1800,2300,0,2600,0,0,26171,25629,24271,28128,24948,29536,0.8723666666666666,0.8543,0.8090333333333334,0.9376,0.8316,0.9845333333333334,7
2398,60000,1,2,2,25,0,0,0,0,0,0,36081,37194,38116,39902,58737,56902,2500,2000,3000,20000,3000,2000,0,33581,35194,35116,19902,55737,54902,0.5596833333333333,0.5865666666666667,0.5852666666666667,0.3317,0.92895,0.9150333333333334,0
2399,110000,1,1,2,34,0,0,0,0,0,0,110712,110988,98270,79402,80804,81024,4112,3648,2800,3100,3133,2800,0,106600,107340,95470,76302,77671,78224,0.9690909090909091,0.9758181818181818,0.867909090909091,0.6936545454545454,0.7061,0.7111272727272727,0
2400,180000,1,1,2,29,0,0,0,0,0,0,44109,20896,18193,18652,14545,18545,8000,5000,3000,2000,2000,6000,0,36109,15896,15193,16652,12545,12545,0.20060555555555556,0.08831111111111112,0.08440555555555555,0.09251111111111111,0.06969444444444445,0.06969444444444445,0
2401,450000,0,1,1,45,-1,-1,-1,0,0,0,26773,700,46727,46367,46191,20019,700,46727,1400,924,400,16608,1,26073,-46027,45327,45443,45791,3411,0.05794,-0.10228222222222222,0.10072666666666667,0.10098444444444445,0.10175777777777778,0.00758,-3
2402,120000,1,2,2,27,1,-2,-1,-1,-2,-2,0,0,2382,0,0,0,0,2382,0,0,0,0,0,0,-2382,2382,0,0,0,0.0,-0.01985,0.01985,0.0,0.0,0.0,-7
2403,20000,0,2,1,30,1,2,2,2,2,2,17005,15451,18067,17469,19905,19763,0,2874,0,2712,1566,818,1,17005,12577,18067,14757,18339,18945,0.85025,0.62885,0.90335,0.73785,0.91695,0.94725,11
2404,80000,1,1,1,29,-1,-1,-1,-1,0,-1,2175,358,1872,746,746,4424,358,1872,746,0,4424,0,1,1817,-1514,1126,746,-3678,4424,0.0227125,-0.018925,0.014075,0.009325,-0.045975,0.0553,-5
2405,260000,0,1,2,49,-1,-1,-1,-1,-1,-1,316,316,4866,316,316,4843,316,4866,316,316,4843,316,0,0,-4550,4550,0,-4527,4527,0.0,-0.0175,0.0175,0.0,-0.01741153846153846,0.01741153846153846,-6
2406,270000,0,3,1,32,3,2,0,0,0,0,150616,146262,149449,150893,153878,157324,0,7100,5500,6000,6000,5100,1,150616,139162,143949,144893,147878,152224,0.557837037037037,0.5154148148148148,0.5331444444444444,0.5366407407407408,0.5476962962962963,0.5637925925925926,5
2407,50000,1,1,2,23,-2,-2,-2,-2,-2,-2,307,0,0,0,0,0,0,0,0,0,0,0,0,307,0,0,0,0,0,0.00614,0.0,0.0,0.0,0.0,0.0,-12
2408,60000,1,2,1,48,0,0,0,0,0,0,56899,58032,59624,58124,58852,58872,2080,2530,1865,1445,293,1545,1,54819,55502,57759,56679,58559,57327,0.91365,0.9250333333333334,0.96265,0.94465,0.9759833333333333,0.95545,0
2409,200000,0,1,1,28,-1,-1,-1,-1,-1,-1,1867,994,2058,1546,2215,1828,997,2064,1550,2229,1833,808,1,870,-1070,508,-683,382,1020,0.00435,-0.00535,0.00254,-0.003415,0.00191,0.0051,-6
2410,200000,0,1,2,36,0,0,0,0,0,0,103457,111541,113809,35797,36087,38505,10000,5000,1412,1300,3000,0,0,93457,106541,112397,34497,33087,38505,0.467285,0.532705,0.561985,0.172485,0.165435,0.192525,0
2411,100000,1,1,1,38,-1,-1,-1,-1,-1,-1,1669,710,1824,1968,0,640,710,1824,1968,0,640,0,1,959,-1114,-144,1968,-640,640,0.00959,-0.01114,-0.00144,0.01968,-0.0064,0.0064,-6
2412,300000,0,3,1,41,-1,-1,-1,-1,-1,-1,1556,118157,11409,11907,3965,18327,118816,11488,11967,3983,18416,6260,1,-117260,106669,-558,7924,-14451,12067,-0.39086666666666664,0.35556333333333334,-0.00186,0.026413333333333334,-0.04817,0.04022333333333333,-6
2413,500000,0,1,1,57,-1,-1,-1,-1,-1,-1,4560,600,0,51697,37511,1685,600,0,51697,37511,1685,414,1,3960,600,-51697,14186,35826,1271,0.00792,0.0012,-0.103394,0.028372,0.071652,0.002542,-6
2414,300000,0,1,1,37,0,0,-2,-2,-2,-2,41000,0,0,0,0,0,0,0,0,0,0,0,1,41000,0,0,0,0,0,0.13666666666666666,0.0,0.0,0.0,0.0,0.0,-8
2415,130000,1,3,1,44,0,0,0,0,0,0,40331,43929,45816,47018,48550,49737,5000,3390,3000,3000,1955,3000,1,35331,40539,42816,44018,46595,46737,0.2717769230769231,0.31183846153846156,0.32935384615384616,0.3386,0.3584230769230769,0.3595153846153846,0
2416,80000,1,3,1,34,0,0,2,2,2,0,43321,47586,48525,49423,46132,47233,5000,2000,2000,0,2000,2000,1,38321,45586,46525,49423,44132,45233,0.4790125,0.569825,0.5815625,0.6177875,0.55165,0.5654125,6
2417,50000,0,2,1,43,-1,2,-1,-1,2,-1,780,390,390,650,260,520,0,390,650,0,800,800,1,780,0,-260,650,-540,-280,0.0156,0.0,-0.0052,0.013,-0.0108,-0.0056,0
2418,230000,1,2,1,34,-2,-2,-2,-2,-2,-2,0,0,615,0,0,0,0,615,0,0,0,0,1,0,-615,615,0,0,0,0.0,-0.002673913043478261,0.002673913043478261,0.0,0.0,0.0,-12
2419,180000,0,2,2,23,0,0,0,0,0,0,96709,99673,100951,104625,106498,115632,4485,3682,5253,5000,11000,10000,0,92224,95991,95698,99625,95498,105632,0.5123555555555556,0.5332833333333333,0.5316555555555555,0.5534722222222223,0.5305444444444445,0.5868444444444444,0
2420,390000,1,2,2,39,0,-1,-1,0,0,0,27918,3115,278505,288000,264214,266704,3145,278505,15000,9310,10000,9702,0,24773,-275390,263505,278690,254214,257002,0.06352051282051283,-0.7061282051282052,0.6756538461538462,0.7145897435897436,0.6518307692307692,0.6589794871794872,-2
2421,110000,1,2,1,46,0,0,2,0,0,0,102726,110179,105137,105467,94294,86381,10700,0,5000,4000,4000,5000,1,92026,110179,100137,101467,90294,81381,0.8366,1.0016272727272728,0.9103363636363636,0.9224272727272728,0.8208545454545455,0.7398272727272728,2
2422,350000,0,1,2,35,2,-1,-1,0,-1,-1,105,3298,50064,8003,8293,23080,3308,50206,40,8334,23102,5004,0,-3203,-46908,50024,-331,-14809,18076,-0.00915142857142857,-0.13402285714285714,0.1429257142857143,-0.0009457142857142857,-0.04231142857142857,0.05164571428571429,-2
2423,50000,0,3,1,54,0,0,0,-1,-1,0,50356,48981,47942,1261,17147,16609,2000,1120,1300,17147,1000,1000,1,48356,47861,46642,-15886,16147,15609,0.96712,0.95722,0.93284,-0.31772,0.32294,0.31218,-2
2424,140000,1,1,2,25,2,0,0,0,0,0,26623,28863,34049,36061,40003,45423,3000,6000,3000,5000,6000,5000,0,23623,22863,31049,31061,34003,40423,0.1687357142857143,0.16330714285714285,0.22177857142857144,0.2218642857142857,0.24287857142857142,0.28873571428571426,2
2425,310000,0,1,1,43,0,0,0,0,2,0,250708,256157,261550,285233,280905,272240,11000,11300,29841,69,9980,9546,1,239708,244857,231709,285164,270925,262694,0.7732516129032259,0.7898612903225807,0.7474483870967742,0.9198838709677419,0.8739516129032258,0.8474,2
2426,150000,0,1,1,30,1,-1,2,-1,-1,-1,-819,35457,819,2145,17000,23698,36276,0,2145,17000,23698,411,1,-37095,35457,-1326,-14855,-6698,23287,-0.2473,0.23638,-0.00884,-0.09903333333333333,-0.04465333333333334,0.15524666666666667,-1
2427,340000,1,3,2,46,1,-1,-1,0,0,-1,0,1321,35028,35028,8500,1612,1321,35028,0,0,1612,0,0,-1321,-33707,35028,35028,6888,1612,-0.003885294117647059,-0.09913823529411765,0.10302352941176471,0.10302352941176471,0.020258823529411763,0.004741176470588236,-2
2428,90000,0,1,2,29,0,0,2,0,0,0,24802,27551,20559,17228,6531,8411,3200,0,1000,1000,2000,0,0,21602,27551,19559,16228,4531,8411,0.24002222222222222,0.30612222222222224,0.21732222222222222,0.18031111111111112,0.05034444444444444,0.09345555555555556,2
2429,400000,1,2,1,44,1,-2,-1,-1,-1,-1,0,0,1228,3405,961,-251,0,1228,3405,961,0,0,1,0,-1228,-2177,2444,961,-251,0.0,-0.00307,-0.0054425,0.00611,0.0024025,-0.0006275,-5
2430,280000,1,1,1,26,-2,-2,-2,-2,-2,-2,4664,1578,646,3689,560,-150,1578,646,3689,560,0,1605,1,3086,932,-3043,3129,560,-1755,0.011021428571428571,0.0033285714285714286,-0.010867857142857143,0.011175,0.002,-0.006267857142857143,-12
2431,30000,0,2,2,34,0,0,0,0,0,0,29302,30052,29349,29476,30014,29785,1530,1416,1142,1102,1106,3450,0,27772,28636,28207,28374,28908,26335,0.9257333333333333,0.9545333333333333,0.9402333333333334,0.9458,0.9636,0.8778333333333334,0
2432,140000,1,1,2,30,0,0,2,0,0,2,78095,84781,82558,80376,85281,84688,8000,0,3500,5900,0,3000,0,70095,84781,79058,74476,85281,81688,0.5006785714285714,0.6055785714285714,0.5647,0.5319714285714285,0.60915,0.5834857142857143,4
2433,240000,1,1,2,28,1,2,2,2,0,-1,17868,188,2288,2100,405,1665,0,2100,405,0,1665,0,0,17868,-1912,1883,2100,-1260,1665,0.07445,-0.007966666666666667,0.007845833333333333,0.00875,-0.00525,0.0069375,6
2434,180000,0,1,2,28,2,2,2,2,2,2,175154,175790,153515,130864,131569,128983,5100,50,14500,4500,296,4500,0,170054,175740,139015,126364,131273,124483,0.9447444444444445,0.9763333333333334,0.7723055555555556,0.7020222222222222,0.7292944444444445,0.6915722222222223,12
2435,240000,1,1,2,29,-1,-1,-1,-1,-1,-1,59,548,208,0,44,19,548,208,0,44,0,643,0,-489,340,208,-44,44,-624,-0.0020375,0.0014166666666666668,0.0008666666666666666,-0.00018333333333333334,0.00018333333333333334,-0.0026,-6
2436,20000,1,1,1,34,0,0,0,0,0,0,14676,15721,19335,20029,20473,19860,1286,3900,1000,900,900,600,1,13390,11821,18335,19129,19573,19260,0.6695,0.59105,0.91675,0.95645,0.97865,0.963,0
2437,60000,0,1,2,22,0,0,2,0,0,0,57392,60254,58971,29137,29900,30069,4400,304,1100,1216,1300,589,0,52992,59950,57871,27921,28600,29480,0.8832,0.9991666666666666,0.9645166666666667,0.46535,0.4766666666666667,0.49133333333333334,2
2438,390000,1,2,2,28,-1,-1,-1,-1,0,-1,19081,1170,6512,14122,7894,3927,1170,6512,14122,0,3927,200,0,17911,-5342,-7610,14122,3967,3727,0.04592564102564103,-0.013697435897435897,-0.019512820512820512,0.03621025641025641,0.010171794871794872,0.009556410256410257,-5
2439,110000,1,3,1,63,-1,-1,-1,-1,-1,-1,390,390,390,390,780,0,390,390,390,780,0,390,1,0,0,0,-390,780,-390,0.0,0.0,0.0,-0.0035454545454545456,0.007090909090909091,-0.0035454545454545456,-6
2440,270000,1,2,1,25,0,0,0,0,0,0,184560,178592,170225,156719,151716,153519,6061,6081,5072,5009,5254,4069,1,178499,172511,165153,151710,146462,149450,0.6611074074074074,0.6389296296296296,0.6116777777777778,0.5618888888888889,0.5424518518518519,0.5535185185185185,0
2441,30000,0,3,1,42,-1,-1,-1,-1,-1,2,390,390,390,240,1320,780,390,390,240,1470,0,0,1,0,0,150,-1230,1320,780,0.0,0.0,0.005,-0.041,0.044,0.026,-3
2442,270000,0,1,2,29,-1,-1,0,0,0,0,1576,199973,192008,166364,141918,141984,199973,8000,7800,5000,5500,5000,0,-198397,191973,184208,161364,136418,136984,-0.7348037037037037,0.7110111111111111,0.6822518518518519,0.5976444444444444,0.5052518518518518,0.5073481481481481,-2
2443,410000,1,2,1,29,-2,-2,-2,-1,-1,0,6764,6500,6764,1743,149153,145597,6500,6764,3542,161064,5072,4891,1,264,-264,3222,-159321,144081,140706,0.0006439024390243902,-0.0006439024390243902,0.007858536585365854,-0.3885878048780488,0.35141707317073173,0.34318536585365855,-8
2444,210000,1,1,2,32,0,0,0,0,0,0,67374,69489,70937,71761,73505,74827,3200,3200,2600,2900,2700,3000,0,64174,66289,68337,68861,70805,71827,0.3055904761904762,0.31566190476190475,0.3254142857142857,0.3279095238095238,0.33716666666666667,0.34203333333333336,0
2445,180000,1,2,1,37,0,0,0,0,0,0,88275,78089,75159,76602,76896,78588,2800,3333,3310,2900,3040,3500,1,85475,74756,71849,73702,73856,75088,0.4748611111111111,0.41531111111111113,0.39916111111111113,0.4094555555555556,0.4103111111111111,0.41715555555555556,0
2446,100000,1,1,1,33,-1,-1,-2,-2,-2,-2,3976,0,0,0,0,0,0,0,0,0,0,402,1,3976,0,0,0,0,-402,0.03976,0.0,0.0,0.0,0.0,-0.00402,-10
2447,160000,1,2,2,30,0,0,2,-1,0,0,17357,4747,4500,32468,22485,119853,2250,0,32468,2000,104465,4602,0,15107,4747,-27968,30468,-81980,115251,0.09441875,0.02966875,-0.1748,0.190425,-0.512375,0.72031875,1
2448,210000,1,2,1,33,0,0,0,-2,-2,-1,29672,31050,0,0,0,87045,2100,0,0,0,87045,4000,1,27572,31050,0,0,-87045,83045,0.1312952380952381,0.14785714285714285,0.0,0.0,-0.4145,0.39545238095238094,-5
2449,450000,1,1,1,42,-1,-1,-1,-1,-1,-1,72517,0,6281,3446,6157,0,0,6281,3446,6157,0,14380,1,72517,-6281,2835,-2711,6157,-14380,0.1611488888888889,-0.013957777777777777,0.0063,-0.006024444444444444,0.013682222222222222,-0.031955555555555556,-6
2450,480000,1,2,1,35,0,0,0,0,0,0,227221,243942,244961,248394,253596,211055,51000,10000,8000,8200,23000,8000,1,176221,233942,236961,240194,230596,203055,0.3671270833333333,0.48737916666666664,0.49366875,0.5004041666666666,0.4804083333333333,0.42303125,0
2451,160000,1,1,2,27,-2,-2,-2,-2,-2,-2,717,3265,5105,3326,5482,2698,3269,5109,3328,5494,2864,2367,0,-2552,-1844,1777,-2168,2618,331,-0.01595,-0.011525,0.01110625,-0.01355,0.0163625,0.00206875,-12
2452,20000,1,1,2,22,0,0,0,0,0,0,15829,15299,16262,16749,13764,18732,1600,1550,1000,1000,5283,0,0,14229,13749,15262,15749,8481,18732,0.71145,0.68745,0.7631,0.78745,0.42405,0.9366,0
2453,150000,1,2,2,44,0,0,0,0,0,0,39471,41515,43879,44446,45394,46702,2636,3000,1528,1600,2000,2000,0,36835,38515,42351,42846,43394,44702,0.24556666666666666,0.25676666666666664,0.28234,0.28564,0.28929333333333335,0.29801333333333335,0
2454,300000,1,1,2,25,1,-2,-1,0,0,0,-4,-231,10610,10520,120,0,227,10841,0,100,0,0,0,-231,-11072,10610,10420,120,0,-0.00077,-0.036906666666666664,0.035366666666666664,0.03473333333333333,0.0004,0.0,-2
2455,20000,1,1,2,23,0,0,0,0,0,0,16841,17676,18804,19037,20137,20160,1642,2000,1000,1730,587,208,0,15199,15676,17804,17307,19550,19952,0.75995,0.7838,0.8902,0.86535,0.9775,0.9976,0
2456,50000,1,2,2,36,0,0,0,0,0,2,94228,47635,42361,19574,20295,19439,2000,1500,1000,1800,0,1000,0,92228,46135,41361,17774,20295,18439,1.84456,0.9227,0.82722,0.35548,0.4059,0.36878,2
2457,300000,1,1,2,26,0,0,-1,-1,0,-1,293554,291421,3760,3359,10670,2969,7877,5016,5008,10032,2977,11875,0,285677,286405,-1248,-6673,7693,-8906,0.9522566666666666,0.9546833333333333,-0.00416,-0.022243333333333334,0.025643333333333334,-0.029686666666666667,-3
2458,20000,1,3,2,24,-1,-1,-1,-1,-1,-2,5103,3773,10132,4818,0,0,3773,10139,4830,0,0,1960,0,1330,-6366,5302,4818,0,-1960,0.0665,-0.3183,0.2651,0.2409,0.0,-0.098,-7
2459,500000,1,2,2,28,0,0,0,0,0,0,215459,201715,141177,130352,126422,113148,7412,4721,3854,3622,3433,3201,0,208047,196994,137323,126730,122989,109947,0.416094,0.393988,0.274646,0.25346,0.245978,0.219894,0
2460,90000,0,1,2,36,-1,0,0,0,0,0,91111,81784,97541,90102,78285,70224,9400,27000,3000,2680,52930,3400,0,81711,54784,94541,87422,25355,66824,0.9079,0.6087111111111111,1.0504555555555555,0.9713555555555555,0.2817222222222222,0.7424888888888889,-1
2461,170000,1,2,2,34,0,0,0,0,-1,0,85235,81462,59800,20650,127601,121774,5000,3400,3000,127601,4600,5100,0,80235,78062,56800,-106951,123001,116674,0.47197058823529414,0.4591882352941177,0.3341176470588235,-0.6291235294117647,0.723535294117647,0.6863176470588235,-1
2462,240000,1,2,1,43,0,0,0,0,0,0,50120,48502,49001,47026,45827,39527,1781,2200,1923,1682,2000,2000,1,48339,46302,47078,45344,43827,37527,0.2014125,0.192925,0.19615833333333332,0.18893333333333334,0.1826125,0.1563625,0
2463,240000,1,4,1,44,0,0,0,0,0,0,47315,34623,34347,36082,32957,18797,3000,3500,9700,4000,6300,3000,1,44315,31123,24647,32082,26657,15797,0.18464583333333334,0.12967916666666668,0.10269583333333333,0.133675,0.11107083333333333,0.06582083333333333,0
2464,300000,1,1,2,34,2,2,2,2,-2,-2,2500,2500,2500,0,0,0,0,0,0,0,0,0,0,2500,2500,2500,0,0,0,0.008333333333333333,0.008333333333333333,0.008333333333333333,0.0,0.0,0.0,4
2465,60000,0,1,2,24,0,0,0,0,0,0,20873,22228,22691,22816,26587,22917,2000,1246,720,4780,1700,4000,0,18873,20982,21971,18036,24887,18917,0.31455,0.3497,0.36618333333333336,0.3006,0.41478333333333334,0.31528333333333336,0
2466,220000,0,2,2,30,0,0,0,0,0,0,91210,91093,76832,66879,55495,43369,4000,3000,2271,2009,1469,2000,0,87210,88093,74561,64870,54026,41369,0.39640909090909093,0.40042272727272726,0.33891363636363636,0.2948636363636364,0.24557272727272728,0.1880409090909091,0
2467,70000,1,1,2,30,0,0,0,0,0,2,12196,13291,14563,14625,15589,15189,1300,1500,600,1200,0,600,0,10896,11791,13963,13425,15589,14589,0.15565714285714286,0.16844285714285714,0.19947142857142858,0.19178571428571428,0.2227,0.20841428571428572,2
2468,100000,1,2,1,42,0,0,0,0,0,0,63984,65917,67673,66292,67793,67182,3000,4000,3000,2500,3000,2500,1,60984,61917,64673,63792,64793,64682,0.60984,0.61917,0.64673,0.63792,0.64793,0.64682,0
2469,90000,1,1,2,27,0,0,0,0,0,0,14421,18846,22509,24129,24815,27725,5000,4000,2000,1075,3500,3000,0,9421,14846,20509,23054,21315,24725,0.10467777777777777,0.16495555555555555,0.2278777777777778,0.2561555555555556,0.23683333333333334,0.2747222222222222,0
2470,70000,0,1,2,28,0,0,0,0,0,0,67857,69711,64947,26022,28575,21460,3000,1500,13959,3000,1500,4000,0,64857,68211,50988,23022,27075,17460,0.9265285714285715,0.9744428571428572,0.7284,0.3288857142857143,0.3867857142857143,0.24942857142857142,0
2471,50000,0,2,1,38,0,0,0,0,0,0,25742,23300,21266,19418,19315,18559,1372,1286,666,680,816,819,1,24370,22014,20600,18738,18499,17740,0.4874,0.44028,0.412,0.37476,0.36998,0.3548,0
2472,120000,0,3,1,46,0,-1,0,0,0,0,94953,116914,89799,89913,88484,90477,120656,3520,2931,3180,3432,1116,1,-25703,113394,86868,86733,85052,89361,-0.21419166666666667,0.94495,0.7239,0.722775,0.7087666666666667,0.744675,-1
2473,80000,0,2,1,60,2,2,2,2,2,2,48463,49484,50372,51246,52279,53069,2100,2000,2000,2000,1800,1000,1,46363,47484,48372,49246,50479,52069,0.5795375,0.59355,0.60465,0.615575,0.6309875,0.6508625,12
2474,350000,1,4,1,45,0,0,0,0,0,0,355310,337523,342288,336750,341376,348730,13671,12678,13601,12136,12771,12900,1,341639,324845,328687,324614,328605,335830,0.9761114285714285,0.9281285714285714,0.9391057142857143,0.9274685714285714,0.9388714285714286,0.9595142857142858,0
2475,50000,0,1,2,34,1,2,2,2,2,2,48212,49207,49914,48382,50693,50364,2500,2200,0,3800,1000,1500,0,45712,47007,49914,44582,49693,48864,0.91424,0.94014,0.99828,0.89164,0.99386,0.97728,11
2476,120000,0,2,1,60,2,2,2,2,2,2,27497,27960,28996,29321,29803,30511,1200,1800,1100,1100,1350,1500,1,26297,26160,27896,28221,28453,29011,0.21914166666666668,0.218,0.23246666666666665,0.235175,0.23710833333333334,0.24175833333333333,12
2477,140000,1,2,2,50,0,0,0,0,0,2,95310,97902,100214,102496,108405,106649,4000,3800,3800,7600,0,4000,0,91310,94102,96414,94896,108405,102649,0.6522142857142857,0.6721571428571429,0.6886714285714286,0.6778285714285714,0.7743214285714286,0.7332071428571428,2
2478,70000,1,1,2,26,0,0,0,0,0,0,64471,65577,53264,51464,96184,49104,2281,2888,1800,2000,1900,1760,0,62190,62689,51464,49464,94284,47344,0.8884285714285715,0.8955571428571428,0.7352,0.7066285714285714,1.3469142857142857,0.6763428571428571,0
2479,50000,1,3,1,36,0,0,0,0,0,2,45260,46605,47317,48259,50245,50265,2075,1787,1729,2765,1000,2000,1,43185,44818,45588,45494,49245,48265,0.8637,0.89636,0.91176,0.90988,0.9849,0.9653,2
2480,310000,0,1,1,45,-2,-2,-2,-2,-2,-2,8964,1168,6495,-16,-16,-16,1174,6527,0,0,0,0,1,7790,-5359,6495,-16,-16,-16,0.025129032258064517,-0.017287096774193548,0.020951612903225808,-5.161290322580645e-05,-5.161290322580645e-05,-5.161290322580645e-05,-12
2481,210000,0,2,1,43,0,0,0,0,0,0,48540,38410,40291,31869,32186,25554,4000,5013,4000,5000,5000,5000,1,44540,33397,36291,26869,27186,20554,0.2120952380952381,0.15903333333333333,0.17281428571428573,0.12794761904761906,0.12945714285714285,0.09787619047619048,0
2482,270000,1,1,2,26,1,-2,-1,-1,-2,-2,0,0,6336,0,0,0,0,6336,0,0,0,0,0,0,-6336,6336,0,0,0,0.0,-0.023466666666666667,0.023466666666666667,0.0,0.0,0.0,-7
2483,80000,1,1,2,23,-1,-1,0,0,-1,-1,3526,6687,4356,3450,4318,0,6687,1000,0,4318,0,254,0,-3161,5687,4356,-868,4318,-254,-0.0395125,0.0710875,0.05445,-0.01085,0.053975,-0.003175,-4
2484,50000,1,1,2,25,-1,2,0,0,0,-1,2823,1760,2640,1760,880,1910,0,1760,0,0,1910,0,0,2823,0,2640,1760,-1030,1910,0.05646,0.0,0.0528,0.0352,-0.0206,0.0382,0
2485,120000,0,3,1,32,1,2,2,2,2,2,110826,113572,114719,115736,117729,120601,6000,4500,4400,4000,5000,4700,1,104826,109072,110319,111736,112729,115901,0.87355,0.9089333333333334,0.919325,0.9311333333333334,0.9394083333333333,0.9658416666666667,11
2486,90000,1,1,2,27,-1,-1,-1,0,0,-2,700,2122,1897,1190,0,0,2122,1897,0,0,0,0,0,-1422,225,1897,1190,0,0,-0.0158,0.0025,0.02107777777777778,0.013222222222222222,0.0,0.0,-5
2487,50000,1,1,2,52,-1,0,0,0,0,-1,28594,33080,29233,23340,-300,31031,5000,3000,1000,0,31331,0,0,23594,30080,28233,23340,-31631,31031,0.47188,0.6016,0.56466,0.4668,-0.63262,0.62062,-2
2488,50000,1,2,3,49,0,0,0,0,0,2,45681,14657,9677,8826,10177,9865,1209,1300,350,1500,0,300,0,44472,13357,9327,7326,10177,9565,0.88944,0.26714,0.18654,0.14652,0.20354,0.1913,2
2489,80000,1,1,2,33,1,2,0,0,0,0,83367,81409,78790,80567,78047,82942,0,2873,3101,3000,6328,0,0,83367,78536,75689,77567,71719,82942,1.0420875,0.9817,0.9461125,0.9695875,0.8964875,1.036775,3
2490,180000,1,2,1,36,-1,-1,-1,-2,-2,-2,1252,23,-820,-1140,0,0,23,3,0,2000,0,150,1,1229,20,-820,-3140,0,-150,0.006827777777777778,0.00011111111111111112,-0.004555555555555556,-0.017444444444444443,0.0,-0.0008333333333333334,-9
2491,370000,0,2,2,28,0,0,0,0,0,0,276436,239025,149128,48907,53025,51434,20000,13000,5000,10000,4000,6000,0,256436,226025,144128,38907,49025,45434,0.6930702702702702,0.6108783783783783,0.38953513513513516,0.10515405405405405,0.1325,0.12279459459459459,0
2492,200000,0,3,1,30,0,0,0,0,0,0,141785,144933,148103,148137,151505,154728,7000,7000,4000,4000,4000,4000,1,134785,137933,144103,144137,147505,150728,0.673925,0.689665,0.720515,0.720685,0.737525,0.75364,0
2493,500000,1,2,1,30,-2,-2,-2,-2,-2,-2,344,5757,1820,2308,807,4966,5757,1820,2308,807,4966,3240,1,-5413,3937,-488,1501,-4159,1726,-0.010826,0.007874,-0.000976,0.003002,-0.008318,0.003452,-12
2494,320000,0,1,1,38,0,0,0,0,0,0,18924,21589,23926,31161,32234,35688,3000,3000,8000,1900,4000,1600,1,15924,18589,15926,29261,28234,34088,0.0497625,0.058090625,0.04976875,0.091440625,0.08823125,0.106525,0
2495,280000,0,1,2,30,-1,-1,-1,-1,-1,-1,17913,380,5118,380,380,380,380,5118,380,380,380,380,0,17533,-4738,4738,0,0,0,0.06261785714285714,-0.01692142857142857,0.01692142857142857,0.0,0.0,0.0,-6
2496,80000,1,2,2,27,0,0,2,0,0,0,78672,83807,81833,79673,79735,81271,7018,0,3000,3100,3000,3100,0,71654,83807,78833,76573,76735,78171,0.895675,1.0475875,0.9854125,0.9571625,0.9591875,0.9771375,2
2497,20000,0,2,2,21,0,0,0,-2,-2,-2,19030,19783,0,0,0,0,1500,0,0,0,0,0,0,17530,19783,0,0,0,0,0.8765,0.98915,0.0,0.0,0.0,0.0,-6
2498,80000,1,1,2,26,2,0,0,2,2,2,37097,38174,40550,41577,41595,43264,2000,3000,2000,1000,2500,1000,0,35097,35174,38550,40577,39095,42264,0.4387125,0.439675,0.481875,0.5072125,0.4886875,0.5283,8
2499,300000,0,1,1,47,-2,-2,-2,-2,-1,-1,0,225,4019,4509,7155,5778,225,4019,3860,5000,5778,23978,1,-225,-3794,159,-491,1377,-18200,-0.00075,-0.012646666666666667,0.00053,-0.0016366666666666667,0.00459,-0.06066666666666667,-10
2500,50000,1,2,2,35,1,2,0,0,-1,0,31507,30705,33467,12870,3325,5103,0,3467,1229,3325,2000,2167,0,31507,27238,32238,9545,1325,2936,0.63014,0.54476,0.64476,0.1909,0.0265,0.05872,2
2501,130000,0,1,1,40,2,2,0,0,0,0,80987,79085,82799,86407,88959,97487,0,5000,5000,4000,10000,3724,1,80987,74085,77799,82407,78959,93763,0.6229769230769231,0.5698846153846154,0.5984538461538461,0.6339,0.607376923076923,0.7212538461538461,4
2502,20000,0,2,2,38,0,0,0,0,0,0,16465,18470,18877,19604,19800,0,3000,1473,1200,396,0,0,0,13465,16997,17677,19208,19800,0,0.67325,0.84985,0.88385,0.9604,0.99,0.0,0
2503,50000,1,2,2,49,0,0,0,0,0,0,43342,44441,45390,46310,47262,48219,2100,2000,1113,1143,1159,1381,0,41242,42441,44277,45167,46103,46838,0.82484,0.84882,0.88554,0.90334,0.92206,0.93676,0
2504,150000,1,1,1,36,-2,-2,-2,-2,-2,-2,16228,29414,4975,3960,2914,1068,30745,4975,5017,2914,1250,4734,1,-14517,24439,-42,1046,1664,-3666,-0.09678,0.16292666666666666,-0.00028,0.006973333333333333,0.011093333333333334,-0.02444,-12
2505,450000,1,2,1,36,-1,-1,-1,-1,-1,-1,3087,2081,198,9532,3420,130,2081,198,9532,3420,130,878,1,1006,1883,-9334,6112,3290,-748,0.0022355555555555557,0.004184444444444445,-0.02074222222222222,0.013582222222222223,0.007311111111111111,-0.0016622222222222223,-6
2506,100000,1,2,2,24,1,-1,-1,-2,-2,-1,0,670,0,0,0,150,670,0,0,0,150,477,0,-670,670,0,0,-150,-327,-0.0067,0.0067,0.0,0.0,-0.0015,-0.00327,-6
2507,30000,1,3,1,31,0,0,0,0,0,0,9388,10387,10624,11539,11771,9075,1162,1229,1144,376,329,345,1,8226,9158,9480,11163,11442,8730,0.2742,0.3052666666666667,0.316,0.3721,0.3814,0.291,0
2508,330000,0,1,1,57,-1,-1,-1,-1,-2,-1,3166,-206,3429,0,0,749,552,5726,0,0,749,799,1,2614,-5932,3429,0,-749,-50,0.00792121212121212,-0.017975757575757575,0.010390909090909091,0.0,-0.0022696969696969697,-0.00015151515151515152,-7
2509,20000,0,3,1,45,0,0,0,0,0,0,26400,27400,28400,29400,30000,0,1000,1000,1000,600,0,0,1,25400,26400,27400,28800,30000,0,1.27,1.32,1.37,1.44,1.5,0.0,0
2510,50000,1,2,1,34,0,0,0,2,2,2,45974,47504,45206,35892,22989,22483,2374,4656,25,2869,0,814,1,43600,42848,45181,33023,22989,21669,0.872,0.85696,0.90362,0.66046,0.45978,0.43338,6
2511,170000,1,1,1,28,1,-1,-1,-1,-1,-1,0,1295,0,376,0,376,1295,0,376,0,376,0,1,-1295,1295,-376,376,-376,376,-0.007617647058823529,0.007617647058823529,-0.0022117647058823527,0.0022117647058823527,-0.0022117647058823527,0.0022117647058823527,-4
2512,200000,0,3,2,27,-1,0,0,0,0,0,3179,3844,5117,6877,7504,8148,1844,2117,1877,1504,1148,2599,0,1335,1727,3240,5373,6356,5549,0.006675,0.008635,0.0162,0.026865,0.03178,0.027745,-1
2513,30000,0,1,2,28,-1,2,2,0,0,0,1190,2107,1098,1098,1248,982,1098,0,0,982,150,0,0,92,2107,1098,116,1098,982,0.0030666666666666668,0.07023333333333333,0.0366,0.0038666666666666667,0.0366,0.032733333333333337,3
2514,110000,0,3,1,34,0,0,0,0,0,0,23751,25068,26351,26996,27754,28597,1717,2000,2000,1500,2000,5000,1,22034,23068,24351,25496,25754,23597,0.2003090909090909,0.2097090909090909,0.22137272727272728,0.23178181818181817,0.23412727272727274,0.21451818181818183,0
2515,200000,1,2,2,34,0,0,2,2,0,0,189490,204278,207559,202518,164682,168224,18000,8000,0,6000,6200,7000,0,171490,196278,207559,196518,158482,161224,0.85745,0.98139,1.037795,0.98259,0.79241,0.80612,4
2516,20000,0,3,2,45,0,0,0,0,0,0,18011,18083,18500,19014,19019,17484,1500,1400,1243,638,2000,480,0,16511,16683,17257,18376,17019,17004,0.82555,0.83415,0.86285,0.9188,0.85095,0.8502,0
2517,210000,1,2,1,45,0,0,0,0,0,0,203273,188955,183774,152509,136376,131656,6515,7113,6011,4471,4513,4261,1,196758,181842,177763,148038,131863,127395,0.9369428571428572,0.8659142857142857,0.8464904761904762,0.7049428571428571,0.6279190476190476,0.6066428571428572,0
2518,80000,1,3,1,44,-1,-1,-1,-1,-1,-1,817,1131,817,1907,1962,1865,1131,1000,1907,2000,2000,700,1,-314,131,-1090,-93,-38,1165,-0.003925,0.0016375,-0.013625,-0.0011625,-0.000475,0.0145625,-6
2519,120000,0,1,2,34,0,0,0,2,0,0,32773,28002,32493,16258,8871,2000,1509,5000,7,0,2000,1666,0,31264,23002,32486,16258,6871,334,0.26053333333333334,0.19168333333333334,0.27071666666666666,0.13548333333333334,0.057258333333333335,0.0027833333333333334,2
2520,100000,1,3,2,31,0,0,0,0,-1,-1,85030,49489,50424,51563,780,0,1820,2308,3000,780,0,0,0,83210,47181,47424,50783,780,0,0.8321,0.47181,0.47424,0.50783,0.0078,0.0,-2
2521,50000,0,2,1,23,0,0,-2,-2,-2,-2,9156,0,0,0,0,0,0,0,0,0,0,0,1,9156,0,0,0,0,0,0.18312,0.0,0.0,0.0,0.0,0.0,-8
2522,140000,0,2,1,34,-1,-1,-1,-1,-1,-1,711,711,711,10976,711,711,711,711,10976,711,711,291,1,0,0,-10265,10265,0,420,0.0,0.0,-0.07332142857142857,0.07332142857142857,0.0,0.003,-6
2523,50000,0,1,3,51,0,0,0,0,0,0,48600,49387,49259,30864,16016,13913,1986,1638,1130,449,418,416,0,46614,47749,48129,30415,15598,13497,0.93228,0.95498,0.96258,0.6083,0.31196,0.26994,0
2524,100000,0,2,1,38,0,0,0,0,0,0,99660,99908,98052,94423,96056,97320,4600,3500,3400,3500,5000,3500,1,95060,96408,94652,90923,91056,93820,0.9506,0.96408,0.94652,0.90923,0.91056,0.9382,0
2525,140000,0,1,2,28,2,2,2,2,2,2,113780,115297,114448,114653,115720,116690,5800,3500,4500,4000,4000,4500,0,107980,111797,109948,110653,111720,112190,0.7712857142857142,0.79855,0.7853428571428571,0.7903785714285714,0.798,0.8013571428571429,12
2526,220000,0,1,1,35,0,0,0,0,0,0,21960,21860,25463,28036,34552,43827,2000,4000,3000,7000,11000,3000,1,19960,17860,22463,21036,23552,40827,0.09072727272727273,0.08118181818181819,0.10210454545454545,0.09561818181818182,0.10705454545454546,0.18557727272727273,0
2527,50000,0,2,2,39,0,0,0,0,0,0,26842,23540,16980,16908,17327,17895,2500,2010,1500,1000,1000,900,0,24342,21530,15480,15908,16327,16995,0.48684,0.4306,0.3096,0.31816,0.32654,0.3399,0
2528,50000,1,3,1,36,0,0,0,0,0,0,46311,47579,47897,28263,8548,8906,2014,1332,698,310,500,330,1,44297,46247,47199,27953,8048,8576,0.88594,0.92494,0.94398,0.55906,0.16096,0.17152,0
2529,80000,1,2,2,22,3,2,0,0,0,2,42080,41131,42281,42605,47544,33115,0,2200,1500,5600,0,2275,0,42080,38931,40781,37005,47544,30840,0.526,0.4866375,0.5097625,0.4625625,0.5943,0.3855,7
2530,260000,1,1,1,41,0,0,0,2,0,0,157551,160759,351026,170671,169689,159066,7312,18934,23,3729,4226,514,1,150239,141825,351003,166942,165463,158552,0.5778423076923077,0.5454807692307693,1.3500115384615385,0.6420846153846154,0.6363961538461539,0.6098153846153846,2
2531,140000,1,2,2,27,0,0,0,0,2,2,120072,78166,72631,65517,59275,58208,2824,2508,4973,2300,0,3000,0,117248,75658,67658,63217,59275,55208,0.8374857142857143,0.5404142857142857,0.4832714285714286,0.45155,0.4233928571428571,0.39434285714285716,4
2532,150000,1,1,2,35,-2,-2,-2,-2,-2,-2,9164,14011,7715,8295,7301,4388,14021,7723,8295,7301,4388,1600,0,-4857,6288,-580,994,2913,2788,-0.03238,0.04192,-0.0038666666666666667,0.006626666666666667,0.01942,0.018586666666666668,-12
2533,180000,0,2,1,48,-1,2,2,-2,-2,-2,919,919,0,0,0,0,0,0,0,0,0,0,1,919,919,0,0,0,0,0.005105555555555556,0.005105555555555556,0.0,0.0,0.0,0.0,-3
2534,90000,0,3,1,31,0,0,0,0,0,0,67776,68476,68485,67000,45837,49959,4023,4017,4000,4000,5000,4000,1,63753,64459,64485,63000,40837,45959,0.7083666666666667,0.7162111111111111,0.7165,0.7,0.45374444444444445,0.5106555555555555,0
2535,290000,1,2,2,26,0,0,0,0,-1,-1,18125,20807,99860,100000,3015,23473,3000,80000,3000,3015,23473,1148,0,15125,-59193,96860,96985,-20458,22325,0.052155172413793104,-0.20411379310344827,0.334,0.3344310344827586,-0.07054482758620689,0.07698275862068965,-2
2536,90000,1,2,2,24,0,0,0,0,0,-2,87711,80699,68100,33434,0,0,3248,2991,2655,0,0,0,0,84463,77708,65445,33434,0,0,0.9384777777777777,0.8634222222222222,0.7271666666666666,0.37148888888888887,0.0,0.0,-2
2537,410000,0,2,1,46,2,2,2,2,2,0,71532,73643,72083,76603,74964,76370,3700,0,6147,0,2577,2747,1,67832,73643,65936,76603,72387,73623,0.1654439024390244,0.1796170731707317,0.16081951219512194,0.18683658536585365,0.17655365853658536,0.17956829268292682,10
2538,50000,0,2,2,36,0,0,0,0,0,0,5197,6015,6615,7131,6987,6980,1300,1100,1000,500,500,1000,0,3897,4915,5615,6631,6487,5980,0.07794,0.0983,0.1123,0.13262,0.12974,0.1196,0
2539,280000,1,2,1,46,0,0,0,0,0,0,34433,34763,25048,24116,50483,47056,1383,1647,1004,41551,2056,1670,1,33050,33116,24044,-17435,48427,45386,0.11803571428571429,0.11827142857142857,0.08587142857142857,-0.062267857142857146,0.17295357142857143,0.16209285714285715,0
2540,210000,1,3,2,37,-1,-1,-1,-1,-1,-1,13438,9241,7924,13416,2228,4490,9315,7924,13421,2240,4490,10834,0,4123,1317,-5497,11176,-2262,-6344,0.019633333333333332,0.006271428571428571,-0.026176190476190478,0.05321904761904762,-0.01077142857142857,-0.03020952380952381,-6
2541,400000,1,3,2,26,0,0,0,0,0,0,18256,18245,18447,13574,8805,10501,1300,1229,1120,292,2784,270,0,16956,17016,17327,13282,6021,10231,0.04239,0.04254,0.0433175,0.033205,0.0150525,0.0255775,0
2542,110000,1,2,1,43,0,0,0,0,0,0,45021,45782,46187,47105,45253,46144,2100,1800,1638,1490,1957,2000,1,42921,43982,44549,45615,43296,44144,0.3901909090909091,0.39983636363636366,0.40499090909090907,0.4146818181818182,0.3936,0.4013090909090909,0
2543,140000,1,2,2,31,-1,-1,-1,-1,0,-1,277,19983,17685,36603,27886,7659,19983,17725,36621,0,7847,43467,0,-19706,2258,-18936,36603,20039,-35808,-0.14075714285714286,0.01612857142857143,-0.13525714285714285,0.26145,0.14313571428571428,-0.2557714285714286,-5
2544,60000,1,2,1,33,2,0,0,0,0,0,60099,60983,55595,54940,47959,29763,2500,2006,5000,2000,2000,0,1,57599,58977,50595,52940,45959,29763,0.9599833333333333,0.98295,0.84325,0.8823333333333333,0.7659833333333333,0.49605,2
2545,170000,1,2,1,38,-1,-1,-1,0,0,-2,521,5360,29271,26511,0,0,6439,29271,0,0,0,2730,1,-5918,-23911,29271,26511,0,-2730,-0.034811764705882355,-0.1406529411764706,0.17218235294117648,0.1559470588235294,0.0,-0.016058823529411764,-5
2546,50000,0,2,2,26,1,-2,-2,-2,-2,-2,0,0,0,0,0,0,0,0,0,0,0,0,0,0,0,0,0,0,0,0.0,0.0,0.0,0.0,0.0,0.0,-9
2547,280000,1,2,2,33,0,0,0,0,0,-1,71174,66228,39379,13409,40854,2930,2290,1304,1000,29485,2930,0,0,68884,64924,38379,-16076,37924,2930,0.2460142857142857,0.23187142857142856,0.13706785714285713,-0.057414285714285716,0.13544285714285714,0.010464285714285714,-1
2548,180000,1,1,1,44,-1,-1,-1,-1,-1,-1,1210,1071,6554,0,21398,298,1071,6557,0,21398,298,0,1,139,-5486,6554,-21398,21100,298,0.0007722222222222222,-0.030477777777777777,0.03641111111111111,-0.11887777777777778,0.11722222222222223,0.0016555555555555555,-6
2549,390000,1,1,2,26,-2,-1,-1,0,0,0,5044,1248,199466,200701,210885,213137,1248,201925,6195,30000,8000,8000,0,3796,-200677,193271,170701,202885,205137,0.009733333333333333,-0.5145564102564103,0.49556666666666666,0.4376948717948718,0.5202179487179487,0.5259923076923076,-4
2550,20000,1,3,3,51,2,0,0,0,0,2,18355,17165,17676,18300,20278,20192,1600,1500,900,3600,393,0,0,16755,15665,16776,14700,19885,20192,0.83775,0.78325,0.8388,0.735,0.99425,1.0096,4
2551,60000,0,3,2,23,0,0,0,0,0,0,15592,16643,15557,15526,16273,17001,2000,1400,1000,1000,1000,1000,0,13592,15243,14557,14526,15273,16001,0.22653333333333334,0.25405,0.24261666666666667,0.2421,0.25455,0.26668333333333333,0
2552,300000,1,2,1,34,0,0,0,0,0,0,86116,83724,80721,79939,58586,14570,3894,2783,3575,1605,1520,0,1,82222,80941,77146,78334,57066,14570,0.27407333333333334,0.26980333333333334,0.25715333333333334,0.2611133333333333,0.19022,0.04856666666666667,0
2553,200000,0,1,2,27,-1,0,-1,-1,-1,-1,9747,17230,198,875,1977,2052,10051,198,877,1982,2058,2939,0,-304,17032,-679,-1107,-81,-887,-0.00152,0.08516,-0.003395,-0.005535,-0.000405,-0.004435,-5
2554,250000,1,4,1,33,0,0,0,0,0,0,211084,211577,202346,203132,201230,199820,6934,7000,8975,7043,8000,10000,1,204150,204577,193371,196089,193230,189820,0.8166,0.818308,0.773484,0.784356,0.77292,0.75928,0
2555,20000,0,4,2,27,5,4,3,2,2,2,21673,21051,20440,19709,20113,19840,0,0,0,900,0,0,0,21673,21051,20440,18809,20113,19840,1.08365,1.05255,1.022,0.94045,1.00565,0.992,18
2556,500000,1,1,1,58,1,-1,0,-1,0,0,-1,33982,37844,9441,12700,19267,35436,37311,9442,5001,10001,95478,1,-35437,-3329,28402,4440,2699,-76211,-0.070874,-0.006658,0.056804,0.00888,0.005398,-0.152422,-1
2557,50000,1,3,1,36,0,0,0,0,0,0,13572,10805,8623,8799,8468,8768,1188,3000,176,169,300,1200,1,12384,7805,8447,8630,8168,7568,0.24768,0.1561,0.16894,0.1726,0.16336,0.15136,0
2558,50000,0,3,2,30,0,0,0,0,-1,-1,9610,9132,8681,8039,4952,390,1147,1169,1000,4986,390,390,0,8463,7963,7681,3053,4562,0,0.16926,0.15926,0.15362,0.06106,0.09124,0.0,-2
2559,290000,1,1,1,37,-1,-1,-1,-1,-1,-1,3486,550,1922,550,550,3810,550,1922,550,550,3810,2927,1,2936,-1372,1372,0,-3260,883,0.010124137931034482,-0.004731034482758621,0.004731034482758621,0.0,-0.011241379310344827,0.0030448275862068963,-6
2560,220000,1,2,1,41,2,0,0,2,0,0,27094,27819,30363,29579,48933,97187,1465,3009,0,20000,50000,1240,1,25629,24810,30363,9579,-1067,95947,0.11649545454545454,0.11277272727272727,0.13801363636363637,0.04354090909090909,-0.00485,0.4361227272727273,4
2561,150000,1,1,2,30,0,-1,0,0,-2,-2,7674,432,2232,0,0,0,432,2000,0,0,0,5757,0,7242,-1568,2232,0,0,-5757,0.04828,-0.010453333333333334,0.01488,0.0,0.0,-0.03838,-5
2562,330000,1,1,2,24,0,0,0,0,0,0,341499,334929,317997,274132,267622,261246,12500,10882,9902,10000,10000,17629,0,328999,324047,308095,264132,257622,243617,0.9969666666666667,0.9819606060606061,0.9336212121212121,0.8004,0.7806727272727273,0.7382333333333333,0
2563,50000,1,1,2,24,0,0,0,0,0,0,49982,49650,48321,30281,30380,28852,1963,1739,1033,1058,1041,1007,0,48019,47911,47288,29223,29339,27845,0.96038,0.95822,0.94576,0.58446,0.58678,0.5569,0
2564,190000,0,2,1,58,1,2,0,0,0,0,147335,135184,139664,142293,113086,115433,0,6586,5881,3292,3399,3469,1,147335,128598,133783,139001,109687,111964,0.7754473684210527,0.6768315789473685,0.704121052631579,0.7315842105263158,0.5773,0.5892842105263157,3
2565,30000,1,1,2,28,1,2,2,2,2,0,24307,23618,26733,27016,24972,25425,0,3500,1028,0,1000,3300,0,24307,20118,25705,27016,23972,22125,0.8102333333333334,0.6706,0.8568333333333333,0.9005333333333333,0.7990666666666667,0.7375,9
2566,30000,0,2,2,34,2,0,0,4,3,2,18402,19785,24633,23961,23289,22779,2000,5500,0,0,0,3400,0,16402,14285,24633,23961,23289,19379,0.5467333333333333,0.4761666666666667,0.8211,0.7987,0.7763,0.6459666666666667,11
2567,280000,1,2,1,37,0,0,0,0,0,0,252814,255974,110389,114874,118273,114204,10610,10018,10000,5038,5039,5010,1,242204,245956,100389,109836,113234,109194,0.8650142857142857,0.8784142857142857,0.35853214285714285,0.39227142857142855,0.40440714285714285,0.38997857142857145,0
2568,20000,1,3,2,45,0,0,0,0,0,0,12670,13682,14399,15408,15728,17082,1520,1234,1243,563,1609,1500,0,11150,12448,13156,14845,14119,15582,0.5575,0.6224,0.6578,0.74225,0.70595,0.7791,0
2569,170000,1,2,2,24,-1,-1,2,0,0,-1,1166,4144,3889,4889,4139,430,3000,0,1000,0,1000,17342,0,-1834,4144,2889,4889,3139,-16912,-0.010788235294117647,0.024376470588235295,0.016994117647058823,0.028758823529411764,0.018464705882352942,-0.09948235294117647,-1
2570,330000,1,2,1,30,0,0,0,0,0,-1,155285,156122,11733,9620,0,4520,10000,10000,2000,0,4520,2500,1,145285,146122,9733,9620,-4520,2020,0.44025757575757574,0.4427939393939394,0.029493939393939395,0.02915151515151515,-0.013696969696969697,0.006121212121212121,-1
2571,50000,0,2,2,25,2,0,0,0,0,0,47987,49084,46759,8195,8367,8534,2690,2359,293,304,306,316,0,45297,46725,46466,7891,8061,8218,0.90594,0.9345,0.92932,0.15782,0.16122,0.16436,2
2572,200000,0,2,2,31,0,0,0,0,0,0,33781,35879,26043,27497,29082,31647,3000,2000,2000,2000,3000,4000,0,30781,33879,24043,25497,26082,27647,0.153905,0.169395,0.120215,0.127485,0.13041,0.138235,0
2573,100000,1,2,1,60,-2,-1,-1,-1,-1,-1,0,198,198,324,171,0,198,198,324,171,0,144,1,-198,0,-126,153,171,-144,-0.00198,0.0,-0.00126,0.00153,0.00171,-0.00144,-7
2574,200000,1,2,2,31,1,-2,-1,-1,-2,-2,0,0,500,0,0,0,0,500,0,0,0,0,0,0,-500,500,0,0,0,0.0,-0.0025,0.0025,0.0,0.0,0.0,-7
2575,60000,1,2,1,34,2,2,2,2,2,0,24898,27976,27233,30184,29566,30225,3800,0,3720,0,1300,1291,1,21098,27976,23513,30184,28266,28934,0.35163333333333335,0.46626666666666666,0.3918833333333333,0.5030666666666667,0.4711,0.48223333333333335,10
2576,40000,1,3,1,39,2,2,2,2,2,2,22241,23273,24204,24510,24811,24274,1700,1600,1000,1000,0,2000,1,20541,21673,23204,23510,24811,22274,0.513525,0.541825,0.5801,0.58775,0.620275,0.55685,12
2577,180000,1,2,1,36,0,0,0,0,-2,-1,20138,21494,25600,0,0,36565,2000,5000,0,0,36565,1548,1,18138,16494,25600,0,-36565,35017,0.10076666666666667,0.09163333333333333,0.14222222222222222,0.0,-0.2031388888888889,0.1945388888888889,-3
2578,100000,1,2,2,38,0,0,0,0,0,0,96707,89842,82669,70018,57847,43618,4070,4025,2511,1523,1292,1236,0,92637,85817,80158,68495,56555,42382,0.92637,0.85817,0.80158,0.68495,0.56555,0.42382,0
2579,30000,1,1,2,25,0,0,2,0,0,2,19801,20449,19798,20217,21435,19239,3000,0,700,1500,0,323,0,16801,20449,19098,18717,21435,18916,0.5600333333333334,0.6816333333333333,0.6366,0.6239,0.7145,0.6305333333333333,4
2580,500000,0,1,1,32,0,0,0,0,0,0,305575,231984,228765,185694,179853,178763,9824,10910,7239,5576,6717,6128,1,295751,221074,221526,180118,173136,172635,0.591502,0.442148,0.443052,0.360236,0.346272,0.34527,0
2581,20000,0,2,1,47,0,0,0,0,0,0,15166,15014,16024,16345,17579,18750,1257,1267,588,1500,1500,0,1,13909,13747,15436,14845,16079,18750,0.69545,0.68735,0.7718,0.74225,0.80395,0.9375,0
2582,30000,1,2,1,38,0,0,0,0,2,2,20344,21705,22537,24161,25128,24576,2000,1500,2000,1500,0,1200,1,18344,20205,20537,22661,25128,23376,0.6114666666666667,0.6735,0.6845666666666667,0.7553666666666666,0.8376,0.7792,4
2583,180000,0,1,1,49,0,0,0,0,0,0,63444,65420,67722,70970,72670,76444,3000,4000,5000,3000,5000,5000,1,60444,61420,62722,67970,67670,71444,0.3358,0.3412222222222222,0.3484555555555556,0.3776111111111111,0.37594444444444447,0.3969111111111111,0
2584,140000,0,2,1,28,0,0,0,0,0,0,110384,106389,97978,98857,101264,103524,3729,3539,3538,4000,4097,3631,1,106655,102850,94440,94857,97167,99893,0.7618214285714285,0.7346428571428572,0.6745714285714286,0.67755,0.69405,0.7135214285714285,0
2585,200000,0,2,1,30,0,0,0,0,0,0,143266,113676,116355,117802,116296,60792,6000,6000,5000,6000,3000,1611,1,137266,107676,111355,111802,113296,59181,0.68633,0.53838,0.556775,0.55901,0.56648,0.295905,0
2586,510000,1,2,2,48,0,0,0,0,0,-1,113616,96756,72730,64746,24040,23791,9019,8000,20000,24040,23791,22503,0,104597,88756,52730,40706,249,1288,0.2050921568627451,0.1740313725490196,0.1033921568627451,0.0798156862745098,0.00048823529411764707,0.0025254901960784313,-1
2587,360000,1,1,2,26,-1,-1,-1,-1,-1,-1,273,3558,1489,-356,9824,2010,3558,1489,0,10560,2010,1491,0,-3285,2069,1489,-10916,7814,519,-0.009125,0.005747222222222222,0.004136111111111111,-0.030322222222222223,0.021705555555555554,0.0014416666666666666,-6
2588,50000,1,2,2,23,0,0,-2,-2,-2,-2,43634,0,0,0,0,0,0,0,0,0,0,0,0,43634,0,0,0,0,0,0.87268,0.0,0.0,0.0,0.0,0.0,-8
2589,50000,0,1,2,22,0,0,0,0,0,-1,5137,5960,6270,6000,5810,390,1300,1000,120,200,390,1170,0,3837,4960,6150,5800,5420,-780,0.07674,0.0992,0.123,0.116,0.1084,-0.0156,-1
2590,200000,1,2,2,31,0,0,0,0,-2,-2,8350,4750,5134,245,56,167,2001,1001,501,201,501,501,0,6349,3749,4633,44,-445,-334,0.031745,0.018745,0.023165,0.00022,-0.002225,-0.00167,-4
2591,130000,0,2,2,54,0,0,0,0,-2,-2,30184,31795,31467,-440,-240,-240,2419,1000,0,200,0,0,0,27765,30795,31467,-640,-240,-240,0.21357692307692308,0.2368846153846154,0.24205384615384615,-0.004923076923076923,-0.0018461538461538461,-0.0018461538461538461,-4
2592,60000,1,2,2,57,0,0,2,0,0,0,44041,46810,45781,48814,49802,51034,3810,0,3814,1802,2034,4459,0,40231,46810,41967,47012,47768,46575,0.6705166666666666,0.7801666666666667,0.69945,0.7835333333333333,0.7961333333333334,0.77625,2
2593,100000,1,1,2,24,-1,3,2,-1,-1,-1,1331,1326,652,326,326,476,0,0,326,326,476,326,0,1331,1326,326,0,-150,150,0.01331,0.01326,0.00326,0.0,-0.0015,0.0015,1
2594,90000,1,2,1,32,1,-1,-1,-1,-1,-1,0,323,0,2520,1651,0,323,0,2520,1651,0,0,1,-323,323,-2520,869,1651,0,-0.003588888888888889,0.003588888888888889,-0.028,0.009655555555555556,0.018344444444444444,0.0,-4
2595,360000,0,2,1,29,0,0,0,-1,0,0,18454,16419,12932,91329,82929,70047,6028,6032,99578,2507,5376,2000,1,12426,10387,-86646,88822,77553,68047,0.03451666666666667,0.02885277777777778,-0.24068333333333333,0.24672777777777777,0.215425,0.18901944444444443,-1
2596,160000,1,1,1,39,-2,-2,-2,-2,-2,-2,710,666,403,1650,336,790,666,403,1650,336,790,1141,1,44,263,-1247,1314,-454,-351,0.000275,0.00164375,-0.00779375,0.0082125,-0.0028375,-0.00219375,-12
2597,50000,0,2,1,37,1,2,2,2,0,0,10904,9316,4328,2846,1585,1324,0,3000,0,0,1000,1000,1,10904,6316,4328,2846,585,324,0.21808,0.12632,0.08656,0.05692,0.0117,0.00648,7
2598,60000,1,3,1,29,0,0,0,0,0,0,59190,56704,48980,34416,28818,28546,2200,2300,3000,1100,1000,1000,1,56990,54404,45980,33316,27818,27546,0.9498333333333333,0.9067333333333333,0.7663333333333333,0.5552666666666667,0.46363333333333334,0.4591,0
2599,160000,1,2,1,41,0,0,0,0,0,0,39962,45640,38988,19825,22654,16158,10000,10000,5000,5000,5000,10000,1,29962,35640,33988,14825,17654,6158,0.1872625,0.22275,0.212425,0.09265625,0.1103375,0.0384875,0
2600,380000,0,2,1,35,0,0,0,0,0,0,27268,75331,72950,70022,70861,70897,50042,3017,3000,3016,3000,4010,1,-22774,72314,69950,67006,67861,66887,-0.05993157894736842,0.1903,0.18407894736842106,0.17633157894736842,0.17858157894736842,0.17601842105263157,0
2601,390000,1,1,2,27,0,0,0,0,0,0,375023,376767,359292,348513,272077,225079,13313,13705,15454,144206,9000,10000,0,361710,363062,343838,204307,263077,215079,0.9274615384615384,0.9309282051282052,0.8816358974358974,0.5238641025641025,0.6745564102564102,0.5514846153846154,0
2602,100000,1,2,1,58,2,2,2,0,0,0,86654,87851,85594,87095,88357,77155,3500,0,3300,2839,3000,4000,1,83154,87851,82294,84256,85357,73155,0.83154,0.87851,0.82294,0.84256,0.85357,0.73155,6
2603,300000,1,1,1,36,1,2,-1,0,0,-1,5602,2700,6300,8100,5400,2700,0,6300,5400,0,2700,7150,1,5602,-3600,900,8100,2700,-4450,0.018673333333333333,-0.012,0.003,0.027,0.009,-0.014833333333333334,1
2604,140000,0,2,2,29,0,0,0,0,-2,-2,132629,55185,56000,0,0,0,5000,2000,0,0,0,0,0,127629,53185,56000,0,0,0,0.9116357142857143,0.37989285714285714,0.4,0.0,0.0,0.0,-4
2605,50000,0,3,1,53,1,-1,-1,0,0,-1,0,484,929,474,0,1288,484,1000,0,0,1288,334,1,-484,-516,929,474,-1288,954,-0.00968,-0.01032,0.01858,0.00948,-0.02576,0.01908,-2
2606,150000,0,3,2,39,-2,-2,-2,-2,-2,-2,1580,2925,-551,-1944,-4430,-5813,2935,4,7,4,7,10004,0,-1355,2921,-558,-1948,-4437,-15817,-0.009033333333333334,0.019473333333333332,-0.00372,-0.012986666666666667,-0.02958,-0.10544666666666666,-12
2607,230000,1,1,2,24,-1,0,0,0,-1,-1,5883,7923,5418,0,2000,987,7000,1000,0,2000,987,1951,0,-1117,6923,5418,-2000,1013,-964,-0.004856521739130435,0.0301,0.023556521739130434,-0.008695652173913044,0.004404347826086957,-0.004191304347826087,-3
2608,50000,1,3,1,52,-2,-2,-2,-2,-2,-2,0,0,0,0,0,0,0,0,0,0,0,0,1,0,0,0,0,0,0,0.0,0.0,0.0,0.0,0.0,0.0,-12
2609,140000,1,1,2,28,0,0,3,2,2,0,47547,55621,54174,54599,53124,54393,9532,0,1900,0,2124,2427,0,38015,55621,52274,54599,51000,51966,0.27153571428571427,0.39729285714285717,0.37338571428571427,0.38999285714285714,0.36428571428571427,0.3711857142857143,7
2610,200000,0,1,1,36,-1,-1,-1,-1,-1,-1,8065,49307,5679,8855,49572,2684,49362,5679,8855,49572,2684,13050,1,-41297,43628,-3176,-40717,46888,-10366,-0.206485,0.21814,-0.01588,-0.203585,0.23444,-0.05183,-6
2611,110000,1,1,2,31,-1,-1,-2,-2,-2,-2,223,0,0,0,0,0,0,0,0,0,0,0,0,223,0,0,0,0,0,0.0020272727272727274,0.0,0.0,0.0,0.0,0.0,-10
2612,280000,0,1,1,45,2,2,2,2,2,2,2482,2482,2482,2482,2482,2482,0,0,0,0,0,18,1,2482,2482,2482,2482,2482,2464,0.008864285714285713,0.008864285714285713,0.008864285714285713,0.008864285714285713,0.008864285714285713,0.0088,12
2613,130000,1,1,2,27,0,0,0,0,0,0,36487,37029,35595,36200,34081,31542,3000,3000,3000,2000,3000,3000,0,33487,34029,32595,34200,31081,28542,0.2575923076923077,0.26176153846153843,0.25073076923076926,0.2630769230769231,0.2390846153846154,0.21955384615384615,0
2614,50000,0,2,2,53,0,0,0,0,0,0,48353,48005,49115,48688,48927,49106,2000,2581,1900,1919,1887,1127,0,46353,45424,47215,46769,47040,47979,0.92706,0.90848,0.9443,0.93538,0.9408,0.95958,0
2615,170000,1,1,2,49,0,0,0,0,0,0,163951,136825,140450,116293,118759,108766,5100,6000,4000,4000,3200,2200,0,158851,130825,136450,112293,115559,106566,0.9344176470588236,0.7695588235294117,0.8026470588235294,0.6605470588235294,0.6797588235294117,0.6268588235294118,0
2616,50000,0,2,2,49,0,0,0,0,0,0,90231,90647,92309,93880,99418,101392,2852,2784,2603,10000,3164,2868,0,87379,87863,89706,83880,96254,98524,1.74758,1.75726,1.79412,1.6776,1.92508,1.97048,0
2617,140000,0,1,1,41,0,0,0,0,0,0,44635,45891,48149,50341,51897,53058,2000,3000,3000,3000,2000,3000,1,42635,42891,45149,47341,49897,50058,0.3045357142857143,0.3063642857142857,0.32249285714285714,0.33815,0.35640714285714287,0.35755714285714285,0
2618,460000,1,2,1,40,0,0,0,0,0,0,133102,126956,126758,121857,122830,90219,5015,5032,4407,4040,3001,3109,1,128087,121924,122351,117817,119829,87110,0.27845,0.2650521739130435,0.2659804347826087,0.25612391304347826,0.26049782608695654,0.18936956521739132,0
2619,20000,0,2,1,53,2,0,0,0,0,0,15794,16515,17827,17874,18288,18557,1281,1593,640,702,612,1000,1,14513,14922,17187,17172,17676,17557,0.72565,0.7461,0.85935,0.8586,0.8838,0.87785,2
2620,240000,0,3,1,38,0,0,0,0,0,0,230131,216824,219487,151295,228276,233079,8500,6900,6000,80000,8600,9000,1,221631,209924,213487,71295,219676,224079,0.9234625,0.8746833333333334,0.8895291666666667,0.2970625,0.9153166666666667,0.9336625,0
2621,240000,0,2,1,40,0,0,0,0,0,0,11671,10030,8132,8402,4585,3551,1810,1151,2029,1003,112,173,1,9861,8879,6103,7399,4473,3378,0.0410875,0.03699583333333333,0.025429166666666666,0.030829166666666668,0.0186375,0.014075,0
2622,280000,0,2,1,35,0,0,0,0,0,0,202260,102097,104596,106950,87706,88396,4000,4000,4000,3000,3600,3100,1,198260,98097,100596,103950,84106,85296,0.7080714285714286,0.35034642857142856,0.3592714285714286,0.37125,0.30037857142857144,0.3046285714285714,0
2623,80000,1,1,2,27,0,0,0,0,0,0,76306,75970,77468,60167,57474,58815,3600,3574,2300,2300,2300,2200,0,72706,72396,75168,57867,55174,56615,0.908825,0.90495,0.9396,0.7233375,0.689675,0.7076875,0
2624,300000,1,2,1,40,0,0,0,0,0,-1,184164,151244,150727,196467,201425,-8276,7028,6000,50000,10013,9505,175074,1,177136,145244,100727,186454,191920,-183350,0.5904533333333334,0.48414666666666667,0.33575666666666665,0.6215133333333334,0.6397333333333334,-0.6111666666666666,-1
2625,360000,0,1,1,41,-2,-2,-2,-2,-2,-2,316,736,2178,316,1812,1510,736,2178,316,1812,1510,485,1,-420,-1442,1862,-1496,302,1025,-0.0011666666666666668,-0.004005555555555556,0.005172222222222222,-0.0041555555555555556,0.0008388888888888889,0.0028472222222222223,-12
2626,220000,0,2,1,32,0,0,0,0,0,0,202010,103124,105226,107476,109746,111920,3746,3820,4000,4000,4000,4500,1,198264,99304,101226,103476,105746,107420,0.9012,0.45138181818181816,0.4601181818181818,0.47034545454545457,0.48066363636363635,0.48827272727272725,0
2627,120000,1,2,1,29,-1,-1,-1,-1,-1,-1,1686,657,2179,1423,0,1820,657,2319,1423,0,1820,2496,1,1029,-1662,756,1423,-1820,-676,0.008575,-0.01385,0.0063,0.011858333333333334,-0.015166666666666667,-0.005633333333333333,-6
2628,230000,1,1,2,42,-1,-1,-1,-1,-1,2,326,326,326,1458,952,476,326,326,1458,952,0,326,0,0,0,-1132,506,952,150,0.0,0.0,-0.004921739130434782,0.0022,0.004139130434782609,0.0006521739130434783,-3
2629,110000,1,1,2,28,0,0,0,0,0,0,65024,61848,57944,53857,35036,31973,2500,2900,2000,2000,2000,2000,0,62524,58948,55944,51857,33036,29973,0.5684,0.5358909090909091,0.5085818181818181,0.47142727272727275,0.3003272727272727,0.27248181818181816,0
2630,340000,0,1,2,30,0,0,-1,-1,-1,0,1933,2855,872,981,22936,8097,1000,872,981,22936,5000,5939,0,933,1983,-109,-21955,17936,2158,0.0027441176470588235,0.005832352941176471,-0.00032058823529411765,-0.06457352941176471,0.052752941176470586,0.006347058823529411,-3
2631,120000,1,1,2,35,-1,-1,-1,-1,0,-1,2776,2549,2558,2577,249,1976,2549,2558,2577,0,1976,1000,0,227,-9,-19,2577,-1727,976,0.0018916666666666667,-7.5e-05,-0.00015833333333333332,0.021475,-0.014391666666666667,0.008133333333333333,-5
2632,140000,1,2,2,53,0,0,0,0,0,0,8068,9446,13271,11243,12091,12691,1535,5004,1451,1000,1000,3194,0,6533,4442,11820,10243,11091,9497,0.046664285714285714,0.031728571428571425,0.08442857142857142,0.07316428571428571,0.07922142857142857,0.06783571428571429,0
2633,150000,1,3,2,28,-1,0,0,0,0,0,35199,36206,36343,45180,45694,45694,1588,1971,20000,914,0,1746,0,33611,34235,16343,44266,45694,43948,0.22407333333333335,0.22823333333333334,0.10895333333333333,0.2951066666666667,0.30462666666666666,0.2929866666666667,-1
2634,170000,0,1,1,39,-2,-2,-2,-2,-2,-2,0,0,905,0,0,0,0,905,0,0,0,0,1,0,-905,905,0,0,0,0.0,-0.005323529411764706,0.005323529411764706,0.0,0.0,0.0,-12
2635,10000,1,2,2,32,0,0,0,0,0,0,8509,9228,9821,9495,9469,10191,1400,1300,350,500,1650,0,0,7109,7928,9471,8995,7819,10191,0.7109,0.7928,0.9471,0.8995,0.7819,1.0191,0
2636,110000,0,1,2,30,0,0,0,0,0,0,110800,112008,96347,49506,49142,49251,4404,2826,1880,1805,2182,2000,0,106396,109182,94467,47701,46960,47251,0.9672363636363637,0.9925636363636363,0.858790909090909,0.43364545454545456,0.4269090909090909,0.42955454545454547,0
2637,600000,0,2,1,50,0,0,0,0,0,0,225274,230414,237135,241033,246081,250971,8773,10561,8629,8934,8984,9306,1,216501,219853,228506,232099,237097,241665,0.360835,0.36642166666666665,0.3808433333333333,0.3868316666666667,0.3951616666666667,0.402775,0
2638,440000,1,1,2,36,-2,-2,-2,-2,-2,-2,0,0,0,0,0,0,0,0,0,0,162000,0,0,0,0,0,0,-162000,0,0.0,0.0,0.0,0.0,-0.36818181818181817,0.0,-12
2639,20000,0,2,2,24,3,2,0,0,-1,-1,18937,18350,18918,19323,13180,5200,0,1251,656,13180,5200,0,0,18937,17099,18262,6143,7980,5200,0.94685,0.85495,0.9131,0.30715,0.399,0.26,3
2640,30000,0,2,2,60,0,0,0,0,0,0,23575,24582,25711,26614,26948,14648,1398,1527,1430,764,530,655,0,22177,23055,24281,25850,26418,13993,0.7392333333333333,0.7685,0.8093666666666667,0.8616666666666667,0.8806,0.4664333333333333,0
2641,130000,0,2,2,31,0,0,0,0,0,0,116437,112881,96191,88934,90633,91459,4911,3533,3301,3607,5516,7020,0,111526,109348,92890,85327,85117,84439,0.8578923076923077,0.8411384615384615,0.7145384615384616,0.6563615384615384,0.6547461538461539,0.6495307692307692,0
2642,500000,1,3,2,40,0,0,0,0,0,0,212961,264961,237006,139311,128095,181304,63000,20078,30141,30000,60000,50000,0,149961,244883,206865,109311,68095,131304,0.299922,0.489766,0.41373,0.218622,0.13619,0.262608,0
2643,110000,1,2,1,40,0,0,0,0,0,0,107035,110156,8871,66482,59578,57961,4000,2500,58000,2000,3000,3500,1,103035,107656,-49129,64482,56578,54461,0.9366818181818182,0.9786909090909091,-0.4466272727272727,0.5862,0.5143454545454546,0.4951,0
2644,230000,1,2,1,39,-2,-2,-2,-2,-2,-2,0,0,0,0,0,0,0,0,0,0,0,0,1,0,0,0,0,0,0,0.0,0.0,0.0,0.0,0.0,0.0,-12
2645,200000,1,2,1,36,-1,-1,-1,-1,-1,-1,371,37647,371,2977,3784,10579,37647,371,2977,3784,10579,10546,1,-37276,37276,-2606,-807,-6795,33,-0.18638,0.18638,-0.01303,-0.004035,-0.033975,0.000165,-6
2646,180000,1,2,1,41,2,0,0,0,0,0,106944,78405,47542,44952,24904,26825,3500,2000,1500,2000,3000,3000,1,103444,76405,46042,42952,21904,23825,0.5746888888888889,0.4244722222222222,0.2557888888888889,0.23862222222222224,0.12168888888888889,0.13236111111111112,2
2647,400000,0,3,1,43,-1,0,0,0,0,-1,145801,134269,100229,57583,8556,316,6100,26621,6600,406,316,316,1,139701,107648,93629,57177,8240,0,0.3492525,0.26912,0.2340725,0.1429425,0.0206,0.0,-2
2648,440000,1,1,1,37,-1,-1,0,-1,-1,-1,10858,46104,21349,11569,-1401,1773,50004,20000,12000,0,3773,0,1,-39146,26104,9349,11569,-5174,1773,-0.08896818181818182,0.05932727272727273,0.021247727272727272,0.02629318181818182,-0.011759090909090908,0.004029545454545455,-5
2649,430000,0,1,1,69,0,-1,-1,-1,-1,0,3658,1962,6591,854,44275,32731,1962,6591,1026,50000,0,3000,1,1696,-4629,5565,-49146,44275,29731,0.003944186046511628,-0.010765116279069767,0.012941860465116278,-0.11429302325581395,0.10296511627906976,0.06914186046511628,-4
2650,500000,0,1,1,52,1,-1,-1,-1,-1,-1,-5,43528,104315,71776,60753,0,43533,104406,71776,60753,0,8200,1,-43538,-60878,32539,11023,60753,-8200,-0.087076,-0.121756,0.065078,0.022046,0.121506,-0.0164,-4
2651,80000,1,2,2,38,-1,-1,-1,0,0,0,390,390,3529,13207,13110,13116,390,3529,10207,500,600,3000,0,0,-3139,-6678,12707,12510,10116,0.0,-0.0392375,-0.083475,0.1588375,0.156375,0.12645,-3
2652,150000,1,1,2,27,-1,-1,-2,-2,-2,-2,1345,0,0,0,0,0,0,0,0,0,0,24948,0,1345,0,0,0,0,-24948,0.008966666666666666,0.0,0.0,0.0,0.0,-0.16632,-10
2653,320000,0,1,2,33,1,-2,-2,-2,-2,-2,0,0,0,0,0,0,0,0,0,0,0,0,0,0,0,0,0,0,0,0.0,0.0,0.0,0.0,0.0,0.0,-9
2654,100000,0,3,1,42,7,6,5,4,3,2,33816,33024,32308,31399,30448,29933,0,60,0,0,0,118,1,33816,32964,32308,31399,30448,29815,0.33816,0.32964,0.32308,0.31399,0.30448,0.29815,27
2655,50000,0,1,2,28,0,0,0,0,0,3,4999,5913,7315,9195,10624,10138,1000,1500,2000,1583,1100,0,0,3999,4413,5315,7612,9524,10138,0.07998,0.08826,0.1063,0.15224,0.19048,0.20276,3
2656,80000,0,1,2,35,0,0,0,0,0,0,52065,55205,55900,55622,56295,61598,5000,2606,2200,2100,6679,1700,0,47065,52599,53700,53522,49616,59898,0.5883125,0.6574875,0.67125,0.669025,0.6202,0.748725,0
2657,100000,1,1,1,32,2,0,0,0,0,2,98033,97995,98781,97946,101885,98015,4620,4700,3900,7900,0,7700,1,93413,93295,94881,90046,101885,90315,0.93413,0.93295,0.94881,0.90046,1.01885,0.90315,4
2658,280000,0,2,1,37,0,0,0,0,0,-1,149227,152331,153080,156000,160000,40485,5505,3258,3120,4000,100045,10000,1,143722,149073,149960,152000,59955,30485,0.5132928571428571,0.5324035714285714,0.5355714285714286,0.5428571428571428,0.214125,0.108875,-1
2659,200000,0,3,1,29,-1,-1,-1,-1,-1,-1,15456,46620,22935,8335,971,4278,46722,22985,8346,971,4296,21767,1,-31266,23635,14589,7364,-3325,-17489,-0.15633,0.118175,0.072945,0.03682,-0.016625,-0.087445,-6
2660,50000,1,2,2,23,0,0,0,0,0,0,47598,40714,38124,19893,20314,18810,2559,1969,684,713,672,670,0,45039,38745,37440,19180,19642,18140,0.90078,0.7749,0.7488,0.3836,0.39284,0.3628,0
2661,200000,1,1,2,26,0,0,0,0,2,2,71574,74755,76945,82914,83733,80498,5000,4000,8000,2900,0,5700,0,66574,70755,68945,80014,83733,74798,0.33287,0.353775,0.344725,0.40007,0.418665,0.37399,4
2662,390000,0,2,1,39,-1,2,-1,-1,0,0,7831,3844,5797,7657,4086,5795,8,5806,7667,95,5804,4721,1,7823,-1962,-1870,7562,-1718,1074,0.020058974358974357,-0.005030769230769231,-0.004794871794871795,0.019389743589743588,-0.004405128205128205,0.002753846153846154,-1
2663,50000,1,1,2,23,0,0,0,0,0,0,8889,10234,13734,14754,16499,18223,1500,4000,1255,2000,2000,3000,0,7389,6234,12479,12754,14499,15223,0.14778,0.12468,0.24958,0.25508,0.28998,0.30446,0
2664,130000,0,3,2,40,0,0,0,0,0,0,129548,129438,129388,127628,64345,62373,6000,6000,5161,2239,3000,2291,0,123548,123438,124227,125389,61345,60082,0.9503692307692307,0.9495230769230769,0.9555923076923077,0.9645307692307692,0.4718846153846154,0.4621692307692308,0
2665,130000,1,3,1,43,0,0,0,0,0,0,32667,33822,34975,35943,36447,37259,2000,2000,1850,1400,1400,1400,1,30667,31822,33125,34543,35047,35859,0.2359,0.24478461538461538,0.2548076923076923,0.26571538461538463,0.2695923076923077,0.27583846153846153,0
2666,40000,1,2,1,36,1,2,0,0,0,0,38430,37537,38156,39581,36506,37893,0,1575,2000,1500,2000,3000,1,38430,35962,36156,38081,34506,34893,0.96075,0.89905,0.9039,0.952025,0.86265,0.872325,3
2667,20000,0,1,2,28,1,-2,-2,-2,-1,0,0,0,0,0,12723,30000,0,0,0,12723,18000,32200,0,0,0,0,-12723,-5277,-2200,0.0,0.0,0.0,-0.63615,-0.26385,-0.11,-6
2668,220000,1,2,1,52,0,0,0,0,0,0,52536,53624,43462,36222,19055,3098,4151,16992,5225,2000,1000,83020,1,48385,36632,38237,34222,18055,-79922,0.21993181818181817,0.1665090909090909,0.17380454545454546,0.15555454545454545,0.08206818181818182,-0.3632818181818182,0
2669,350000,1,1,3,53,1,-2,-2,-2,-2,-1,36138,7613,5875,4020,33127,6877,7619,5875,4020,33127,6877,0,0,28519,1738,1855,-29107,26250,6877,0.08148285714285715,0.004965714285714286,0.0053,-0.08316285714285715,0.075,0.01964857142857143,-8
2670,50000,1,2,2,49,2,0,0,0,0,0,50986,48599,17815,16362,14694,13520,1325,1512,532,514,524,384,0,49661,47087,17283,15848,14170,13136,0.99322,0.94174,0.34566,0.31696,0.2834,0.26272,2
2671,100000,1,2,2,28,0,0,0,0,0,0,101557,101518,97664,70995,70183,71068,5000,4000,2700,2500,2800,2600,0,96557,97518,94964,68495,67383,68468,0.96557,0.97518,0.94964,0.68495,0.67383,0.68468,0
2672,390000,1,2,1,39,-1,-1,-1,-1,-1,0,827,827,827,1036,15209,15156,827,827,1036,15000,1000,1000,1,0,0,-209,-13964,14209,14156,0.0,0.0,-0.0005358974358974359,-0.035805128205128205,0.03643333333333333,0.0362974358974359,-5
2673,460000,1,1,2,32,-2,-2,-2,-2,-2,-2,13377,12776,8364,20465,13714,38090,12840,8403,20552,13778,38266,25005,0,537,4373,-12188,6687,-24552,13085,0.001167391304347826,0.009506521739130434,-0.026495652173913045,0.014536956521739131,-0.05337391304347826,0.028445652173913042,-12
2674,110000,1,1,2,24,0,0,2,0,0,0,111863,111569,110768,110480,48708,47060,6001,5000,5060,2000,3000,5000,0,105862,106569,105708,108480,45708,42060,0.9623818181818182,0.968809090909091,0.9609818181818182,0.9861818181818182,0.41552727272727275,0.38236363636363635,2
2675,340000,1,2,1,47,-1,-1,-1,-1,-1,-1,507,892,5221,7627,580,999,892,5269,8193,596,999,176340,1,-385,-4377,-2972,7031,-419,-175341,-0.0011323529411764706,-0.012873529411764706,-0.008741176470588235,0.020679411764705884,-0.0012323529411764707,-0.5157088235294117,-6
2676,330000,0,1,2,44,0,0,0,0,0,0,604019,605943,439854,404157,370686,294348,19001,14000,12000,15000,7000,7000,0,585018,591943,427854,389157,363686,287348,1.7727818181818182,1.7937666666666667,1.2965272727272728,1.1792636363636364,1.1020787878787879,0.8707515151515152,0
2677,300000,0,1,2,40,1,-2,-2,-2,-2,-2,0,0,0,0,0,0,0,0,0,0,0,0,0,0,0,0,0,0,0,0.0,0.0,0.0,0.0,0.0,0.0,-9
2678,50000,1,2,1,32,0,0,0,0,0,0,45271,44751,43952,29136,19048,17946,2000,1500,1239,612,607,2593,1,43271,43251,42713,28524,18441,15353,0.86542,0.86502,0.85426,0.57048,0.36882,0.30706,0
2679,30000,1,2,2,24,0,0,0,0,0,0,27391,28412,28575,28925,24159,0,1767,1700,1010,1141,0,0,0,25624,26712,27565,27784,24159,0,0.8541333333333333,0.8904,0.9188333333333333,0.9261333333333334,0.8053,0.0,0
2680,500000,1,1,1,45,-1,-1,-1,-1,-1,-1,36954,-24704,22999,18339,-3876,15586,0,83000,0,0,20000,18000,1,36954,-107704,22999,18339,-23876,-2414,0.073908,-0.215408,0.045998,0.036678,-0.047752,-0.004828,-6
2681,80000,0,1,1,53,0,-1,0,0,0,2,9527,42908,42108,30610,32396,31743,42908,2400,1900,2600,0,2700,1,-33381,40508,40208,28010,32396,29043,-0.4172625,0.50635,0.5026,0.350125,0.40495,0.3630375,1
2682,80000,1,3,2,40,3,2,2,2,2,2,38503,40118,41199,42264,43083,43471,2500,2000,2000,1600,1200,2000,0,36003,38118,39199,40664,41883,41471,0.4500375,0.476475,0.4899875,0.5083,0.5235375,0.5183875,13
2683,70000,1,2,1,39,3,2,2,2,2,2,20392,19772,22234,21579,22720,23704,0,3100,0,1500,1500,0,1,20392,16672,22234,20079,21220,23704,0.2913142857142857,0.23817142857142856,0.3176285714285714,0.2868428571428571,0.30314285714285716,0.33862857142857145,13
2684,100000,1,3,1,43,2,2,0,0,0,0,100304,97814,100337,100585,52041,70731,0,5000,2623,2500,32000,2567,1,100304,92814,97714,98085,20041,68164,1.00304,0.92814,0.97714,0.98085,0.20041,0.68164,4
2685,20000,0,2,2,52,0,0,0,2,2,-2,13874,14488,16029,15470,0,0,1238,2559,0,0,0,0,0,12636,11929,16029,15470,0,0,0.6318,0.59645,0.80145,0.7735,0.0,0.0,2
2686,80000,1,1,2,31,-1,-1,-1,-1,-1,2,14401,4374,15020,4233,5934,158,4374,15037,4233,6092,0,13391,0,10027,-10663,10787,-1859,5934,-13233,0.1253375,-0.1332875,0.1348375,-0.0232375,0.074175,-0.1654125,-3
2687,500000,1,2,1,39,-1,-1,-1,-1,-1,-1,36550,18752,22376,39018,4233,397,18795,22398,39041,4233,397,28337,1,17755,-3646,-16665,34785,3836,-27940,0.03551,-0.007292,-0.03333,0.06957,0.007672,-0.05588,-6
2688,260000,1,2,2,26,0,0,2,2,0,0,258364,279322,282092,255409,257913,262004,45446,9000,0,9394,9628,8539,0,212918,270322,282092,246015,248285,253465,0.8189153846153846,1.0397,1.0849692307692307,0.9462115384615385,0.9549423076923077,0.9748653846153846,4
2689,150000,1,2,2,39,1,2,2,0,0,2,21019,19890,19271,19037,20448,19345,1602,0,1000,1709,0,1000,0,19417,19890,18271,17328,20448,18345,0.12944666666666665,0.1326,0.12180666666666666,0.11552,0.13632,0.1223,7
2690,120000,1,3,1,45,-2,-2,-2,-2,-2,-2,0,0,0,0,0,0,0,0,0,0,0,0,1,0,0,0,0,0,0,0.0,0.0,0.0,0.0,0.0,0.0,-12
2691,340000,1,1,1,27,0,0,-2,-1,-1,-1,307650,0,0,495,495,1528,0,0,495,495,1528,3254,1,307650,0,-495,0,-1033,-1726,0.9048529411764706,0.0,-0.0014558823529411764,0.0,-0.003038235294117647,-0.005076470588235294,-5
2692,170000,0,2,1,52,3,2,2,-2,-1,-1,2184,1990,0,0,3955,1278,0,0,0,3955,1278,1316,1,2184,1990,0,-3955,2677,-38,0.012847058823529411,0.011705882352941177,0.0,-0.02326470588235294,0.015747058823529413,-0.0002235294117647059,3
2693,310000,1,1,2,32,-2,-2,-2,-2,-2,-2,90654,20784,5649,9141,5122,380,27778,5649,9141,5122,380,2475,0,62876,15135,-3492,4019,4742,-2095,0.2028258064516129,0.04882258064516129,-0.011264516129032258,0.012964516129032258,0.015296774193548386,-0.006758064516129032,-12
2694,120000,1,2,1,47,-1,-1,-1,-1,-1,-1,1188,2512,3444,1742,502,346,2512,3444,1742,502,346,325,1,-1324,-932,1702,1240,156,21,-0.011033333333333332,-0.0077666666666666665,0.014183333333333333,0.010333333333333333,0.0013,0.000175,-6
2695,300000,1,3,1,30,0,0,0,0,0,0,25936,26008,26324,27249,46007,46764,1500,1800,2000,20000,2160,2400,1,24436,24208,24324,7249,43847,44364,0.08145333333333334,0.08069333333333334,0.08108,0.024163333333333332,0.14615666666666666,0.14788,0
2696,30000,0,2,2,26,0,0,0,0,0,0,25531,26301,27376,28359,24844,25364,1500,1500,1450,889,920,992,0,24031,24801,25926,27470,23924,24372,0.8010333333333334,0.8267,0.8642,0.9156666666666666,0.7974666666666667,0.8124,0
2697,230000,0,1,1,39,0,0,0,0,0,0,220706,227741,183268,186989,159345,162695,11200,6200,6237,7000,6000,6100,1,209506,221541,177031,179989,153345,156595,0.910895652173913,0.9632217391304347,0.7697,0.7825608695652174,0.6667173913043478,0.6808478260869565,0
2698,240000,1,2,1,56,2,2,-2,-2,-2,-2,2500,0,0,0,0,0,0,0,0,0,0,0,1,2500,0,0,0,0,0,0.010416666666666666,0.0,0.0,0.0,0.0,0.0,-4
2699,30000,1,2,1,34,-1,-1,2,-1,-1,3,5088,996,888,656,1957,1536,996,0,656,1957,0,0,1,4092,996,232,-1301,1957,1536,0.1364,0.0332,0.007733333333333333,-0.043366666666666664,0.06523333333333334,0.0512,1
2700,150000,1,2,1,45,-1,-1,-1,-1,-1,-1,2605,2605,4590,2605,2605,3795,2605,4590,2605,2605,3795,10675,1,0,-1985,1985,0,-1190,-6880,0.0,-0.013233333333333333,0.013233333333333333,0.0,-0.007933333333333334,-0.04586666666666667,-6
2701,340000,1,2,1,46,-2,-2,-2,-2,-2,-2,0,0,0,0,0,0,0,0,0,0,0,0,1,0,0,0,0,0,0,0.0,0.0,0.0,0.0,0.0,0.0,-12
2702,360000,0,1,1,44,0,0,0,0,0,0,162773,158557,158098,153896,152053,128253,5676,6019,5315,4975,4701,4516,1,157097,152538,152783,148921,147352,123737,0.43638055555555555,0.4237166666666667,0.4243972222222222,0.4136694444444444,0.4093111111111111,0.3437138888888889,0
2703,140000,1,3,1,56,0,0,0,0,0,0,141342,137996,139888,126590,111187,111414,5025,5962,4878,4100,4200,4003,1,136317,132034,135010,122490,106987,107411,0.9736928571428571,0.9431,0.9643571428571428,0.8749285714285714,0.7641928571428571,0.7672214285714286,0
2704,250000,1,1,2,28,0,0,0,0,-1,0,45687,31114,21867,13190,27817,22001,5000,1585,3028,27817,0,0,0,40687,29529,18839,-14627,27817,22001,0.162748,0.118116,0.075356,-0.058508,0.111268,0.088004,-1
2705,20000,0,2,1,39,2,0,0,0,0,0,20264,20328,19299,19928,20204,20398,1500,1500,900,700,1480,0,1,18764,18828,18399,19228,18724,20398,0.9382,0.9414,0.91995,0.9614,0.9362,1.0199,2
2706,70000,1,1,2,29,0,0,0,2,2,2,40048,40783,44205,44784,43763,46646,1700,4100,1600,0,3600,2000,0,38348,36683,42605,44784,40163,44646,0.5478285714285714,0.5240428571428571,0.6086428571428572,0.6397714285714285,0.5737571428571429,0.6378,6
2707,180000,1,1,2,31,-2,-2,-2,-2,-2,-2,-23,5631,2771,390,0,0,5654,2771,390,0,0,999,0,-5677,2860,2381,390,0,-999,-0.03153888888888889,0.01588888888888889,0.013227777777777778,0.0021666666666666666,0.0,-0.00555,-12
2708,330000,1,2,1,45,0,0,0,0,0,0,47644,48906,50531,50595,40491,31020,2000,2500,1309,1243,2027,1056,1,45644,46406,49222,49352,38464,29964,0.1383151515151515,0.14062424242424243,0.14915757575757577,0.14955151515151516,0.11655757575757576,0.0908,0
2709,480000,0,2,1,30,-1,-1,-1,-1,-1,-1,1309,662,645,32636,27552,1428,668,645,32641,27552,1428,11822,1,641,17,-31996,5084,26124,-10394,0.0013354166666666666,3.541666666666667e-05,-0.06665833333333333,0.010591666666666666,0.054425,-0.021654166666666665,-6
2710,450000,1,2,1,37,-1,-1,-1,-1,-1,-1,1212,791,2663,783,1730,-51443,1032,2663,783,1730,0,70803,1,180,-1872,1880,-947,1730,-122246,0.0004,-0.00416,0.004177777777777778,-0.0021044444444444444,0.0038444444444444446,-0.2716577777777778,-6
2711,130000,0,2,2,42,0,0,0,0,0,0,83521,84373,86004,87718,90720,87851,3087,3059,3080,4355,3323,3192,0,80434,81314,82924,83363,87397,84659,0.6187230769230769,0.6254923076923077,0.6378769230769231,0.6412538461538462,0.6722846153846154,0.6512230769230769,0
2712,500000,0,2,2,28,0,0,0,0,0,0,33758,33048,45422,46483,39598,40622,1626,13000,2100,37000,1234,3512,0,32132,20048,43322,9483,38364,37110,0.064264,0.040096,0.086644,0.018966,0.076728,0.07422,0
2713,100000,1,2,1,36,-2,-2,-2,-2,-2,-2,2205,0,1983,3543,0,0,0,1983,3543,0,0,2645,1,2205,-1983,-1560,3543,0,-2645,0.02205,-0.01983,-0.0156,0.03543,0.0,-0.02645,-12
2714,70000,0,2,1,34,0,0,0,0,0,0,66977,68904,68863,33809,34764,36989,3013,2627,1210,1500,3000,2000,1,63964,66277,67653,32309,31764,34989,0.9137714285714286,0.9468142857142857,0.9664714285714285,0.46155714285714283,0.45377142857142855,0.49984285714285714,0
2715,20000,1,2,1,32,1,2,2,2,0,0,17044,16478,19098,18397,18696,38282,0,3200,0,700,700,500,1,17044,13278,19098,17697,17996,37782,0.8522,0.6639,0.9549,0.88485,0.8998,1.8891,7
2716,380000,1,3,1,54,-1,-1,0,0,-1,-1,1630,65757,65201,39281,80561,19302,65757,1628,196,80962,19395,13452,1,-64127,64129,65005,-41681,61166,5850,-0.16875526315789474,0.16876052631578947,0.1710657894736842,-0.10968684210526315,0.16096315789473684,0.015394736842105263,-4
2717,180000,1,1,2,32,0,-1,0,0,0,-1,64008,3414,3844,5344,4000,10395,3414,1500,1500,0,10395,3600,0,60594,1914,2344,5344,-6395,6795,0.33663333333333334,0.010633333333333333,0.013022222222222221,0.02968888888888889,-0.035527777777777776,0.03775,-2
2718,80000,1,2,1,32,-1,-1,-2,-2,-2,-2,11262,0,0,0,0,0,0,0,0,0,0,0,1,11262,0,0,0,0,0,0.140775,0.0,0.0,0.0,0.0,0.0,-10
2719,20000,1,2,1,23,-1,-1,-1,-1,0,-1,3426,11581,10713,4272,4285,16542,11615,10739,4272,13,16687,952,1,-8189,842,6441,4259,-12402,15590,-0.40945,0.0421,0.32205,0.21295,-0.6201,0.7795,-5
2720,260000,1,1,1,44,1,-1,-1,-2,-1,2,0,6500,0,0,2223,2056,6500,0,0,2223,0,60934,1,-6500,6500,0,-2223,2223,-58878,-0.025,0.025,0.0,-0.00855,0.00855,-0.22645384615384614,-2
2721,50000,0,3,1,41,1,2,2,0,0,0,85579,78993,69424,64201,58110,57337,3023,23,4023,2523,7926,102,1,82556,78970,65401,61678,50184,57235,1.65112,1.5794,1.30802,1.23356,1.00368,1.1447,5
2722,320000,1,2,1,39,0,0,0,0,0,0,147440,137938,131816,120761,120375,120897,5009,6125,4001,4013,5000,4015,1,142431,131813,127815,116748,115375,116882,0.445096875,0.411915625,0.399421875,0.3648375,0.360546875,0.36525625,0
2723,220000,1,2,2,28,-1,-1,-1,-1,-1,-1,7468,5045,4944,7083,2495,8365,5045,4949,7083,2495,8365,5574,0,2423,96,-2139,4588,-5870,2791,0.011013636363636364,0.00043636363636363637,-0.009722727272727274,0.020854545454545455,-0.02668181818181818,0.012686363636363636,-6
2724,150000,1,1,1,31,0,0,0,0,0,0,138121,145763,134887,105822,86341,88072,10001,6712,5500,3400,3201,3403,1,128120,139051,129387,102422,83140,84669,0.8541333333333333,0.9270066666666666,0.86258,0.6828133333333334,0.5542666666666667,0.56446,0
2725,80000,1,2,1,43,1,2,0,0,2,0,24621,23948,24751,26493,25936,26304,0,1500,2150,0,944,2000,1,24621,22448,22601,26493,24992,24304,0.3077625,0.2806,0.2825125,0.3311625,0.3124,0.3038,5
2726,140000,1,1,1,34,-1,-1,-2,-2,-2,-1,2574,0,0,0,0,840,0,0,0,0,840,1380,1,2574,0,0,0,-840,-540,0.018385714285714286,0.0,0.0,0.0,-0.006,-0.003857142857142857,-9
2727,350000,0,1,1,50,0,0,0,0,0,0,93676,91832,88719,87968,84596,82785,3240,5006,4014,3010,3043,5003,1,90436,86826,84705,84958,81553,77782,0.2583885714285714,0.24807428571428572,0.2420142857142857,0.24273714285714285,0.23300857142857143,0.22223428571428572,0
2728,180000,1,2,1,37,1,-2,-1,0,0,0,-1279,-2329,2115,2329,850,0,0,4444,214,0,0,0,1,-1279,-6773,1901,2329,850,0,-0.007105555555555556,-0.03762777777777778,0.010561111111111111,0.012938888888888889,0.004722222222222222,0.0,-2
2729,200000,1,1,2,29,1,-2,-1,-1,-2,-1,0,0,35063,0,0,5799,0,35063,16720,0,5799,0,0,0,-35063,18343,0,-5799,5799,0.0,-0.175315,0.091715,0.0,-0.028995,0.028995,-6
2730,80000,1,3,1,65,0,0,0,0,0,0,80260,82116,80299,81416,81617,81607,3750,3520,3069,3271,3262,3237,1,76510,78596,77230,78145,78355,78370,0.956375,0.98245,0.965375,0.9768125,0.9794375,0.979625,0
2731,50000,0,2,1,44,2,-1,2,0,0,0,1473,2423,950,1560,1170,780,2423,0,1000,0,0,0,1,-950,2423,-50,1560,1170,780,-0.019,0.04846,-0.001,0.0312,0.0234,0.0156,3
2732,90000,1,1,2,25,0,0,0,0,0,0,33336,39009,47657,52372,52112,56257,10000,10000,6000,1570,5000,1363,0,23336,29009,41657,50802,47112,54894,0.2592888888888889,0.32232222222222223,0.4628555555555556,0.5644666666666667,0.5234666666666666,0.6099333333333333,0
2733,140000,1,2,2,38,0,0,0,0,0,0,135034,133283,132765,123208,97154,97687,4729,5434,4751,3500,3500,3800,0,130305,127849,128014,119708,93654,93887,0.93075,0.9132071428571429,0.9143857142857142,0.8550571428571428,0.6689571428571428,0.6706214285714286,0
2734,210000,1,1,2,34,-1,-1,-1,-2,-1,-1,300878,2250,0,0,692,1560,2250,0,0,692,1560,1838,0,298628,2250,0,-692,-868,-278,1.4220380952380953,0.010714285714285714,0.0,-0.0032952380952380954,-0.0041333333333333335,-0.0013238095238095238,-7
2735,150000,1,2,1,27,-1,-1,0,0,0,0,1108,143813,149350,149984,130610,121793,147314,7752,6046,2753,5583,6700,1,-146206,136061,143304,147231,125027,115093,-0.9747066666666667,0.9070733333333333,0.95536,0.98154,0.8335133333333333,0.7672866666666667,-2
2736,140000,0,3,2,35,0,0,2,0,0,0,47422,52831,51345,49734,50476,50751,6800,8,1718,4000,2001,1879,0,40622,52823,49627,45734,48475,48872,0.29015714285714284,0.37730714285714284,0.3544785714285714,0.32667142857142856,0.34625,0.3490857142857143,2
2737,320000,1,4,1,46,-2,-2,-2,-2,-2,-2,17849,5149,16615,2914,696,740,5149,16654,2914,696,740,6498,1,12700,-11505,13701,2218,-44,-5758,0.0396875,-0.035953125,0.042815625,0.00693125,-0.0001375,-0.01799375,-12
2738,360000,1,1,2,30,0,0,0,0,0,0,146277,102869,102283,86370,86432,73607,6029,5487,5043,10084,5059,5040,0,140248,97382,97240,76286,81373,68567,0.3895777777777778,0.27050555555555555,0.27011111111111114,0.21190555555555557,0.2260361111111111,0.19046388888888888,0
2739,240000,0,1,1,36,1,-2,-2,-2,-2,-2,0,0,0,0,0,0,0,0,0,0,0,0,1,0,0,0,0,0,0,0.0,0.0,0.0,0.0,0.0,0.0,-9
2740,180000,1,2,1,44,-1,-1,-1,-1,-1,-2,108,131,550,99,0,0,131,550,99,0,0,0,1,-23,-419,451,99,0,0,-0.0001277777777777778,-0.0023277777777777776,0.0025055555555555556,0.00055,0.0,0.0,-7
2741,160000,1,1,2,27,0,0,0,0,0,0,124573,122730,125319,125283,124170,125140,5800,5900,5900,4300,4600,4400,0,118773,116830,119419,120983,119570,120740,0.74233125,0.7301875,0.74636875,0.75614375,0.7473125,0.754625,0
2742,10000,0,1,1,41,0,0,3,2,2,2,6859,9751,9451,9169,10056,8559,3000,0,0,1002,0,500,1,3859,9751,9451,8167,10056,8059,0.3859,0.9751,0.9451,0.8167,1.0056,0.8059,9
2743,180000,0,2,2,39,-1,-1,-1,-1,-1,0,3135,2822,1938,5818,2628,2628,2833,2015,5818,2628,0,0,0,302,807,-3880,3190,2628,2628,0.0016777777777777778,0.004483333333333333,-0.021555555555555557,0.017722222222222223,0.0146,0.0146,-5
2744,20000,0,2,1,40,1,2,2,0,0,0,15919,16939,16374,16604,16837,17357,1570,0,800,650,800,1000,1,14349,16939,15574,15954,16037,16357,0.71745,0.84695,0.7787,0.7977,0.80185,0.81785,5
2745,50000,0,3,2,36,0,0,0,0,-2,-2,47911,48418,7000,0,0,0,2166,1000,0,0,0,0,0,45745,47418,7000,0,0,0,0.9149,0.94836,0.14,0.0,0.0,0.0,-4
2746,290000,0,1,2,29,-1,-1,-1,-1,0,0,783,2830,1357,14959,13459,115990,2838,1359,14968,2022,110142,205,0,-2055,1471,-13611,12937,-96683,115785,-0.007086206896551724,0.005072413793103448,-0.04693448275862069,0.044610344827586204,-0.3333896551724138,0.3992586206896552,-4
2747,260000,0,1,1,59,-1,-1,-1,-1,-1,-1,1929,-627,4134,792,1309,2557,627,7388,792,1312,2564,804,1,1302,-8015,3342,-520,-1255,1753,0.005007692307692308,-0.030826923076923078,0.012853846153846153,-0.002,-0.004826923076923077,0.006742307692307692,-6
2748,500000,1,1,2,34,0,0,0,0,0,0,119451,143348,159291,262663,308074,400050,26000,20000,106700,50000,100000,200000,0,93451,123348,52591,212663,208074,200050,0.186902,0.246696,0.105182,0.425326,0.416148,0.4001,0
2749,50000,1,2,1,50,0,0,0,0,0,0,49068,47947,49293,41941,39643,39273,1848,2194,1842,1544,1396,1420,1,47220,45753,47451,40397,38247,37853,0.9444,0.91506,0.94902,0.80794,0.76494,0.75706,0
2750,20000,1,1,2,22,-1,-1,-2,-2,-2,-2,18356,0,0,0,0,0,0,0,0,0,0,0,0,18356,0,0,0,0,0,0.9178,0.0,0.0,0.0,0.0,0.0,-10
2751,230000,1,1,2,25,0,0,0,0,0,-2,32915,21726,12299,5860,0,0,4794,3116,5029,0,0,0,0,28121,18610,7270,5860,0,0,0.12226521739130435,0.08091304347826087,0.03160869565217391,0.025478260869565218,0.0,0.0,-2
2752,360000,1,3,1,31,-1,-1,-1,-1,-1,-1,28835,14596,10705,3400,6410,5479,14596,10705,3400,6410,5479,4120,1,14239,3891,7305,-3010,931,1359,0.03955277777777778,0.010808333333333333,0.020291666666666666,-0.00836111111111111,0.002586111111111111,0.003775,-6
2753,220000,1,3,2,27,2,2,2,3,2,0,150739,153827,156531,154721,150627,154034,7000,7000,2300,0,5600,4500,0,143739,146827,154231,154721,145027,149534,0.653359090909091,0.6673954545454546,0.70105,0.7032772727272727,0.6592136363636364,0.6797,11
2754,300000,1,2,1,36,-1,-1,-2,-1,-1,-1,77765,1443,41071,58995,24713,28948,1443,41071,58995,24713,28948,7210,1,76322,-39628,-17924,34282,-4235,21738,0.25440666666666667,-0.13209333333333334,-0.05974666666666666,0.11427333333333334,-0.014116666666666666,0.07246,-7
2755,160000,1,2,2,30,-2,-2,-2,-2,-2,-2,-38,-38,-38,-38,-38,-38,0,0,0,0,0,0,0,-38,-38,-38,-38,-38,-38,-0.0002375,-0.0002375,-0.0002375,-0.0002375,-0.0002375,-0.0002375,-12
2756,80000,0,2,1,23,-2,-2,-2,-2,-2,-2,795,1698,798,-2,748,708,1703,800,0,750,810,1310,1,-908,898,798,-752,-62,-602,-0.01135,0.011225,0.009975,-0.0094,-0.000775,-0.007525,-12
2757,100000,0,2,2,26,0,0,0,0,0,0,32186,32949,33680,34419,37782,76185,2000,2000,2000,4500,40000,3000,0,30186,30949,31680,29919,-2218,73185,0.30186,0.30949,0.3168,0.29919,-0.02218,0.73185,0
2758,20000,1,2,1,31,0,0,0,0,0,0,13080,10911,18890,11026,5863,3273,1500,2000,2000,1000,1000,0,1,11580,8911,16890,10026,4863,3273,0.579,0.44555,0.8445,0.5013,0.24315,0.16365,0
2759,50000,1,2,1,22,0,0,0,0,0,0,47718,48719,47725,46467,14767,15085,2106,2200,2000,1000,700,800,1,45612,46519,45725,45467,14067,14285,0.91224,0.93038,0.9145,0.90934,0.28134,0.2857,0
2760,20000,1,1,2,22,0,0,0,0,0,-1,9930,8176,6860,7000,10199,1500,1336,1000,140,3199,1500,780,0,8594,7176,6720,3801,8699,720,0.4297,0.3588,0.336,0.19005,0.43495,0.036,-1
2761,150000,1,3,1,46,0,0,0,0,0,0,61510,62731,64047,65966,66671,68067,2240,2321,2980,2400,2468,2611,1,59270,60410,61067,63566,64203,65456,0.39513333333333334,0.40273333333333333,0.4071133333333333,0.42377333333333334,0.42802,0.43637333333333334,0
2762,150000,0,1,2,35,0,0,0,0,0,0,251063,244285,238438,232570,226808,220586,9000,10000,10000,8000,8000,7000,0,242063,234285,228438,224570,218808,213586,1.6137533333333334,1.5619,1.52292,1.4971333333333334,1.45872,1.4239066666666667,0
2763,410000,0,1,2,32,-1,0,-1,-1,-1,-1,3339,13047,7764,623,4695,4133,10000,7764,623,4695,5973,4421,0,-6661,5283,7141,-4072,-1278,-288,-0.016246341463414634,0.012885365853658537,0.017417073170731708,-0.009931707317073171,-0.003117073170731707,-0.0007024390243902439,-5
2764,80000,1,1,2,25,-2,-2,-2,-2,-2,-2,0,0,988,0,0,0,0,988,0,0,0,0,0,0,-988,988,0,0,0,0.0,-0.01235,0.01235,0.0,0.0,0.0,-12
2765,150000,0,1,1,34,1,-1,-1,-1,-1,-1,0,347,-13,4085,4006,826,347,0,4098,4006,826,3146,1,-347,347,-4111,79,3180,-2320,-0.0023133333333333335,0.0023133333333333335,-0.027406666666666666,0.0005266666666666667,0.0212,-0.015466666666666667,-4
2766,180000,0,1,2,29,-1,-1,-1,-1,-1,-1,1430,1785,435,2145,3090,4165,1785,435,2145,3090,4165,16828,0,-355,1350,-1710,-945,-1075,-12663,-0.0019722222222222224,0.0075,-0.0095,-0.00525,-0.0059722222222222225,-0.07035,-6
2767,240000,1,2,1,38,1,2,-1,2,2,2,7466,221,189,189,1648,1459,899,198,0,1459,0,1250,1,6567,23,189,-1270,1648,209,0.0273625,9.583333333333334e-05,0.0007875,-0.005291666666666667,0.006866666666666667,0.0008708333333333334,8
2768,60000,1,1,2,23,0,0,0,0,0,0,17191,17864,18408,18393,18238,18345,1700,1600,1000,1000,1000,2000,0,15491,16264,17408,17393,17238,16345,0.2581833333333333,0.2710666666666667,0.29013333333333335,0.2898833333333333,0.2873,0.27241666666666664,0
2769,200000,1,2,1,29,0,0,0,0,0,0,118729,121398,125899,128933,129427,132338,4874,6690,7000,4500,5000,4682,1,113855,114708,118899,124433,124427,127656,0.569275,0.57354,0.594495,0.622165,0.622135,0.63828,0
2770,300000,1,2,1,27,0,0,0,0,0,0,286321,283547,578971,293063,296677,230338,20000,12003,10524,11238,8814,9463,1,266321,271544,568447,281825,287863,220875,0.8877366666666666,0.9051466666666667,1.8948233333333333,0.9394166666666667,0.9595433333333333,0.73625,0
2771,210000,0,1,2,40,-1,-1,-1,-1,-1,-1,1535,2652,179,1326,1326,1326,2652,179,1326,1326,1326,4182,0,-1117,2473,-1147,0,0,-2856,-0.005319047619047619,0.011776190476190477,-0.005461904761904762,0.0,0.0,-0.0136,-6
2772,130000,1,1,2,26,-2,-2,-2,-2,-2,-2,1016,0,0,0,402,0,0,0,0,402,0,2054,0,1016,0,0,-402,402,-2054,0.007815384615384615,0.0,0.0,-0.0030923076923076924,0.0030923076923076924,-0.0158,-12
2773,340000,1,2,1,43,-2,-2,-2,-2,-2,-2,33245,249,27476,0,0,24272,249,27477,0,0,24272,11008,1,32996,-27228,27476,0,-24272,13264,0.09704705882352942,-0.08008235294117647,0.08081176470588235,0.0,-0.07138823529411764,0.03901176470588235,-12
2774,20000,0,2,1,43,2,0,0,2,0,0,11573,12372,14946,14409,16659,17887,1300,2787,0,2500,1500,0,1,10273,9585,14946,11909,15159,17887,0.51365,0.47925,0.7473,0.59545,0.75795,0.89435,4
2775,500000,0,2,2,36,1,-2,-1,0,0,0,226,8546,121867,116089,114293,118081,9125,126768,3468,4050,15099,5015,0,-8899,-118222,118399,112039,99194,113066,-0.017798,-0.236444,0.236798,0.224078,0.198388,0.226132,-2
2776,400000,0,2,2,27,0,0,0,0,0,0,15330,8626,11470,10745,20737,9545,2501,10009,1437,1105,510,959,0,12829,-1383,10033,9640,20227,8586,0.0320725,-0.0034575,0.0250825,0.0241,0.0505675,0.021465,0
2777,20000,1,2,1,43,2,0,0,0,0,2,15294,16340,17359,17776,19293,18844,1300,1300,700,1800,0,1000,1,13994,15040,16659,15976,19293,17844,0.6997,0.752,0.83295,0.7988,0.96465,0.8922,4
2778,130000,1,2,2,32,0,0,0,0,0,0,7469,8472,9143,9741,9713,9458,1138,1173,1138,477,400,600,0,6331,7299,8005,9264,9313,8858,0.0487,0.056146153846153846,0.06157692307692308,0.07126153846153846,0.07163846153846154,0.06813846153846154,0
2779,30000,0,2,2,37,0,0,0,0,0,0,23422,24425,25463,26453,26987,28760,1397,1435,1425,959,2201,1200,0,22025,22990,24038,25494,24786,27560,0.7341666666666666,0.7663333333333333,0.8012666666666667,0.8498,0.8262,0.9186666666666666,0
2780,70000,1,1,2,34,0,0,0,0,0,0,36467,40505,43333,36959,27296,23474,5000,5000,1500,546,1000,1746,0,31467,35505,41833,36413,26296,21728,0.44952857142857144,0.5072142857142857,0.5976142857142858,0.5201857142857143,0.37565714285714286,0.3104,0
2781,30000,1,3,2,42,0,0,0,2,0,0,26300,26295,26167,25413,25122,20448,1700,3102,1000,1015,700,1000,0,24600,23193,25167,24398,24422,19448,0.82,0.7731,0.8389,0.8132666666666667,0.8140666666666667,0.6482666666666667,2
2782,20000,0,2,1,41,1,-1,-1,-1,0,0,0,3793,1100,17982,18166,0,3793,1103,17982,384,8,17839,1,-3793,2690,-16882,17598,18158,-17839,-0.18965,0.1345,-0.8441,0.8799,0.9079,-0.89195,-2
2783,120000,1,2,1,41,0,0,0,-1,2,0,14792,20084,0,6849,6598,16205,10000,0,6849,0,10000,2000,1,4792,20084,-6849,6849,-3402,14205,0.039933333333333335,0.16736666666666666,-0.057075,0.057075,-0.02835,0.118375,1
2784,20000,0,3,2,43,0,0,0,0,0,0,19107,20120,19445,19831,19473,20009,1330,1274,660,752,906,650,0,17777,18846,18785,19079,18567,19359,0.88885,0.9423,0.93925,0.95395,0.92835,0.96795,0
2785,20000,1,3,2,50,0,0,0,0,0,0,16350,17382,18488,19179,19720,19822,1300,1400,1000,1000,626,300,0,15050,15982,17488,18179,19094,19522,0.7525,0.7991,0.8744,0.90895,0.9547,0.9761,0
2786,300000,1,2,2,35,0,0,0,0,0,0,291619,297268,205629,215827,208464,212508,12019,9006,17000,12000,9557,15000,0,279600,288262,188629,203827,198907,197508,0.932,0.9608733333333334,0.6287633333333333,0.6794233333333334,0.6630233333333333,0.65836,0
2787,270000,1,2,2,29,0,0,0,0,0,0,62516,48770,47846,39772,35143,44371,1854,1952,1418,5000,14000,2500,0,60662,46818,46428,34772,21143,41871,0.22467407407407408,0.1734,0.17195555555555556,0.1287851851851852,0.07830740740740741,0.1550777777777778,0
2788,20000,1,2,2,35,0,0,2,0,0,0,16528,19347,18600,19000,19000,20000,3400,0,1000,0,1000,0,0,13128,19347,17600,19000,18000,20000,0.6564,0.96735,0.88,0.95,0.9,1.0,2
2789,320000,0,1,1,58,-1,2,-1,0,0,-1,380,64,948,632,316,316,0,1200,0,0,316,316,1,380,-1136,948,632,0,0,0.0011875,-0.00355,0.0029625,0.001975,0.0,0.0,-1
2790,220000,0,1,2,24,0,0,0,-1,-1,-1,105607,108917,111520,8303,0,85632,5000,5050,8303,0,85632,0,0,100607,103867,103217,8303,-85632,85632,0.45730454545454546,0.47212272727272725,0.4691681818181818,0.03774090909090909,-0.38923636363636366,0.38923636363636366,-3
2791,220000,1,1,1,33,0,0,0,0,0,0,199040,182158,143895,147039,152384,159631,10032,7000,7500,10000,10000,7000,1,189008,175158,136395,137039,142384,152631,0.8591272727272727,0.7961727272727273,0.6199772727272728,0.6229045454545454,0.6472,0.6937772727272727,0
2792,90000,1,3,1,54,3,2,2,2,2,0,86228,85437,90635,91745,87466,85662,1500,7500,3500,0,3300,3500,1,84728,77937,87135,91745,84166,82162,0.9414222222222223,0.8659666666666667,0.9681666666666666,1.019388888888889,0.9351777777777778,0.9129111111111111,11
2793,500000,1,1,1,47,-2,-2,-2,-2,-2,-2,3634,296,966,6675,-10,2055,299,1169,6708,0,2065,1133,1,3335,-873,-5742,6675,-2075,922,0.00667,-0.001746,-0.011484,0.01335,-0.00415,0.001844,-12
2794,50000,0,2,1,40,1,2,0,0,0,0,49039,47949,49235,49577,17063,17634,0,2058,1400,762,1000,650,1,49039,45891,47835,48815,16063,16984,0.98078,0.91782,0.9567,0.9763,0.32126,0.33968,3
2795,150000,0,4,2,27,0,0,0,0,0,-2,133374,40283,49746,51500,0,0,10000,10000,2900,10000,0,0,0,123374,30283,46846,41500,0,0,0.8224933333333333,0.20188666666666666,0.3123066666666667,0.27666666666666667,0.0,0.0,-2
2796,340000,1,1,2,44,-2,-2,-2,-2,-2,-2,2732,2183,4103,12950,11372,2434,2183,4142,12950,11372,2434,2222,0,549,-1959,-8847,1578,8938,212,0.0016147058823529413,-0.0057617647058823525,-0.02602058823529412,0.004641176470588235,0.026288235294117647,0.0006235294117647059,-12
2797,20000,1,2,3,44,2,2,7,7,7,6,2400,2400,2400,2400,2400,1800,0,0,0,0,0,0,0,2400,2400,2400,2400,2400,1800,0.12,0.12,0.12,0.12,0.12,0.09,31
2798,180000,1,1,2,56,-2,-2,-2,-2,-2,-2,0,0,1829,-200,0,4208,0,1829,998,200,4208,0,0,0,-1829,831,-400,-4208,4208,0.0,-0.01016111111111111,0.0046166666666666665,-0.0022222222222222222,-0.02337777777777778,0.02337777777777778,-12
2799,200000,1,4,1,43,0,0,0,0,0,0,132823,132700,182868,166755,111450,53049,71998,116000,3771,2229,37609,40000,1,60825,16700,179097,164526,73841,13049,0.304125,0.0835,0.895485,0.82263,0.369205,0.065245,0
2800,360000,0,2,1,32,-1,-1,-1,0,0,-1,942,3670,33148,33829,16555,7090,3678,33148,1287,413,7127,1193,1,-2736,-29478,31861,33416,9428,5897,-0.0076,-0.08188333333333334,0.08850277777777778,0.09282222222222222,0.02618888888888889,0.016380555555555554,-4
2801,280000,1,1,1,57,-1,-1,-1,2,2,3,929,1669,5707,4795,5328,4969,1669,4795,0,4115,0,0,1,-740,-3126,5707,680,5328,4969,-0.002642857142857143,-0.011164285714285715,0.020382142857142856,0.0024285714285714284,0.01902857142857143,0.017746428571428573,4
2802,200000,0,3,1,40,0,0,0,0,0,0,187431,192558,196537,76167,76810,72039,8124,8339,5004,2961,2579,2761,1,179307,184219,191533,73206,74231,69278,0.896535,0.921095,0.957665,0.36603,0.371155,0.34639,0
2803,200000,0,2,1,55,0,0,0,0,0,2,184505,182475,180103,180647,76236,71415,8000,7512,8034,5600,0,2700,1,176505,174963,172069,175047,76236,68715,0.882525,0.874815,0.860345,0.875235,0.38118,0.343575,2
2804,150000,1,1,1,36,0,0,0,0,0,0,38298,39292,40357,41284,42105,43146,1635,1700,1600,1507,1719,2000,1,36663,37592,38757,39777,40386,41146,0.24442,0.25061333333333335,0.25838,0.26518,0.26924,0.27430666666666664,0
2805,300000,1,2,2,26,0,-1,-1,-1,0,0,11342,9670,2615,10170,7200,7200,9670,2615,10170,0,0,908,0,1672,7055,-7555,10170,7200,6292,0.005573333333333333,0.02351666666666667,-0.025183333333333332,0.0339,0.024,0.020973333333333333,-3
2806,450000,1,2,1,53,-2,-2,-2,-2,-2,-2,2542,2545,1158,1103,110,187,2557,1273,1109,0,187,2014,1,-15,1272,49,1103,-77,-1827,-3.3333333333333335e-05,0.0028266666666666666,0.00010888888888888889,0.002451111111111111,-0.0001711111111111111,-0.00406,-12
2807,200000,1,2,1,44,1,-2,-2,-2,-2,-2,0,0,0,0,0,0,0,0,0,0,0,0,1,0,0,0,0,0,0,0.0,0.0,0.0,0.0,0.0,0.0,-9
2808,200000,1,1,1,30,0,0,0,2,0,0,18660,27871,55277,38259,8266,13200,27010,30300,179,5415,10000,10000,1,-8350,-2429,55098,32844,-1734,3200,-0.04175,-0.012145,0.27549,0.16422,-0.00867,0.016,2
2809,50000,1,3,2,44,2,2,2,2,2,2,40985,42115,41164,43658,44644,43798,2100,0,3500,2000,0,2000,0,38885,42115,37664,41658,44644,41798,0.7777,0.8423,0.75328,0.83316,0.89288,0.83596,12
2810,120000,0,2,2,30,0,0,0,0,0,0,100802,104378,106651,108362,96168,99399,5200,5500,5000,5000,5000,5000,0,95602,98878,101651,103362,91168,94399,0.7966833333333333,0.8239833333333333,0.8470916666666667,0.86135,0.7597333333333334,0.7866583333333333,0
2811,360000,0,3,1,53,-1,-1,-1,-1,-1,-1,45421,68526,47416,48811,193712,80601,68536,47427,48846,193712,80601,11166,1,-23115,21099,-1430,-144901,113111,69435,-0.06420833333333334,0.05860833333333333,-0.0039722222222222225,-0.40250277777777776,0.31419722222222224,0.192875,-6
2812,100000,1,2,1,36,0,0,0,0,0,0,92688,94925,96865,99196,101000,0,3000,2746,3156,3000,0,0,1,89688,92179,93709,96196,101000,0,0.89688,0.92179,0.93709,0.96196,1.01,0.0,0
2813,70000,1,2,1,44,0,0,0,0,0,0,66301,68105,68287,28163,27220,28124,3500,3000,1500,1000,2000,2000,1,62801,65105,66787,27163,25220,26124,0.8971571428571429,0.9300714285714285,0.9541,0.38804285714285713,0.36028571428571426,0.3732,0
2814,80000,1,1,1,39,1,2,2,2,0,0,21340,22389,23017,22349,22791,23331,1700,1280,0,814,905,30331,1,19640,21109,23017,21535,21886,-7000,0.2455,0.2638625,0.2877125,0.2691875,0.273575,-0.0875,7
2815,80000,0,2,1,43,1,2,0,0,0,0,77871,71898,72926,73745,75675,75999,1261,3214,3000,3500,2266,3000,1,76610,68684,69926,70245,73409,72999,0.957625,0.85855,0.874075,0.8780625,0.9176125,0.9124875,3
2816,20000,1,2,1,46,1,2,0,0,0,0,13254,12749,13834,14894,15050,16251,0,1600,1600,700,1601,1620,1,13254,11149,12234,14194,13449,14631,0.6627,0.55745,0.6117,0.7097,0.67245,0.73155,3
2817,300000,1,2,2,26,-1,-1,-1,-1,-1,-1,1121,699,3131,5180,1780,0,699,3152,5180,1780,0,6200,0,422,-2453,-2049,3400,1780,-6200,0.0014066666666666667,-0.008176666666666667,-0.00683,0.011333333333333334,0.005933333333333333,-0.020666666666666667,-6
2818,360000,1,1,2,30,-1,-1,-1,-1,-1,-1,11193,332,272,1465,18503,5151,332,272,1465,18503,5151,0,0,10861,60,-1193,-17038,13352,5151,0.030169444444444443,0.00016666666666666666,-0.003313888888888889,-0.04732777777777778,0.037088888888888887,0.014308333333333333,-6
2819,50000,0,2,2,42,0,0,0,0,0,0,39236,39729,27068,28604,28199,58428,2094,1451,1987,1039,1500,1200,0,37142,38278,25081,27565,26699,57228,0.74284,0.76556,0.50162,0.5513,0.53398,1.14456,0
2820,120000,0,1,1,35,1,2,2,2,2,2,114127,117131,114496,120538,115975,116937,7000,1500,9975,0,8000,0,1,107127,115631,104521,120538,107975,116937,0.892725,0.9635916666666666,0.8710083333333334,1.0044833333333334,0.8997916666666667,0.974475,11
2821,300000,1,1,2,50,-2,-2,-2,-2,-2,-2,22443,31175,26476,27782,23325,49146,31175,26476,27782,23325,49146,13164,0,-8732,4699,-1306,4457,-25821,35982,-0.029106666666666666,0.015663333333333335,-0.004353333333333333,0.014856666666666667,-0.08607,0.11994,-12
2822,250000,0,1,1,51,3,2,2,2,2,2,2487,2487,2487,2487,2487,2487,0,0,0,0,0,0,1,2487,2487,2487,2487,2487,2487,0.009948,0.009948,0.009948,0.009948,0.009948,0.009948,13
2823,150000,1,3,1,29,0,0,0,0,0,0,149278,142117,144947,140696,143607,136575,3984,3825,3361,3469,3812,3020,1,145294,138292,141586,137227,139795,133555,0.9686266666666666,0.9219466666666667,0.9439066666666667,0.9148466666666667,0.9319666666666667,0.8903666666666666,0
2824,120000,0,2,2,32,0,0,0,0,0,0,113650,105592,105428,76543,144089,74115,3999,6025,3069,3001,6000,3112,0,109651,99567,102359,73542,138089,71003,0.9137583333333333,0.829725,0.8529916666666667,0.61285,1.1507416666666668,0.5916916666666666,0
2825,220000,1,1,2,27,0,0,0,0,0,0,164855,168607,152765,152953,156065,145846,6102,7000,6500,5573,7000,8000,0,158753,161607,146265,147380,149065,137846,0.7216045454545454,0.7345772727272727,0.6648409090909091,0.6699090909090909,0.6775681818181818,0.6265727272727273,0
2826,360000,0,2,1,49,1,-2,-1,-1,-2,-2,0,0,8209,-41,-41,-41,0,8209,0,0,0,0,1,0,-8209,8209,-41,-41,-41,0.0,-0.02280277777777778,0.02280277777777778,-0.00011388888888888889,-0.00011388888888888889,-0.00011388888888888889,-7
2827,140000,1,1,2,29,1,2,0,0,0,0,144922,141289,137377,93261,95368,97063,17,5547,3242,3512,3333,4383,0,144905,135742,134135,89749,92035,92680,1.0350357142857143,0.9695857142857143,0.9581071428571428,0.6410642857142858,0.6573928571428571,0.662,3
2828,260000,0,2,1,31,-1,2,-1,-1,-1,-1,7559,4860,1350,4645,4625,12209,0,1350,4645,4625,12209,4365,1,7559,3510,-3295,20,-7584,7844,0.029073076923076924,0.0135,-0.012673076923076922,7.692307692307693e-05,-0.02916923076923077,0.030169230769230768,-3
2829,120000,1,3,3,47,-1,0,0,-2,-2,-2,1576,3009,0,0,430,1520,1500,0,0,430,1520,730,0,76,3009,0,-430,-1090,790,0.0006333333333333333,0.025075,0.0,-0.0035833333333333333,-0.009083333333333334,0.006583333333333333,-7
2830,360000,0,1,2,30,-1,-1,-1,0,0,0,10821,5559,3272,13756,12852,20893,5586,3364,13132,10034,16104,14348,0,5235,2195,-9860,3722,-3252,6545,0.014541666666666666,0.006097222222222223,-0.02738888888888889,0.010338888888888889,-0.009033333333333334,0.018180555555555554,-3
2831,50000,0,3,2,31,0,0,0,0,0,0,49415,49547,15464,15701,12192,12515,1278,1195,432,443,526,291,0,48137,48352,15032,15258,11666,12224,0.96274,0.96704,0.30064,0.30516,0.23332,0.24448,0
2832,100000,1,2,1,26,0,0,0,2,0,0,95087,87380,87083,82653,72867,74140,3965,7138,0,2448,2674,2672,1,91122,80242,87083,80205,70193,71468,0.91122,0.80242,0.87083,0.80205,0.70193,0.71468,2
2833,360000,1,2,2,44,-1,-1,-1,-1,-1,-1,10311,2758,1397,298,7950,60097,2758,1397,298,7950,60097,1200,0,7553,1361,1099,-7652,-52147,58897,0.020980555555555554,0.0037805555555555557,0.003052777777777778,-0.021255555555555555,-0.14485277777777777,0.1636027777777778,-6
2834,280000,0,1,2,34,0,0,0,0,0,0,251267,258944,262562,164059,131807,180524,15000,10565,20253,20518,155067,11007,0,236267,248379,242309,143541,-23260,169517,0.8438107142857143,0.8870678571428572,0.8653892857142857,0.5126464285714286,-0.08307142857142857,0.6054178571428571,0
2835,150000,0,1,2,25,0,0,0,0,0,-1,52952,95134,31578,26089,16624,5107,60086,2000,2000,5000,6000,9000,0,-7134,93134,29578,21089,10624,-3893,-0.04756,0.6208933333333333,0.19718666666666668,0.14059333333333332,0.07082666666666666,-0.02595333333333333,-1
2836,200000,1,1,1,30,-2,-2,-2,-2,-2,-2,4833,6370,2342,810,9743,1000,6370,2342,810,10253,1000,7079,1,-1537,4028,1532,-9443,8743,-6079,-0.007685,0.02014,0.00766,-0.047215,0.043715,-0.030395,-12
2837,130000,1,1,2,27,0,0,0,0,0,0,128137,109868,108167,102584,91030,82634,4000,4019,4017,3100,4500,5380,0,124137,105849,104150,99484,86530,77254,0.9549,0.8142230769230769,0.8011538461538461,0.7652615384615384,0.6656153846153846,0.5942615384615385,0
2838,170000,1,2,2,27,2,0,0,0,0,0,173577,171480,171794,166637,169021,164531,6500,7100,6100,6000,5600,7700,0,167077,164380,165694,160637,163421,156831,0.9828058823529412,0.9669411764705882,0.9746705882352941,0.9449235294117647,0.9613,0.922535294117647,2
2839,20000,0,1,2,33,0,0,0,2,0,0,16117,17130,18655,17687,18023,18169,1285,2200,0,1000,1000,500,0,14832,14930,18655,16687,17023,17669,0.7416,0.7465,0.93275,0.83435,0.85115,0.88345,2
2840,20000,1,2,2,29,0,0,0,0,0,0,17648,13580,14204,15345,17764,20049,3000,5007,3000,3000,3000,3000,0,14648,8573,11204,12345,14764,17049,0.7324,0.42865,0.5602,0.61725,0.7382,0.85245,0
2841,290000,0,3,1,47,-1,-1,-1,-1,0,-1,1234,396,396,792,396,423,396,396,792,0,423,369,1,838,0,-396,792,-27,54,0.002889655172413793,0.0,-0.0013655172413793103,0.0027310344827586206,-9.310344827586207e-05,0.00018620689655172415,-5
2842,440000,1,1,1,54,0,0,0,0,0,0,293717,254498,169622,169140,152404,138447,9700,6323,5700,4800,4000,4500,1,284017,248175,163922,164340,148404,133947,0.6454931818181818,0.564034090909091,0.37255,0.3735,0.3372818181818182,0.304425,0
2843,30000,0,2,1,41,0,0,0,-2,-2,-2,29866,30900,0,0,0,0,1900,0,0,0,0,0,1,27966,30900,0,0,0,0,0.9322,1.03,0.0,0.0,0.0,0.0,-6
2844,280000,0,4,1,39,0,0,0,0,0,0,227604,218526,196479,196034,378323,192115,7670,7221,7091,8013,14923,7068,1,219934,211305,189388,188021,363400,185047,0.7854785714285715,0.7546607142857142,0.6763857142857143,0.6715035714285714,1.2978571428571428,0.6608821428571429,0
2845,230000,1,2,1,46,-1,-1,-1,-1,-1,-1,4328,1518,1958,368,1613,1371,1518,1972,368,1613,1371,752,1,2810,-454,1590,-1245,242,619,0.012217391304347826,-0.001973913043478261,0.00691304347826087,-0.0054130434782608695,0.0010521739130434783,0.0026913043478260868,-6
2846,150000,1,1,2,25,0,0,2,2,2,2,129911,140013,137279,143848,146986,149805,12200,1000,10400,5600,5400,5000,0,117711,139013,126879,138248,141586,144805,0.78474,0.9267533333333333,0.84586,0.9216533333333333,0.9439066666666667,0.9653666666666667,8
2847,200000,0,1,1,43,-1,-1,-1,-1,-1,-1,1144,2480,3372,1081,2384,6595,2506,3380,1085,2394,6601,29708,1,-1362,-900,2287,-1313,-4217,-23113,-0.00681,-0.0045,0.011435,-0.006565,-0.021085,-0.115565,-6
2848,110000,1,1,2,27,0,0,0,0,0,0,113461,112026,111792,111936,112030,111975,4251,4218,4167,4238,4181,4246,0,109210,107808,107625,107698,107849,107729,0.9928181818181818,0.9800727272727273,0.9784090909090909,0.9790727272727273,0.9804454545454545,0.9793545454545455,0
2849,100000,1,2,1,31,0,0,0,0,0,0,75818,76887,78178,79858,74785,54849,2745,2939,3500,3000,1989,1987,1,73073,73948,74678,76858,72796,52862,0.73073,0.73948,0.74678,0.76858,0.72796,0.52862,0
2850,170000,1,1,1,31,0,0,-2,-2,-2,-2,6832,0,0,0,0,0,0,0,0,0,0,0,1,6832,0,0,0,0,0,0.04018823529411765,0.0,0.0,0.0,0.0,0.0,-8
2851,150000,1,3,1,39,-1,-1,-1,0,-1,-1,5211,33474,18488,45489,9069,20203,33522,18516,35701,9099,20226,20786,1,-28311,14958,-17213,36390,-11157,-583,-0.18874,0.09972,-0.11475333333333333,0.2426,-0.07438,-0.0038866666666666667,-5
2852,210000,0,1,2,35,-1,-1,-1,-1,-1,-1,326,326,326,326,326,326,326,326,326,326,326,326,0,0,0,0,0,0,0,0.0,0.0,0.0,0.0,0.0,0.0,-6
2853,130000,0,3,2,56,0,0,0,0,0,0,33928,35356,36782,31309,32480,33953,2000,2000,2000,2000,2000,3000,0,31928,33356,34782,29309,30480,30953,0.2456,0.2565846153846154,0.26755384615384614,0.22545384615384614,0.23446153846153847,0.2381,0
2854,360000,0,1,1,40,0,0,2,-1,-1,-1,76584,85400,17295,8331,2643,6008,21358,86,8372,2656,6038,3325,1,55226,85314,8923,5675,-3395,2683,0.15340555555555555,0.23698333333333332,0.02478611111111111,0.01576388888888889,-0.009430555555555555,0.007452777777777778,-1
2855,450000,0,1,2,29,1,-2,-2,-2,-2,-2,1261,1261,1261,1261,1261,1261,1261,1261,1261,1261,1261,1261,0,0,0,0,0,0,0,0.0,0.0,0.0,0.0,0.0,0.0,-9
2856,80000,1,2,2,31,2,0,0,0,0,0,30911,28190,27045,22843,20578,19049,2009,1751,1500,1000,779,545,0,28902,26439,25545,21843,19799,18504,0.361275,0.3304875,0.3193125,0.2730375,0.2474875,0.2313,2
2857,50000,0,2,1,41,0,0,0,0,-1,0,50220,50756,49966,523,18450,18478,2055,1000,523,18868,806,968,1,48165,49756,49443,-18345,17644,17510,0.9633,0.99512,0.98886,-0.3669,0.35288,0.3502,-1
2858,180000,1,2,1,44,0,0,0,0,0,0,174830,178917,182777,171239,119060,121981,7000,6800,6800,4500,5000,5000,1,167830,172117,175977,166739,114060,116981,0.9323888888888889,0.9562055555555555,0.97765,0.9263277777777777,0.6336666666666667,0.6498944444444444,0
2859,60000,1,2,2,28,2,0,0,0,0,0,4114,5875,7612,8826,10113,11289,2000,2000,1500,1600,1500,1500,0,2114,3875,6112,7226,8613,9789,0.03523333333333333,0.06458333333333334,0.10186666666666666,0.12043333333333334,0.14355,0.16315,2
2860,250000,0,3,2,35,-1,-1,-1,-1,-1,-1,29363,4501,27548,1800,11942,4680,4501,27548,1800,11942,4680,0,0,24862,-23047,25748,-10142,7262,4680,0.099448,-0.092188,0.102992,-0.040568,0.029048,0.01872,-6
2861,200000,0,1,2,32,0,0,0,0,0,0,190530,194796,194205,195154,166778,167833,9000,9000,8000,6900,6000,6000,0,181530,185796,186205,188254,160778,161833,0.90765,0.92898,0.931025,0.94127,0.80389,0.809165,0
2862,210000,1,1,1,38,1,-2,-1,0,-1,-1,0,0,250,123,789,1222,0,250,0,789,1222,9616,1,0,-250,250,-666,-433,-8394,0.0,-0.0011904761904761906,0.0011904761904761906,-0.0031714285714285716,-0.0020619047619047618,-0.039971428571428574,-4
2863,260000,1,1,2,53,0,0,0,0,0,0,235073,235704,198181,143561,110982,72514,30000,10087,6030,5001,10002,148,0,205073,225617,192151,138560,100980,72366,0.7887423076923077,0.8677576923076923,0.7390423076923077,0.5329230769230769,0.3883846153846154,0.2783307692307692,0
2864,20000,0,3,2,48,0,0,0,0,2,0,5861,6728,7739,8339,8061,8221,1119,1130,730,0,294,305,0,4742,5598,7009,8339,7767,7916,0.2371,0.2799,0.35045,0.41695,0.38835,0.3958,2
2865,80000,0,2,2,34,0,0,0,0,0,0,73414,66122,92131,47655,43182,44332,3558,2600,4300,2000,2000,2000,0,69856,63522,87831,45655,41182,42332,0.8732,0.794025,1.0978875,0.5706875,0.514775,0.52915,0
2866,20000,0,2,2,26,1,2,2,0,0,2,8476,10187,9885,11398,12208,11869,2000,0,2000,1000,0,1200,0,6476,10187,7885,10398,12208,10669,0.3238,0.50935,0.39425,0.5199,0.6104,0.53345,7
2867,80000,0,1,2,25,-1,-1,-1,-1,-1,-1,390,390,390,390,390,390,390,390,390,390,390,390,0,0,0,0,0,0,0,0.0,0.0,0.0,0.0,0.0,0.0,-6
2868,90000,1,3,1,37,0,0,0,0,0,0,62460,63354,64528,65815,67350,68605,2500,2300,2281,2519,2451,2300,1,59960,61054,62247,63296,64899,66305,0.6662222222222223,0.6783777777777777,0.6916333333333333,0.7032888888888889,0.7211,0.7367222222222222,0
2869,270000,1,1,2,29,0,0,0,0,-1,-1,14728,20865,24812,12674,9486,2460,10000,5000,3900,9486,2460,0,0,4728,15865,20912,3188,7026,2460,0.017511111111111113,0.05875925925925926,0.07745185185185186,0.011807407407407407,0.02602222222222222,0.009111111111111111,-2
2870,30000,1,3,2,22,0,0,0,0,0,0,30136,20741,21906,23183,13273,3027,1335,1500,1700,750,200,200,0,28801,19241,20206,22433,13073,2827,0.9600333333333333,0.6413666666666666,0.6735333333333333,0.7477666666666667,0.4357666666666667,0.09423333333333334,0
2871,230000,1,1,1,49,-2,-2,-2,-2,-2,-2,1034,299,8994,1796,3970,7214,299,8997,1808,3970,7214,3684,1,735,-8698,7186,-2174,-3244,3530,0.0031956521739130435,-0.037817391304347824,0.031243478260869564,-0.009452173913043479,-0.014104347826086957,0.015347826086956522,-12
2872,480000,0,1,1,47,-1,-1,-1,-1,0,0,10668,-2,454,150198,143388,157758,0,456,150244,2915,24550,100,1,10668,-458,-149790,147283,118838,157658,0.022225,-0.0009541666666666666,-0.3120625,0.30683958333333333,0.24757916666666666,0.32845416666666666,-4
2873,360000,1,2,2,43,-2,-2,-2,-2,-2,-2,0,0,0,0,0,0,0,0,0,0,0,84216,0,0,0,0,0,0,-84216,0.0,0.0,0.0,0.0,0.0,-0.23393333333333333,-12
2874,280000,0,3,1,49,-1,-1,-1,-1,-1,-1,4792,3410,2295,3105,582,14013,3410,2295,3105,582,14013,4240,1,1382,1115,-810,2523,-13431,9773,0.0049357142857142855,0.003982142857142857,-0.0028928571428571428,0.009010714285714285,-0.047967857142857145,0.03490357142857143,-6
2875,180000,0,1,2,28,0,0,0,0,0,0,26730,27757,28178,29055,59849,29840,1800,1500,2000,1400,1100,1400,0,24930,26257,26178,27655,58749,28440,0.1385,0.1458722222222222,0.14543333333333333,0.15363888888888888,0.32638333333333336,0.158,0
2876,90000,1,2,2,26,0,0,0,0,0,0,92472,92518,91504,91706,91801,91753,4600,4100,3900,4000,3700,3700,0,87872,88418,87604,87706,88101,88053,0.9763555555555555,0.9824222222222222,0.9733777777777778,0.9745111111111111,0.9789,0.9783666666666667,0
2877,80000,0,1,1,46,0,0,0,0,0,0,48967,49850,50767,45721,49006,56275,2000,1771,1715,4000,8697,0,1,46967,48079,49052,41721,40309,56275,0.5870875,0.6009875,0.61315,0.5215125,0.5038625,0.7034375,0
2878,30000,1,3,1,53,0,0,0,0,-1,0,30587,29462,28068,23362,29837,30357,1700,1288,982,32000,2000,1436,1,28887,28174,27086,-8638,27837,28921,0.9629,0.9391333333333334,0.9028666666666667,-0.2879333333333333,0.9279,0.9640333333333333,-1
2879,220000,0,1,1,39,0,0,0,0,0,0,96473,97887,94776,72842,46747,44236,10000,4000,5063,2000,1605,1697,1,86473,93887,89713,70842,45142,42539,0.3930590909090909,0.4267590909090909,0.4077863636363636,0.3220090909090909,0.2051909090909091,0.1933590909090909,0
2880,150000,1,1,2,29,0,0,0,0,0,0,94062,65825,64041,60948,51510,46917,3183,3023,2549,2000,2000,2000,0,90879,62802,61492,58948,49510,44917,0.60586,0.41868,0.4099466666666667,0.39298666666666665,0.3300666666666667,0.2994466666666667,0
2881,30000,0,2,2,34,0,0,4,3,2,0,19785,24633,23961,23289,22779,51224,5500,0,0,0,3400,512,0,14285,24633,23961,23289,19379,50712,0.4761666666666667,0.8211,0.7987,0.7763,0.6459666666666667,1.6904,9
2882,170000,0,2,1,35,-1,-1,-1,0,0,-1,3995,6300,15291,9085,5801,6603,6380,15291,182,116,6603,4000,1,-2385,-8991,15109,8969,-802,2603,-0.014029411764705882,-0.052888235294117646,0.08887647058823529,0.05275882352941177,-0.0047176470588235295,0.015311764705882353,-4
2883,160000,0,3,2,52,0,0,0,0,0,0,155684,157364,156581,72814,66825,63419,6525,6649,2724,2503,2310,2200,0,149159,150715,153857,70311,64515,61219,0.93224375,0.94196875,0.96160625,0.43944375,0.40321875,0.38261875,0
2884,50000,0,2,2,39,0,0,0,0,-1,-1,48803,48808,20131,19940,390,540,1487,1200,399,390,540,390,0,47316,47608,19732,19550,-150,150,0.94632,0.95216,0.39464,0.391,-0.003,0.003,-2
2885,100000,1,2,2,24,3,2,2,2,2,2,85016,86918,88624,89576,90614,89046,4200,4000,3300,3400,0,7000,0,80816,82918,85324,86176,90614,82046,0.80816,0.82918,0.85324,0.86176,0.90614,0.82046,13
2886,70000,1,1,1,35,4,4,3,2,0,0,77021,73268,70275,46045,42357,41026,0,2001,0,1666,1505,2079,1,77021,71267,70275,44379,40852,38947,1.1003,1.0181,1.0039285714285715,0.6339857142857143,0.5836,0.5563857142857143,13
2887,200000,1,1,2,44,0,0,0,0,0,0,203045,140347,139282,138462,134497,126617,4501,4916,4505,4205,4145,3100,0,198544,135431,134777,134257,130352,123517,0.99272,0.677155,0.673885,0.671285,0.65176,0.617585,0
2888,50000,0,2,1,38,0,0,0,0,0,0,48797,47153,43238,17253,16307,16651,1864,1811,594,587,1000,1000,1,46933,45342,42644,16666,15307,15651,0.93866,0.90684,0.85288,0.33332,0.30614,0.31302,0
2889,200000,1,2,1,60,-1,-1,-1,-1,-1,-1,396,396,461,396,546,396,396,461,396,546,396,396,1,0,-65,65,-150,150,0,0.0,-0.000325,0.000325,-0.00075,0.00075,0.0,-6
2890,340000,1,3,1,49,-2,-1,-1,-1,-2,-2,20452,18816,24010,5320,16612,21373,18832,24099,5320,16612,21373,44729,1,1620,-5283,18690,-11292,-4761,-23356,0.004764705882352941,-0.015538235294117648,0.05497058823529412,-0.03321176470588235,-0.014002941176470588,-0.06869411764705882,-9
2891,20000,0,3,2,26,2,2,-1,-1,2,0,20155,10356,556,20897,20438,20325,0,600,20900,1,805,752,0,20155,9756,-20344,20896,19633,19573,1.00775,0.4878,-1.0172,1.0448,0.98165,0.97865,4
2892,30000,0,2,2,36,-1,-1,2,-1,-1,-1,3024,3462,390,240,2150,780,3462,0,240,2300,780,0,0,-438,3462,150,-2060,1370,780,-0.0146,0.1154,0.005,-0.06866666666666667,0.04566666666666667,0.026,-3
2893,160000,0,1,1,47,1,2,2,2,2,3,58706,57384,59875,61518,65152,64074,0,3200,3000,5000,0,3000,1,58706,54184,56875,56518,65152,61074,0.3669125,0.33865,0.35546875,0.3532375,0.4072,0.3817125,12
2894,50000,0,1,2,30,0,0,2,2,2,2,44572,48361,47192,50588,40009,43685,4500,0,4000,0,5000,0,0,40072,48361,43192,50588,35009,43685,0.80144,0.96722,0.86384,1.01176,0.70018,0.8737,8
2895,200000,1,3,2,49,-1,-1,-1,-1,-1,-1,1801,181,4095,5711,21420,6719,181,4126,5711,21520,6719,150,0,1620,-3945,-1616,-15809,14701,6569,0.0081,-0.019725,-0.00808,-0.079045,0.073505,0.032845,-6
2896,150000,1,2,2,34,0,0,0,0,0,0,39883,34983,23772,20410,14818,7565,2068,1331,1029,353,208,20711,0,37815,33652,22743,20057,14610,-13146,0.2521,0.22434666666666667,0.15162,0.13371333333333332,0.0974,-0.08764,0
2897,20000,0,2,2,25,2,2,3,3,3,3,1050,1050,1050,1050,1050,1050,0,0,0,0,0,0,0,1050,1050,1050,1050,1050,1050,0.0525,0.0525,0.0525,0.0525,0.0525,0.0525,16
2898,160000,1,2,1,50,-2,-2,-2,-2,-2,-2,3440,3208,3315,2645,1049,1469,3219,3322,2645,1049,1469,3490,1,221,-114,670,1596,-420,-2021,0.00138125,-0.0007125,0.0041875,0.009975,-0.002625,-0.01263125,-12
2899,320000,0,1,1,39,-1,-1,0,-1,-1,-1,8374,17634,38000,1140,997,1633,17634,21000,1140,997,1633,0,1,-9260,-3366,36860,143,-636,1633,-0.0289375,-0.01051875,0.1151875,0.000446875,-0.0019875,0.005103125,-5
2900,300000,0,2,1,39,-1,-1,-2,-2,-2,-2,29997,592,1049,-25,-25,-25,598,1057,0,0,0,0,1,29399,-465,1049,-25,-25,-25,0.09799666666666666,-0.00155,0.0034966666666666666,-8.333333333333333e-05,-8.333333333333333e-05,-8.333333333333333e-05,-10
2901,100000,1,1,1,30,0,0,0,0,0,-1,43717,29954,24551,16333,9776,58408,3000,2500,2000,1000,58408,5800,1,40717,27454,22551,15333,-48632,52608,0.40717,0.27454,0.22551,0.15333,-0.48632,0.52608,-1
2902,50000,1,1,2,24,0,0,0,0,0,0,43219,35137,25862,12468,12381,12683,2400,1900,2400,250,500,0,0,40819,33237,23462,12218,11881,12683,0.81638,0.66474,0.46924,0.24436,0.23762,0.25366,0
2903,240000,1,3,2,31,-1,-1,-2,-2,-2,-2,298,0,0,0,0,0,0,0,0,0,0,0,0,298,0,0,0,0,0,0.0012416666666666667,0.0,0.0,0.0,0.0,0.0,-10
2904,90000,1,2,2,23,0,0,0,-2,-1,0,28120,32429,0,0,2522,2575,5000,0,0,2522,94,111,0,23120,32429,0,-2522,2428,2464,0.2568888888888889,0.3603222222222222,0.0,-0.028022222222222223,0.026977777777777778,0.02737777777777778,-3
2905,30000,0,2,2,25,0,0,2,0,0,2,7527,9705,9009,9333,9505,8699,2700,0,1000,700,0,784,0,4827,9705,8009,8633,9505,7915,0.1609,0.3235,0.2669666666666667,0.28776666666666667,0.31683333333333336,0.2638333333333333,4
2906,150000,0,1,2,30,-2,-2,-2,-2,-2,-2,989,1023,7542,1200,0,0,1023,7542,1200,0,0,689,0,-34,-6519,6342,1200,0,-689,-0.00022666666666666666,-0.04346,0.04228,0.008,0.0,-0.004593333333333333,-12
2907,310000,1,1,2,27,1,-1,-1,-2,-1,-1,0,113,0,0,6960,6008,113,200,0,6960,6008,0,0,-113,-87,0,-6960,952,6008,-0.0003645161290322581,-0.00028064516129032256,0.0,-0.022451612903225806,0.003070967741935484,0.019380645161290323,-5
2908,360000,1,1,1,44,1,-2,-2,-2,-2,-2,0,0,0,0,0,0,0,0,0,0,0,0,1,0,0,0,0,0,0,0.0,0.0,0.0,0.0,0.0,0.0,-9
2909,80000,0,2,1,46,0,-1,-1,2,-1,0,31290,780,390,780,780,390,780,390,0,1560,0,390,1,30510,390,390,-780,780,0,0.381375,0.004875,0.004875,-0.00975,0.00975,0.0,-1
2910,480000,0,1,1,37,0,0,0,0,0,2,470317,469673,450172,371819,390178,383822,18507,19307,13534,28001,14,11568,1,451810,450366,436638,343818,390164,372254,0.9412708333333333,0.9382625,0.9096625,0.7162875,0.8128416666666667,0.7755291666666667,2
2911,250000,0,2,1,34,-1,-1,-1,-1,-1,0,6461,8117,2200,3772,8650,17650,8117,2200,3772,8650,10000,4646,1,-1656,5917,-1572,-4878,-1350,13004,-0.006624,0.023668,-0.006288,-0.019512,-0.0054,0.052016,-5
2912,230000,1,2,1,30,-1,-1,-1,0,-1,-1,3686,5557,5816,1288,23196,15072,5619,5838,7,23312,15147,16518,1,-1933,-281,5809,-22024,8049,-1446,-0.008404347826086957,-0.0012217391304347827,0.025256521739130434,-0.09575652173913043,0.034995652173913046,-0.006286956521739131,-5
2913,240000,0,1,2,28,-1,-1,-1,-1,-1,-1,326,326,326,5676,476,326,326,326,5676,476,326,526,0,0,0,-5350,5200,150,-200,0.0,0.0,-0.022291666666666668,0.021666666666666667,0.000625,-0.0008333333333333334,-6
2914,480000,1,2,2,38,-2,-2,-1,0,0,0,5619,7600,123988,177054,273429,293157,7600,123988,60000,100000,24250,12735,0,-1981,-116388,63988,77054,249179,280422,-0.004127083333333333,-0.242475,0.13330833333333333,0.16052916666666667,0.5191229166666667,0.5842125,-5
2915,240000,0,1,2,28,0,0,0,0,0,0,181569,182916,186885,187756,188520,189908,6606,8246,6806,5112,5291,6004,0,174963,174670,180079,182644,183229,183904,0.7290125,0.7277916666666666,0.7503291666666667,0.7610166666666667,0.7634541666666667,0.7662666666666667,0
2916,120000,1,2,2,27,2,0,0,0,0,0,51244,51819,53375,54620,56170,57240,2000,2000,1700,2000,1700,1656,0,49244,49819,51675,52620,54470,55584,0.41036666666666666,0.41515833333333335,0.430625,0.4385,0.4539166666666667,0.4632,2
2917,240000,0,2,2,31,1,-1,-1,-1,-1,-1,0,780,0,390,780,0,780,0,390,780,0,390,0,-780,780,-390,-390,780,-390,-0.00325,0.00325,-0.001625,-0.001625,0.00325,-0.001625,-4
2918,340000,1,2,1,40,0,0,0,0,0,0,244451,230907,228760,229404,161551,164936,10000,10000,7100,5800,5915,6100,1,234451,220907,221660,223604,155636,158836,0.6895617647058824,0.6497264705882353,0.6519411764705882,0.6576588235294117,0.4577529411764706,0.4671647058823529,0
2919,180000,0,2,2,39,0,0,2,0,0,0,29478,32342,31523,32989,33679,34350,3353,0,2000,1222,1231,2704,0,26125,32342,29523,31767,32448,31646,0.1451388888888889,0.17967777777777777,0.16401666666666667,0.17648333333333333,0.18026666666666666,0.1758111111111111,2
2920,150000,1,2,2,30,0,0,0,0,0,0,106911,105889,96548,87085,52323,51260,4000,4500,5000,2000,1700,2300,0,102911,101389,91548,85085,50623,48960,0.6860733333333333,0.6759266666666667,0.61032,0.5672333333333334,0.33748666666666666,0.3264,0
2921,160000,0,1,2,32,-1,-1,-1,-1,0,0,2507,798,-2,2319,1523,-2,800,0,2321,4,0,801,0,1707,798,-2323,2315,1523,-803,0.01066875,0.0049875,-0.01451875,0.01446875,0.00951875,-0.00501875,-4
2922,300000,1,1,1,39,-1,-1,-1,-2,-1,-1,1134,611,0,0,706,0,613,0,0,706,0,0,1,521,611,0,-706,706,0,0.0017366666666666667,0.0020366666666666667,0.0,-0.002353333333333333,0.002353333333333333,0.0,-7
2923,150000,1,1,2,29,2,0,0,0,0,0,46224,34993,31434,26518,21042,16540,1600,1718,1049,1500,2000,5000,0,44624,33275,30385,25018,19042,11540,0.29749333333333333,0.22183333333333333,0.20256666666666667,0.16678666666666667,0.12694666666666668,0.07693333333333334,2
2924,230000,1,2,2,28,0,0,0,0,0,-1,29500,4828,7633,9202,2553,6015,4800,7021,8008,0,6015,3053,0,24700,-2193,-375,9202,-3462,2962,0.10739130434782608,-0.009534782608695652,-0.0016304347826086956,0.040008695652173916,-0.015052173913043478,0.012878260869565217,-1
2925,90000,0,1,2,29,0,0,0,0,0,0,72774,67584,57985,56268,55970,56825,2900,2700,2200,2100,2200,2200,0,69874,64884,55785,54168,53770,54625,0.7763777777777778,0.7209333333333333,0.6198333333333333,0.6018666666666667,0.5974444444444444,0.6069444444444444,0
2926,10000,0,2,2,21,0,0,0,0,0,0,9042,10038,9784,9984,9780,0,1305,1000,200,196,0,0,0,7737,9038,9584,9788,9780,0,0.7737,0.9038,0.9584,0.9788,0.978,0.0,0
2927,70000,1,3,1,35,3,2,2,2,0,0,69852,67531,28650,27590,27850,28085,0,2708,0,1010,1013,2000,1,69852,64823,28650,26580,26837,26085,0.9978857142857143,0.9260428571428572,0.4092857142857143,0.3797142857142857,0.3833857142857143,0.37264285714285716,9
2928,30000,1,2,1,37,3,3,3,2,0,0,27672,28911,29163,28380,28636,30290,2000,1000,0,1000,2100,1500,1,25672,27911,29163,27380,26536,28790,0.8557333333333333,0.9303666666666667,0.9721,0.9126666666666666,0.8845333333333333,0.9596666666666667,11
2929,150000,0,1,2,37,2,2,2,2,2,2,36148,36858,35985,38687,37765,40352,1600,0,3300,0,3200,1700,0,34548,36858,32685,38687,34565,38652,0.23032,0.24572,0.2179,0.25791333333333333,0.23043333333333332,0.25768,12
2930,120000,1,1,2,29,0,0,0,0,0,-2,59538,50150,44742,33231,-1320,-660,4000,5069,2805,0,0,1616,0,55538,45081,41937,33231,-1320,-2276,0.46281666666666665,0.375675,0.349475,0.276925,-0.011,-0.018966666666666666,-2
2931,100000,1,1,2,26,1,-1,-1,-1,-1,-1,0,632,0,316,632,0,632,0,316,632,0,316,0,-632,632,-316,-316,632,-316,-0.00632,0.00632,-0.00316,-0.00316,0.00632,-0.00316,-4
2932,200000,1,1,1,38,2,-1,2,2,-2,-1,166,1694,1519,0,0,600,1694,0,0,0,600,0,1,-1528,1694,1519,0,-600,600,-0.00764,0.00847,0.007595,0.0,-0.003,0.003,2
2933,60000,1,2,1,32,0,0,0,0,0,0,59738,59389,57656,58290,58213,57076,2700,2100,2100,2200,2100,3000,1,57038,57289,55556,56090,56113,54076,0.9506333333333333,0.9548166666666666,0.9259333333333334,0.9348333333333333,0.9352166666666667,0.9012666666666667,0
2934,50000,0,1,1,28,0,0,-2,-2,-2,-2,4545,0,0,0,0,0,0,0,0,0,0,0,1,4545,0,0,0,0,0,0.0909,0.0,0.0,0.0,0.0,0.0,-8
2935,140000,1,2,1,30,0,0,0,0,0,2,106526,85019,82784,81458,86227,84646,4000,3000,4000,7000,0,4000,1,102526,82019,78784,74458,86227,80646,0.7323285714285714,0.58585,0.5627428571428571,0.5318428571428572,0.6159071428571429,0.5760428571428572,2
2936,130000,0,2,3,34,2,2,2,0,0,0,126749,135867,132249,132416,131959,128375,11243,0,5600,5150,5100,4512,0,115506,135867,126649,127266,126859,123863,0.8885076923076923,1.0451307692307692,0.974223076923077,0.9789692307692308,0.9758384615384615,0.9527923076923077,6
2937,80000,1,2,2,29,0,0,0,0,0,0,89061,31367,34848,69990,36711,38103,4000,4000,2000,4000,2000,2000,0,85061,27367,32848,65990,34711,36103,1.0632625,0.3420875,0.4106,0.824875,0.4338875,0.4512875,0
2938,400000,0,2,1,45,0,0,2,0,0,2,337135,373869,366338,374255,409777,527566,44000,0,14000,42000,126000,18000,1,293135,373869,352338,332255,283777,509566,0.7328375,0.9346725,0.880845,0.8306375,0.7094425,1.273915,4
2939,440000,1,1,2,51,0,-1,-1,-2,-1,0,26106,8999,0,0,10961,11349,8999,0,0,10961,503,448,0,17107,8999,0,-10961,10458,10901,0.03887954545454545,0.02045227272727273,0.0,-0.024911363636363638,0.023768181818181817,0.024775,-5
2940,620000,1,1,2,31,0,0,0,0,0,0,569023,562316,475333,473182,481896,513798,23009,20004,20008,14000,35804,250005,0,546014,542312,455325,459182,446092,263793,0.8806677419354839,0.8746967741935484,0.7343951612903226,0.740616129032258,0.7195032258064517,0.4254725806451613,0
2941,260000,1,1,2,32,-2,-2,-2,-2,-2,-2,-34,6846,1479,173,6326,369,6880,1486,174,6357,370,2500,0,-6914,5360,1305,-6184,5956,-2131,-0.026592307692307693,0.020615384615384615,0.005019230769230769,-0.023784615384615383,0.022907692307692306,-0.008196153846153846,-12
2942,90000,0,3,1,42,2,2,2,3,3,3,48674,49895,52570,53614,54534,53374,2300,4116,2500,2052,0,0,1,46374,45779,50070,51562,54534,53374,0.5152666666666667,0.5086555555555555,0.5563333333333333,0.5729111111111111,0.6059333333333333,0.5930444444444445,15
2943,140000,0,3,1,56,0,0,0,0,0,0,7272,7906,8717,9046,9369,10165,1299,1500,1000,1000,1500,1000,1,5973,6406,7717,8046,7869,9165,0.04266428571428572,0.04575714285714286,0.05512142857142857,0.05747142857142857,0.05620714285714286,0.06546428571428571,0
2944,170000,0,3,1,31,0,0,0,0,0,0,3062,112762,112880,111210,111525,112360,112000,6000,4500,4500,5000,4500,1,-108938,106762,108380,106710,106525,107860,-0.6408117647058823,0.6280117647058824,0.6375294117647059,0.6277058823529412,0.6266176470588235,0.6344705882352941,0
2945,290000,1,2,1,42,-2,-1,-1,-1,0,0,-132,18364,2417,4583,1402,3227,18496,2429,4598,7,3227,1,1,-18628,15935,-2181,4576,-1825,3226,-0.06423448275862069,0.05494827586206896,-0.007520689655172413,0.015779310344827588,-0.006293103448275862,0.011124137931034483,-5
2946,240000,0,3,1,43,0,0,0,0,0,0,191453,193548,190288,186770,180458,178722,8500,8300,7000,7000,7000,6500,1,182953,185248,183288,179770,173458,172222,0.7623041666666667,0.7718666666666667,0.7637,0.7490416666666667,0.7227416666666666,0.7175916666666666,0
2947,260000,1,2,1,43,-1,-1,-1,-2,-1,-1,684,1726,0,0,5055,5996,1742,0,0,5055,5996,5648,1,-1058,1726,0,-5055,-941,348,-0.004069230769230769,0.006638461538461538,0.0,-0.019442307692307693,-0.003619230769230769,0.0013384615384615384,-7
2948,280000,1,1,1,34,-1,0,0,0,0,0,11584,12211,10247,10247,6170,11170,7011,3000,0,123,5000,0,1,4573,9211,10247,10124,1170,11170,0.016332142857142858,0.03289642857142857,0.03659642857142857,0.03615714285714286,0.004178571428571428,0.03989285714285714,-1
2949,180000,1,1,2,33,-2,-2,-1,-1,-1,-1,4500,2580,178,1500,0,1118,2580,178,1500,0,1118,1331,0,1920,2402,-1322,1500,-1118,-213,0.010666666666666666,0.013344444444444445,-0.007344444444444444,0.008333333333333333,-0.006211111111111111,-0.0011833333333333333,-8
2950,20000,0,2,2,24,0,0,0,0,0,2,15110,16548,17443,16216,18027,12364,2000,1500,1500,2000,0,1000,0,13110,15048,15943,14216,18027,11364,0.6555,0.7524,0.79715,0.7108,0.90135,0.5682,2
2951,50000,1,1,2,27,1,-1,-1,-1,0,0,0,45000,1000,4874,5374,5874,45000,1000,4874,500,500,0,0,-45000,44000,-3874,4374,4874,5874,-0.9,0.88,-0.07748,0.08748,0.09748,0.11748,-2
2952,180000,0,1,2,33,0,0,2,0,0,0,33331,35311,31648,23461,20671,17122,5317,23,208,10,51,0,0,28014,35288,31440,23451,20620,17122,0.15563333333333335,0.19604444444444444,0.17466666666666666,0.13028333333333333,0.11455555555555555,0.09512222222222222,2
2953,50000,0,2,2,31,0,0,2,0,0,0,23051,18190,12521,14308,14769,15925,2719,0,2000,1000,1542,764,0,20332,18190,10521,13308,13227,15161,0.40664,0.3638,0.21042,0.26616,0.26454,0.30322,2
2954,50000,1,2,1,41,1,2,2,2,2,2,24540,25330,26620,26889,26158,27737,1500,2000,1000,0,2000,0,1,23040,23330,25620,26889,24158,27737,0.4608,0.4666,0.5124,0.53778,0.48316,0.55474,11
2955,210000,1,2,2,26,-1,-1,-1,-1,-1,-1,4341,402,11305,1368,2684,1397,402,11401,1368,2684,1397,0,0,3939,-10999,9937,-1316,1287,1397,0.018757142857142858,-0.05237619047619048,0.04731904761904762,-0.006266666666666667,0.0061285714285714285,0.006652380952380952,-6
2956,20000,0,3,2,24,1,3,2,0,0,3,14665,14146,13634,14401,16257,15713,0,0,1300,2101,0,0,0,14665,14146,12334,12300,16257,15713,0.73325,0.7073,0.6167,0.615,0.81285,0.78565,9
2957,80000,1,1,2,29,1,-1,-1,-1,-1,-1,0,416,832,28940,832,0,416,832,28940,832,0,416,0,-416,-416,-28108,28108,832,-416,-0.0052,-0.0052,-0.35135,0.35135,0.0104,-0.0052,-4
2958,150000,0,2,1,36,2,0,0,0,0,0,86333,88931,92441,102903,105240,109479,4000,5000,12000,4000,6000,50000,1,82333,83931,80441,98903,99240,59479,0.5488866666666666,0.55954,0.5362733333333334,0.6593533333333333,0.6616,0.3965266666666667,2
2959,300000,1,3,1,46,0,0,0,-1,0,0,147289,150201,-3699,4142,1700,0,10000,0,10005,0,0,0,1,137289,150201,-13704,4142,1700,0,0.45763,0.50067,-0.04568,0.013806666666666667,0.005666666666666667,0.0,-1
2960,340000,1,2,2,33,0,0,0,0,0,0,336190,301626,306575,311784,318320,325028,10300,10302,10365,10750,11150,11271,0,325890,291324,296210,301034,307170,313757,0.9585,0.856835294117647,0.8712058823529412,0.8853941176470588,0.9034411764705882,0.9228147058823529,0
2961,360000,1,1,1,48,-1,-1,-2,-1,-1,-1,485,-15,-15,12588,1243,-6,0,0,12603,1250,0,420,1,485,-15,-12618,11338,1243,-426,0.0013472222222222223,-4.1666666666666665e-05,-0.03505,0.03149444444444444,0.0034527777777777777,-0.0011833333333333333,-7
2962,180000,1,1,2,32,1,-2,-2,-1,-1,-2,-10,-10,-10,5650,-10,-10,0,0,5660,0,0,0,0,-10,-10,-5670,5650,-10,-10,-5.555555555555556e-05,-5.555555555555556e-05,-0.0315,0.03138888888888889,-5.555555555555556e-05,-5.555555555555556e-05,-7
2963,270000,1,3,1,55,-2,-1,-1,-1,-1,-1,2039,7918,4246,4875,836,5949,7922,4246,4875,836,5949,1258,1,-5883,3672,-629,4039,-5113,4691,-0.02178888888888889,0.0136,-0.00232962962962963,0.014959259259259259,-0.018937037037037037,0.017374074074074073,-7
2964,270000,1,2,1,30,0,0,0,0,0,0,62599,59368,57856,49804,47310,42812,5000,5000,5000,5000,5240,5000,1,57599,54368,52856,44804,42070,37812,0.21332962962962962,0.20136296296296297,0.19576296296296297,0.16594074074074075,0.15581481481481482,0.14004444444444444,0
2965,230000,1,2,1,42,-2,-2,-2,-2,-2,-2,390,390,390,390,1240,4234,390,390,390,1240,4234,2970,1,0,0,0,-850,-2994,1264,0.0,0.0,0.0,-0.0036956521739130435,-0.013017391304347826,0.005495652173913044,-12
2966,90000,0,2,1,30,1,2,0,0,0,2,45271,44247,45287,46332,49715,48788,0,2055,2100,4476,0,3800,1,45271,42192,43187,41856,49715,44988,0.5030111111111111,0.4688,0.47985555555555554,0.4650666666666667,0.5523888888888889,0.4998666666666667,5
2967,100000,1,3,2,24,0,0,0,0,0,2,54938,55621,56999,57748,62489,60984,1985,2664,2700,6700,0,2389,0,52953,52957,54299,51048,62489,58595,0.52953,0.52957,0.54299,0.51048,0.62489,0.58595,2
2968,100000,1,2,1,41,1,3,2,2,2,2,51345,50249,51421,52684,51400,0,0,2300,2400,0,0,0,1,51345,47949,49021,52684,51400,0,0.51345,0.47949,0.49021,0.52684,0.514,0.0,12
2969,280000,0,1,2,31,-1,-1,-2,-1,-1,-1,2158,-2,-2,5823,2900,42128,0,0,5825,2915,42338,2419,0,2158,-2,-5827,2908,-39438,39709,0.007707142857142857,-7.142857142857143e-06,-0.020810714285714287,0.010385714285714286,-0.14085,0.14181785714285713,-7
2970,260000,1,2,2,26,-1,-1,-2,-2,-2,-2,28,-288,-604,-920,-1236,-1552,288,1236,316,316,316,316,0,-260,-1524,-920,-1236,-1552,-1868,-0.001,-0.005861538461538461,-0.0035384615384615385,-0.004753846153846154,-0.005969230769230769,-0.007184615384615385,-10
2971,110000,0,2,1,39,0,0,0,0,0,0,49464,40359,34533,36819,32467,35806,3007,3000,3000,3000,4000,3000,1,46457,37359,31533,33819,28467,32806,0.4223363636363636,0.3396272727272727,0.28666363636363634,0.3074454545454545,0.25879090909090907,0.29823636363636363,0
2972,110000,1,2,1,40,0,0,0,0,0,0,93466,87748,109517,107403,81794,78463,4438,76000,5000,4000,3000,5000,1,89028,11748,104517,103403,78794,73463,0.8093454545454546,0.1068,0.9501545454545455,0.9400272727272727,0.7163090909090909,0.6678454545454545,0
2973,160000,1,3,1,42,-2,-2,-2,-2,-1,0,0,1473,1863,0,112978,115357,1473,1863,0,119001,5000,4500,1,-1473,-390,1863,-119001,107978,110857,-0.00920625,-0.0024375,0.01164375,-0.74375625,0.6748625,0.69285625,-9
2974,20000,1,3,1,54,1,2,2,2,0,0,7189,6925,8402,9111,9802,10508,0,1600,1000,1000,866,0,1,7189,5325,7402,8111,8936,10508,0.35945,0.26625,0.3701,0.40555,0.4468,0.5254,7
2975,220000,0,1,2,28,0,0,0,0,0,0,22399,24203,24081,25356,20952,18340,3000,2000,2000,1000,1200,900,0,19399,22203,22081,24356,19752,17440,0.08817727272727273,0.10092272727272728,0.10036818181818181,0.11070909090909091,0.08978181818181818,0.07927272727272727,0
2976,80000,1,3,1,47,0,0,0,0,0,0,33590,34524,34038,33231,33440,5513,2079,1200,0,816,365,5000,1,31511,33324,34038,32415,33075,513,0.3938875,0.41655,0.425475,0.4051875,0.4134375,0.0064125,0
2977,400000,1,3,1,42,-1,-1,-1,-1,-1,-1,10132,16932,13088,28540,11860,3978,16932,13088,28540,11860,3978,2390,1,-6800,3844,-15452,16680,7882,1588,-0.017,0.00961,-0.03863,0.0417,0.019705,0.00397,-6
2978,240000,1,2,1,32,0,0,-2,-2,-2,-2,12000,0,0,0,0,0,0,0,0,0,0,0,1,12000,0,0,0,0,0,0.05,0.0,0.0,0.0,0.0,0.0,-8
2979,50000,1,2,1,28,0,0,0,0,0,0,50998,51103,50262,20304,20319,20330,2209,1726,710,724,733,712,1,48789,49377,49552,19580,19586,19618,0.97578,0.98754,0.99104,0.3916,0.39172,0.39236,0
2980,110000,1,2,2,25,2,0,0,0,0,0,109924,111805,108207,75808,78490,81238,6000,4380,3000,5000,10000,3000,0,103924,107425,105207,70808,68490,78238,0.9447636363636364,0.9765909090909091,0.9564272727272727,0.6437090909090909,0.6226363636363637,0.7112545454545455,2
2981,420000,1,2,1,40,-1,0,0,0,2,0,101873,99516,99873,100361,90052,89112,3517,3537,6810,0,2764,3500,1,98356,95979,93063,100361,87288,85612,0.23418095238095238,0.22852142857142857,0.22157857142857143,0.2389547619047619,0.20782857142857142,0.20383809523809523,1
2982,460000,1,1,2,35,1,-1,-1,0,0,0,-14,693,224526,227242,228126,143697,707,224850,5000,4593,23584,0,0,-721,-224157,219526,222649,204542,143697,-0.001567391304347826,-0.48729782608695654,0.4772304347826087,0.4840195652173913,0.44465652173913045,0.3123847826086957,-1
2983,30000,1,3,2,23,0,0,-1,-1,-1,0,18292,18450,390,390,780,780,1000,390,390,780,0,0,0,17292,18060,0,-390,780,780,0.5764,0.602,0.0,-0.013,0.026,0.026,-3
2984,50000,0,2,1,45,0,0,0,0,0,-2,9659,10610,6525,3660,0,0,1155,1000,73,0,0,0,1,8504,9610,6452,3660,0,0,0.17008,0.1922,0.12904,0.0732,0.0,0.0,-2
2985,140000,1,1,2,33,2,0,0,0,0,0,130104,131356,136107,128738,126491,125213,4900,7005,7000,4762,5000,5000,0,125204,124351,129107,123976,121491,120213,0.8943142857142857,0.8882214285714286,0.9221928571428571,0.8855428571428572,0.8677928571428571,0.8586642857142858,2
2986,100000,1,1,2,30,0,0,0,0,0,0,77388,78502,81233,82990,84210,85987,3000,4000,4000,3500,3287,4000,0,74388,74502,77233,79490,80923,81987,0.74388,0.74502,0.77233,0.7949,0.80923,0.81987,0
2987,60000,0,2,1,32,0,0,0,0,0,0,22357,23663,24779,25322,19248,18061,1684,1800,1287,813,700,681,1,20673,21863,23492,24509,18548,17380,0.34455,0.36438333333333334,0.39153333333333334,0.4084833333333333,0.3091333333333333,0.2896666666666667,0
2988,90000,0,2,1,27,0,0,0,0,0,0,70482,70591,64926,59949,54029,48170,2580,2337,1634,1606,1371,620,1,67902,68254,63292,58343,52658,47550,0.7544666666666666,0.7583777777777778,0.7032444444444444,0.6482555555555556,0.5850888888888889,0.5283333333333333,0
2989,120000,0,2,2,34,0,0,0,0,0,2,131773,58259,54699,54832,53693,48731,3000,1944,5000,3692,0,2000,0,128773,56315,49699,51140,53693,46731,1.0731083333333333,0.46929166666666666,0.41415833333333335,0.4261666666666667,0.4474416666666667,0.389425,2
2990,300000,0,2,1,46,-1,-1,-1,-2,-1,0,1413,15393,-10,-10,7805,5738,15480,0,0,7815,28,6554,1,-14067,15393,-10,-7825,7777,-816,-0.04689,0.05131,-3.3333333333333335e-05,-0.026083333333333333,0.025923333333333333,-0.00272,-6
2991,450000,0,1,1,42,-1,2,-1,-1,-1,-2,3566,240,1718,2284,-561,-1477,0,2000,2300,0,590,0,1,3566,-1760,-582,2284,-1151,-1477,0.007924444444444444,-0.003911111111111111,-0.0012933333333333334,0.005075555555555555,-0.0025577777777777777,-0.0032822222222222224,-4
2992,50000,1,2,1,27,1,2,0,0,0,0,52180,51009,49025,38697,18561,18952,0,2080,1600,657,683,838,1,52180,48929,47425,38040,17878,18114,1.0436,0.97858,0.9485,0.7608,0.35756,0.36228,3
2993,80000,1,3,1,35,0,0,0,0,0,0,63436,49544,50418,51810,28964,13059,2096,1970,2355,1500,1000,646,1,61340,47574,48063,50310,27964,12413,0.76675,0.594675,0.6007875,0.628875,0.34955,0.1551625,0
2994,50000,1,2,2,35,1,2,2,2,0,0,18544,17954,21678,21032,21465,24103,0,4351,0,784,3000,0,0,18544,13603,21678,20248,18465,24103,0.37088,0.27206,0.43356,0.40496,0.3693,0.48206,7
2995,20000,1,3,2,28,1,2,2,2,2,0,6616,6364,7891,8913,8624,9628,0,1800,1300,0,1300,1900,0,6616,4564,6591,8913,7324,7728,0.3308,0.2282,0.32955,0.44565,0.3662,0.3864,9
2996,80000,1,3,2,47,-2,-2,-2,-2,-2,-1,194843,197581,202150,0,0,48855,5501,6150,0,0,48855,1832,0,189342,191431,202150,0,-48855,47023,2.366775,2.3928875,2.526875,0.0,-0.6106875,0.5877875,-11
2997,250000,0,2,1,50,-2,-2,-2,-1,-1,-1,390,390,390,8042,16014,5607,390,390,8042,16014,5607,390,1,0,0,-7652,-7972,10407,5217,0.0,0.0,-0.030608,-0.031888,0.041628,0.020868,-9
2998,30000,0,2,2,24,0,0,0,0,0,0,27880,29342,22974,24586,25675,30765,2000,1388,2000,1500,5541,0,0,25880,27954,20974,23086,20134,30765,0.8626666666666667,0.9318,0.6991333333333334,0.7695333333333333,0.6711333333333334,1.0255,0
2999,30000,1,3,1,23,1,2,0,0,0,2,30380,25839,25963,27030,29079,29865,1,1433,1500,2500,1400,1400,1,30379,24406,24463,24530,27679,28465,1.0126333333333333,0.8135333333333333,0.8154333333333333,0.8176666666666667,0.9226333333333333,0.9488333333333333,5
3000,360000,0,1,2,32,-1,-1,-1,0,0,0,8140,0,20470,10357,8540,0,0,20470,207,0,0,3185,0,8140,-20470,20263,10357,8540,-3185,0.02261111111111111,-0.05686111111111111,0.05628611111111111,0.028769444444444445,0.02372222222222222,-0.008847222222222222,-3
3001,90000,1,1,2,25,2,0,0,0,0,-1,84710,87334,87862,18889,-783,73568,4000,3258,1000,0,77500,0,0,80710,84076,86862,18889,-78283,73568,0.8967777777777778,0.9341777777777778,0.9651333333333333,0.20987777777777777,-0.8698111111111111,0.8174222222222223,1
3002,40000,0,1,1,46,-1,2,2,-1,0,0,780,390,0,1170,780,0,0,0,1170,0,0,0,1,780,390,-1170,1170,780,0,0.0195,0.00975,-0.02925,0.02925,0.0195,0.0,2
3003,160000,1,3,1,53,1,-2,-1,2,2,-2,0,0,3613,2722,0,0,0,3613,0,0,0,0,1,0,-3613,3613,2722,0,0,0.0,-0.02258125,0.02258125,0.0170125,0.0,0.0,0
3004,200000,1,1,2,23,0,0,0,0,0,0,72853,73688,56073,57790,58356,60135,2933,2100,2659,2100,2700,2599,0,69920,71588,53414,55690,55656,57536,0.3496,0.35794,0.26707,0.27845,0.27828,0.28768,0
3005,260000,1,4,1,28,0,0,0,0,0,0,237212,228643,231156,223415,158739,159210,8006,7550,8080,4645,5047,4528,1,229206,221093,223076,218770,153692,154682,0.8815615384615385,0.8503576923076923,0.8579846153846153,0.8414230769230769,0.591123076923077,0.5949307692307693,0
3006,240000,1,1,1,41,0,0,0,0,0,0,129776,126395,129371,132218,136003,139798,5000,5000,5000,6000,6000,5098,1,124776,121395,124371,126218,130003,134700,0.5199,0.5058125,0.5182125,0.5259083333333333,0.5416791666666667,0.56125,0
3007,100000,1,2,2,28,0,0,0,0,0,0,50697,51813,53416,32422,33177,42560,1959,2545,1513,1268,10000,10000,0,48738,49268,51903,31154,23177,32560,0.48738,0.49268,0.51903,0.31154,0.23177,0.3256,0
3008,190000,0,1,1,55,-1,-1,-1,-1,-1,-1,390,390,390,390,6026,7410,390,390,390,6026,7410,390,1,0,0,0,-5636,-1384,7020,0.0,0.0,0.0,-0.029663157894736843,-0.00728421052631579,0.03694736842105263,-6
3009,50000,0,1,1,47,0,0,0,0,0,0,11066,15539,17274,19975,23632,25242,5000,2000,3000,4000,2000,0,1,6066,13539,14274,15975,21632,25242,0.12132,0.27078,0.28548,0.3195,0.43264,0.50484,0
3010,70000,0,1,2,43,0,0,0,0,0,0,68228,65935,67454,67592,36515,37426,2378,2600,2613,1500,1500,1500,0,65850,63335,64841,66092,35015,35926,0.9407142857142857,0.9047857142857143,0.9263,0.9441714285714286,0.5002142857142857,0.5132285714285715,0
3011,230000,1,2,1,28,2,2,2,2,2,2,35610,38701,35043,35678,36730,35994,3706,0,1513,1730,2000,9000,1,31904,38701,33530,33948,34730,26994,0.13871304347826088,0.16826521739130434,0.14578260869565218,0.1476,0.151,0.11736521739130434,12
3012,180000,0,1,2,38,2,2,2,0,0,0,114091,124233,125768,126202,127677,99764,12100,5000,4200,3000,5000,2000,0,101991,119233,121568,123202,122677,97764,0.5666166666666667,0.6624055555555556,0.6753777777777777,0.6844555555555556,0.6815388888888889,0.5431333333333334,6
3013,390000,1,3,2,30,0,0,0,0,0,0,338174,256104,221739,184529,175781,173442,8738,6545,6601,5700,6100,5000,0,329436,249559,215138,178829,169681,168442,0.8447076923076923,0.6398948717948718,0.5516358974358975,0.45853589743589745,0.4350794871794872,0.4319025641025641,0
3014,220000,0,1,2,28,0,0,0,0,0,0,150544,155328,156136,158416,161212,156790,12000,6000,6000,6000,6000,12000,0,138544,149328,150136,152416,155212,144790,0.6297454545454545,0.6787636363636363,0.6824363636363636,0.6928,0.7055090909090909,0.6581363636363636,0
3015,310000,1,1,2,35,1,-2,-1,0,0,0,0,0,4488,4696,84522,86206,0,4488,264,80000,2950,3055,0,0,-4488,4224,-75304,81572,83151,0.0,-0.014477419354838709,0.013625806451612904,-0.24291612903225807,0.26313548387096775,0.2682290322580645,-2
3016,360000,1,3,1,73,-2,-2,-2,-2,-2,-2,0,0,0,0,0,0,0,0,0,0,0,0,1,0,0,0,0,0,0,0.0,0.0,0.0,0.0,0.0,0.0,-12
3017,130000,0,1,2,27,1,-2,-2,-2,-2,-2,0,0,0,0,0,0,0,0,0,0,0,0,0,0,0,0,0,0,0,0.0,0.0,0.0,0.0,0.0,0.0,-9
3018,40000,0,1,2,26,2,0,0,2,2,0,36460,37549,40527,41036,39103,38945,2000,3900,1500,0,1600,1600,0,34460,33649,39027,41036,37503,37345,0.8615,0.841225,0.975675,1.0259,0.937575,0.933625,6
3019,280000,0,1,2,31,0,0,0,0,0,0,148186,150724,153762,155242,143679,145615,5000,5006,4408,4117,4600,4600,0,143186,145718,149354,151125,139079,141015,0.5113785714285715,0.5204214285714286,0.5334071428571429,0.5397321428571429,0.4967107142857143,0.503625,0
3020,500000,1,2,2,28,0,0,0,0,0,0,234957,215459,201715,141177,130352,126422,8086,7412,4721,3854,3622,3433,0,226871,208047,196994,137323,126730,122989,0.453742,0.416094,0.393988,0.274646,0.25346,0.245978,0
3021,100000,1,2,2,24,-1,-1,-2,-2,-1,-1,3587,660,6010,2789,2973,3611,660,6010,2789,2973,3611,11880,0,2927,-5350,3221,-184,-638,-8269,0.02927,-0.0535,0.03221,-0.00184,-0.00638,-0.08269,-8
3022,340000,1,1,2,26,-1,-1,-1,-1,-1,-1,4617,13054,15449,9610,4173,12929,13054,15449,9610,4373,12929,8000,0,-8437,-2395,5839,5237,-8756,4929,-0.02481470588235294,-0.007044117647058823,0.017173529411764706,0.015402941176470588,-0.02575294117647059,0.014497058823529411,-6
3023,130000,1,1,2,26,-1,-1,-1,-1,-1,-1,11149,3150,8552,5459,2850,9611,3160,8591,5463,2855,9611,8901,0,7989,-5441,3089,2604,-6761,710,0.06145384615384615,-0.04185384615384615,0.023761538461538462,0.02003076923076923,-0.05200769230769231,0.005461538461538461,-6
3024,200000,1,2,2,46,0,0,0,0,0,0,120343,121198,123834,136629,139504,142269,4342,4593,14955,5143,5166,5349,0,116001,116605,108879,131486,134338,136920,0.580005,0.583025,0.544395,0.65743,0.67169,0.6846,0
3025,270000,1,1,2,36,-1,-1,-1,-1,-1,-1,3458,3833,9791,10532,6559,500,3833,9791,10532,6559,500,961,0,-375,-5958,-741,3973,6059,-461,-0.001388888888888889,-0.022066666666666665,-0.0027444444444444443,0.014714814814814814,0.02244074074074074,-0.0017074074074074075,-6
3026,120000,1,2,2,27,-1,-1,2,-1,-1,-1,1066,5079,2528,4007,7457,2819,5079,0,4007,7457,2819,8638,0,-4013,5079,-1479,-3450,4638,-5819,-0.03344166666666667,0.042325,-0.012325,-0.02875,0.03865,-0.04849166666666667,-3
3027,210000,0,2,2,25,2,0,0,0,2,0,7474,8625,3511,4950,4727,5494,1500,1500,1500,0,1000,1000,0,5974,7125,2011,4950,3727,4494,0.028447619047619048,0.033928571428571426,0.009576190476190476,0.023571428571428573,0.017747619047619047,0.0214,4
3028,130000,1,3,2,53,0,0,0,0,0,0,101156,100184,99001,88214,90167,90682,3615,4700,3200,3403,3300,3500,0,97541,95484,95801,84811,86867,87182,0.7503153846153846,0.7344923076923077,0.7369307692307693,0.6523923076923077,0.6682076923076923,0.6706307692307693,0
3029,270000,0,2,2,27,0,0,0,0,0,0,24689,29520,29722,36276,19065,17937,10058,10339,10034,54,10088,6368,0,14631,19181,19688,36222,8977,11569,0.05418888888888889,0.07104074074074074,0.07291851851851852,0.13415555555555556,0.033248148148148145,0.04284814814814815,0
3030,60000,1,1,2,33,1,-2,-1,0,0,0,1242,0,4028,59334,54526,58575,0,4028,56626,2100,5000,2000,0,1242,-4028,-52598,57234,49526,56575,0.0207,-0.06713333333333334,-0.8766333333333334,0.9539,0.8254333333333334,0.9429166666666666,-2
3031,500000,1,1,2,42,-1,-1,-1,-1,-1,0,21179,51124,21138,49305,39095,15826,51304,21138,49775,39095,0,0,0,-30125,29986,-28637,10210,39095,15826,-0.06025,0.059972,-0.057274,0.02042,0.07819,0.031652,-5
3032,90000,1,2,2,30,2,0,0,0,0,2,75620,75382,73980,75036,77094,75708,3300,3350,3300,5500,1600,3950,0,72320,72032,70680,69536,75494,71758,0.8035555555555556,0.8003555555555556,0.7853333333333333,0.7726222222222222,0.8388222222222222,0.7973111111111111,4
3033,140000,1,2,2,27,2,0,0,0,0,0,136308,137077,138919,138035,138857,138894,5150,7750,5000,5379,5200,4850,0,131158,129327,133919,132656,133657,134044,0.9368428571428571,0.9237642857142857,0.9565642857142858,0.9475428571428571,0.9546928571428571,0.9574571428571429,2
3034,10000,0,1,2,22,0,-1,-1,-1,-1,-1,1483,46,915,352,105,0,46,915,352,105,0,1000,0,1437,-869,563,247,105,-1000,0.1437,-0.0869,0.0563,0.0247,0.0105,-0.1,-5
3035,200000,0,2,1,55,1,2,2,2,2,0,181339,177233,188461,191363,188683,196057,0,14000,7000,0,10000,5000,1,181339,163233,181461,191363,178683,191057,0.906695,0.816165,0.907305,0.956815,0.893415,0.955285,9
3036,200000,1,1,2,30,0,0,2,2,0,0,195128,203187,209286,188243,188668,190192,13600,12200,0,7000,7000,7300,0,181528,190987,209286,181243,181668,182892,0.90764,0.954935,1.04643,0.906215,0.90834,0.91446,4
3037,140000,0,1,2,27,0,0,0,0,0,0,7845,12338,13919,14019,4347,4729,5000,3000,300,500,4000,6000,0,2845,9338,13619,13519,347,-1271,0.02032142857142857,0.0667,0.09727857142857142,0.09656428571428571,0.0024785714285714285,-0.009078571428571429,0
3038,110000,0,3,2,34,2,2,2,2,2,2,86345,88492,81753,84368,80262,80529,4504,30,7000,2600,3500,2,0,81841,88462,74753,81768,76762,80527,0.744009090909091,0.8042,0.6795727272727272,0.7433454545454545,0.6978363636363636,0.7320636363636364,12
3039,210000,1,2,2,34,-2,-1,-1,-2,-2,-2,6769,12656,5570,2285,0,0,12660,5570,2285,0,0,0,0,-5891,7086,3285,2285,0,0,-0.028052380952380954,0.033742857142857144,0.015642857142857142,0.010880952380952382,0.0,0.0,-10
3040,210000,1,2,1,36,0,0,0,0,0,0,124011,119970,68742,65557,65287,64428,5011,3000,3000,3000,3000,2500,1,119000,116970,65742,62557,62287,61928,0.5666666666666667,0.557,0.31305714285714287,0.2978904761904762,0.2966047619047619,0.2948952380952381,0
3041,30000,0,1,2,42,1,2,2,2,0,0,31217,30406,31380,30277,30028,30198,0,3600,0,1100,1050,1000,0,31217,26806,31380,29177,28978,29198,1.0405666666666666,0.8935333333333333,1.046,0.9725666666666667,0.9659333333333333,0.9732666666666666,7
3042,400000,0,1,2,41,-1,-1,-1,-1,0,-1,11461,5864,5300,6534,5222,500,5877,5300,6534,0,500,360,0,5584,564,-1234,6534,4722,140,0.01396,0.00141,-0.003085,0.016335,0.011805,0.00035,-5
3043,30000,0,2,1,49,0,0,0,0,0,0,12922,14199,15461,16497,16923,17649,1500,1500,1300,700,1000,1000,1,11422,12699,14161,15797,15923,16649,0.3807333333333333,0.4233,0.47203333333333336,0.5265666666666666,0.5307666666666667,0.5549666666666667,0
3044,500000,0,1,1,36,0,0,0,0,0,0,294827,292920,291760,288024,274632,266669,20007,20026,20020,10017,15024,10002,1,274820,272894,271740,278007,259608,256667,0.54964,0.545788,0.54348,0.556014,0.519216,0.513334,0
3045,100000,0,2,1,36,1,2,2,2,4,3,9670,9371,11705,12919,12139,11653,0,2500,1700,0,0,0,1,9670,6871,10005,12919,12139,11653,0.0967,0.06871,0.10005,0.12919,0.12139,0.11653,14
3046,50000,0,2,2,42,0,0,0,0,0,0,49495,50586,49200,49763,18373,19187,3000,3000,3003,5000,2000,1500,0,46495,47586,46197,44763,16373,17687,0.9299,0.95172,0.92394,0.89526,0.32746,0.35374,0
3047,400000,1,2,2,38,-2,-2,-2,-2,-1,0,0,0,0,0,45374,46306,0,0,0,45374,1113,1129,0,0,0,0,-45374,44261,45177,0.0,0.0,0.0,-0.113435,0.1106525,0.1129425,-9
3048,50000,0,3,3,52,-2,-2,-2,-2,-2,-2,0,0,0,0,0,0,0,0,0,0,0,0,0,0,0,0,0,0,0,0.0,0.0,0.0,0.0,0.0,0.0,-12
3049,360000,1,3,2,29,-2,-2,-2,-2,-2,-2,3307,0,0,0,0,1131,0,0,0,0,1131,3409,0,3307,0,0,0,-1131,-2278,0.009186111111111112,0.0,0.0,0.0,-0.0031416666666666667,-0.006327777777777778,-12
3050,50000,1,1,2,25,-1,2,-1,-1,-1,-1,9040,3020,2262,2185,0,5918,0,2262,2185,0,5918,0,0,9040,758,77,2185,-5918,5918,0.1808,0.01516,0.00154,0.0437,-0.11836,0.11836,-3
3051,500000,1,1,2,44,-2,-2,-2,-2,-2,-2,29996,10625,14567,0,3808,6751,10625,14573,0,3808,6751,0,0,19371,-3948,14567,-3808,-2943,6751,0.038742,-0.007896,0.029134,-0.007616,-0.005886,0.013502,-12
3052,80000,1,3,1,40,0,0,0,0,0,0,12171,11554,7830,4305,5427,6180,1500,1218,311,1351,1000,2000,1,10671,10336,7519,2954,4427,4180,0.1333875,0.1292,0.0939875,0.036925,0.0553375,0.05225,0
3053,170000,0,2,2,34,-1,-1,-1,-1,-1,-1,2806,326,676,326,326,326,652,676,326,326,326,1722,0,2154,-350,350,0,0,-1396,0.012670588235294118,-0.002058823529411765,0.002058823529411765,0.0,0.0,-0.008211764705882352,-6
3054,380000,1,2,2,28,0,0,0,0,0,0,123880,105184,69221,46858,33060,27047,7050,6018,3000,4000,4000,250400,0,116830,99166,66221,42858,29060,-223353,0.30744736842105264,0.26096315789473684,0.1742657894736842,0.11278421052631579,0.07647368421052632,-0.5877710526315789,0
3055,80000,1,2,2,25,1,2,0,0,0,0,78894,79989,79882,67946,51435,53113,3000,3500,5000,2500,2500,2000,0,75894,76489,74882,65446,48935,51113,0.948675,0.9561125,0.936025,0.818075,0.6116875,0.6389125,3
3056,140000,0,1,2,36,2,0,0,0,0,0,75384,74177,65336,53578,49288,43870,4000,4000,3500,2000,2500,1800,0,71384,70177,61836,51578,46788,42070,0.5098857142857143,0.5012642857142857,0.4416857142857143,0.3684142857142857,0.3342,0.3005,2
3057,30000,1,3,2,23,0,0,0,0,-1,-1,2277,3158,4080,5080,150,178,1078,1000,1000,150,178,300,0,1199,2158,3080,4930,-28,-122,0.039966666666666664,0.07193333333333334,0.10266666666666667,0.16433333333333333,-0.0009333333333333333,-0.004066666666666666,-2
3058,50000,1,3,1,47,1,-2,-2,-2,-2,-2,0,0,0,0,0,0,0,0,0,0,0,0,1,0,0,0,0,0,0,0.0,0.0,0.0,0.0,0.0,0.0,-9
3059,140000,0,3,2,30,2,2,2,2,2,0,145627,145339,136223,113942,109652,109118,6005,210,7903,0,4183,4213,0,139622,145129,128320,113942,105469,104905,0.9973,1.0366357142857143,0.9165714285714286,0.8138714285714286,0.75335,0.7493214285714286,10
3060,50000,1,1,2,25,0,0,0,2,0,0,50673,47278,44993,36782,30442,29636,2500,4000,0,1200,1250,1300,0,48173,43278,44993,35582,29192,28336,0.96346,0.86556,0.89986,0.71164,0.58384,0.56672,2
3061,360000,1,1,1,35,0,0,0,0,0,0,101953,125238,205209,125982,128161,136447,25238,4385,11939,5681,10447,8010,1,76715,120853,193270,120301,117714,128437,0.21309722222222222,0.3357027777777778,0.5368611111111111,0.33416944444444446,0.32698333333333335,0.3567694444444444,0
3062,50000,0,1,2,36,1,2,0,0,-2,-2,49395,50058,50753,0,0,0,1776,2374,0,0,0,0,0,47619,47684,50753,0,0,0,0.95238,0.95368,1.01506,0.0,0.0,0.0,-1
3063,180000,0,1,1,46,0,0,0,-2,-2,-2,142826,61650,0,0,0,0,3000,0,0,0,0,0,1,139826,61650,0,0,0,0,0.7768111111111111,0.3425,0.0,0.0,0.0,0.0,-6
3064,50000,1,2,1,33,0,0,0,0,0,0,44052,32030,31041,26197,25739,27659,2000,1451,3000,862,5000,10000,1,42052,30579,28041,25335,20739,17659,0.84104,0.61158,0.56082,0.5067,0.41478,0.35318,0
3065,30000,1,3,1,56,1,3,2,2,2,2,25158,24466,24087,25890,25175,26870,0,300,2500,0,2100,0,1,25158,24166,21587,25890,23075,26870,0.8386,0.8055333333333333,0.7195666666666667,0.863,0.7691666666666667,0.8956666666666667,12
3066,300000,0,1,1,51,-1,-1,-1,-1,0,0,18961,4371,3391,34282,12983,0,4387,3472,47371,64,0,33588,1,14574,899,-43980,34218,12983,-33588,0.04858,0.0029966666666666666,-0.1466,0.11406,0.043276666666666665,-0.11196,-4
3067,80000,1,2,2,35,0,0,0,-1,-1,-1,48725,53095,56858,4849,4849,4849,10000,10000,4849,4849,4849,4849,0,38725,43095,52009,0,0,0,0.4840625,0.5386875,0.6501125,0.0,0.0,0.0,-3
3068,100000,1,2,1,39,0,0,0,0,0,0,100549,94471,57529,58070,58615,58760,3711,3155,1696,1889,1764,1714,1,96838,91316,55833,56181,56851,57046,0.96838,0.91316,0.55833,0.56181,0.56851,0.57046,0
3069,200000,0,1,2,30,-2,-2,-1,-1,-2,-1,1488,2493,5261,993,2494,3890,2505,5268,996,2501,3896,5189,0,-1017,-2775,4265,-1508,-1402,-1299,-0.005085,-0.013875,0.021325,-0.00754,-0.00701,-0.006495,-9
3070,60000,0,1,2,39,1,2,0,0,0,0,60037,50524,58025,59724,28575,39402,0,9000,3000,1200,11500,3000,0,60037,41524,55025,58524,17075,36402,1.0006166666666667,0.6920666666666667,0.9170833333333334,0.9754,0.28458333333333335,0.6067,3
3071,20000,0,2,2,36,1,4,3,3,2,3,15557,15015,16079,15528,16477,15930,0,1600,0,1500,0,0,0,15557,13415,16079,14028,16477,15930,0.77785,0.67075,0.80395,0.7014,0.82385,0.7965,16
3072,250000,1,2,2,33,0,0,0,0,0,0,147934,149485,152678,157337,159719,163649,5500,5600,7200,6500,6500,6000,0,142434,143885,145478,150837,153219,157649,0.569736,0.57554,0.581912,0.603348,0.612876,0.630596,0
3073,60000,1,2,2,26,0,0,0,0,0,2,58452,52445,52974,54589,59518,60491,2500,2000,2500,6000,2100,0,0,55952,50445,50474,48589,57418,60491,0.9325333333333333,0.84075,0.8412333333333334,0.8098166666666666,0.9569666666666666,1.0081833333333334,2
3074,500000,1,2,2,27,0,0,-1,0,0,0,195140,190529,135943,128438,106591,85215,11613,176596,6506,5178,3031,3466,0,183527,13933,129437,123260,103560,81749,0.367054,0.027866,0.258874,0.24652,0.20712,0.163498,-1
3075,180000,0,3,2,28,0,0,0,0,0,0,129719,133702,133758,80055,69672,33194,6070,3521,5000,5000,5004,5029,0,123649,130181,128758,75055,64668,28165,0.6869388888888889,0.7232277777777778,0.7153222222222222,0.41697222222222224,0.3592666666666667,0.15647222222222223,0
3076,230000,0,1,2,39,0,0,0,0,-2,-2,38395,39943,20650,0,0,0,2500,2000,0,0,0,0,0,35895,37943,20650,0,0,0,0.15606521739130436,0.1649695652173913,0.08978260869565217,0.0,0.0,0.0,-4
3077,130000,1,2,1,47,0,0,0,0,0,0,46096,37939,39138,40023,40536,41697,2167,2000,2000,1469,2000,2000,1,43929,35939,37138,38554,38536,39697,0.3379153846153846,0.27645384615384616,0.28567692307692305,0.29656923076923075,0.2964307692307692,0.30536153846153846,0
3078,280000,0,1,2,32,0,0,0,0,0,0,217798,202676,199490,181857,183324,177920,10050,10123,10001,6244,6315,7037,0,207748,192553,189489,175613,177009,170883,0.7419571428571429,0.6876892857142857,0.6767464285714285,0.6271892857142857,0.632175,0.6102964285714285,0
3079,80000,1,1,2,23,-2,-2,-2,-2,-2,-2,390,390,390,390,740,552,390,780,390,740,552,4390,0,0,-390,0,-350,188,-3838,0.0,-0.004875,0.0,-0.004375,0.00235,-0.047975,-12
3080,130000,1,2,2,25,-1,-1,-1,-1,-1,-1,3639,396,396,396,396,396,396,396,396,396,396,396,0,3243,0,0,0,0,0,0.024946153846153847,0.0,0.0,0.0,0.0,0.0,-6
3081,80000,1,3,1,59,0,0,0,0,0,0,75662,70073,53169,50875,50372,49470,3212,2106,2000,1603,1903,2006,1,72450,67967,51169,49272,48469,47464,0.905625,0.8495875,0.6396125,0.6159,0.6058625,0.5933,0
3082,80000,1,2,2,31,0,0,0,0,0,0,81358,69913,71541,72541,54061,55136,3126,3391,3000,2000,1974,2043,0,78232,66522,68541,70541,52087,53093,0.9779,0.831525,0.8567625,0.8817625,0.6510875,0.6636625,0
3083,200000,0,1,2,31,0,-1,-1,0,0,0,9080,14280,13918,22836,20105,4415,14280,13918,12836,8000,1000,0,0,-5200,362,1082,14836,19105,4415,-0.026,0.00181,0.00541,0.07418,0.095525,0.022075,-2
3084,50000,1,1,2,22,0,0,0,0,0,0,49459,49281,50071,10104,9208,10075,2300,2000,1000,500,1000,500,0,47159,47281,49071,9604,8208,9575,0.94318,0.94562,0.98142,0.19208,0.16416,0.1915,0
3085,30000,1,3,2,53,0,0,0,0,2,0,21101,21831,23457,24972,24432,25126,1374,2000,1908,0,1100,1000,0,19727,19831,21549,24972,23332,24126,0.6575666666666666,0.6610333333333334,0.7183,0.8324,0.7777333333333334,0.8042,2
3086,20000,0,1,2,24,-1,-1,-1,2,0,0,3302,0,679,679,5679,7570,0,679,0,5000,2000,0,0,3302,-679,679,-4321,3679,7570,0.1651,-0.03395,0.03395,-0.21605,0.18395,0.3785,-1
3087,30000,1,2,2,23,0,0,0,0,0,0,28420,27929,28920,27997,28378,29321,1482,1703,1001,1500,1845,1001,0,26938,26226,27919,26497,26533,28320,0.8979333333333334,0.8742,0.9306333333333333,0.8832333333333333,0.8844333333333333,0.944,0
3088,390000,0,1,1,46,-1,-1,-1,-1,-1,-1,6346,94921,53796,6009,9096,3267,94921,53796,6009,9096,3267,2901,1,-88575,41125,47787,-3087,5829,366,-0.2271153846153846,0.10544871794871795,0.12253076923076923,-0.007915384615384616,0.014946153846153847,0.0009384615384615385,-6
3089,70000,1,3,1,29,0,0,0,0,0,0,22438,24055,25359,26434,26993,28551,2000,2000,1500,1000,2000,1500,1,20438,22055,23859,25434,24993,27051,0.29197142857142855,0.31507142857142856,0.34084285714285717,0.36334285714285713,0.35704285714285716,0.38644285714285714,0
3090,110000,1,3,1,53,-2,-2,-2,-2,-2,-2,1457,745,0,0,0,0,745,0,0,0,0,0,1,712,745,0,0,0,0,0.006472727272727272,0.006772727272727273,0.0,0.0,0.0,0.0,-12
3091,200000,0,2,1,28,-1,0,0,0,0,0,11445,12379,12187,7402,10827,11351,5013,3038,3007,5005,2056,2826,1,6432,9341,9180,2397,8771,8525,0.03216,0.046705,0.0459,0.011985,0.043855,0.042625,-1
3092,310000,1,1,1,39,-2,-2,-2,-2,-2,-2,12080,1989,4566,5329,5724,1518,1989,4566,5433,5724,1336,0,1,10091,-2577,-867,-395,4388,1518,0.03255161290322581,-0.008312903225806452,-0.002796774193548387,-0.0012741935483870969,0.014154838709677419,0.004896774193548387,-12
3093,340000,1,2,2,32,0,0,0,0,0,0,169246,100967,102819,105477,107454,110419,6000,4500,5000,4000,5000,4000,0,163246,96467,97819,101477,102454,106419,0.48013529411764705,0.2837264705882353,0.2877029411764706,0.29846176470588237,0.30133529411764703,0.3129970588235294,0
3094,360000,0,1,2,33,-2,-2,-2,-2,-2,-2,780,286,0,0,390,-200,286,0,0,390,0,0,0,494,286,0,-390,390,-200,0.0013722222222222222,0.0007944444444444444,0.0,-0.0010833333333333333,0.0010833333333333333,-0.0005555555555555556,-12
3095,170000,1,1,2,40,-2,-2,-2,-2,-2,-2,0,0,1980,0,280,280,0,1980,0,280,280,1111,0,0,-1980,1980,-280,0,-831,0.0,-0.011647058823529411,0.011647058823529411,-0.0016470588235294118,0.0,-0.004888235294117647,-12
3096,230000,1,2,2,32,1,-1,-1,0,-1,-1,328,1593,2015,1077,1479,3104,1621,2015,10,1479,3104,1152,0,-1293,-422,2005,-402,-1625,1952,-0.0056217391304347825,-0.0018347826086956521,0.008717391304347826,-0.0017478260869565217,-0.007065217391304348,0.00848695652173913,-3
3097,170000,0,1,2,36,-1,-1,-1,-1,-1,-1,8433,644,7567,0,499,576,644,7567,0,499,576,0,0,7789,-6923,7567,-499,-77,576,0.04581764705882353,-0.04072352941176471,0.044511764705882355,-0.002935294117647059,-0.00045294117647058825,0.003388235294117647,-6
3098,90000,1,2,2,23,0,0,0,0,-1,-1,88015,69701,52046,42541,8571,4653,5640,16021,13280,8571,19653,12000,0,82375,53680,38766,33970,-11082,-7347,0.9152777777777777,0.5964444444444444,0.43073333333333336,0.37744444444444447,-0.12313333333333333,-0.08163333333333334,-2
3099,70000,1,1,2,22,0,0,0,0,0,0,71358,70285,28867,29766,26522,27584,3280,1480,1360,960,1500,1000,0,68078,68805,27507,28806,25022,26584,0.9725428571428572,0.9829285714285714,0.39295714285714284,0.4115142857142857,0.35745714285714286,0.3797714285714286,0
3100,40000,1,2,2,27,0,0,0,0,0,0,29009,34183,35606,37018,37184,38066,9000,2000,2000,1349,1500,1500,0,20009,32183,33606,35669,35684,36566,0.500225,0.804575,0.84015,0.891725,0.8921,0.91415,0
3101,230000,0,2,2,38,2,2,2,2,2,0,177917,181465,185074,187053,176805,180826,8000,8000,6500,0,7000,6500,0,169917,173465,178574,187053,169805,174326,0.7387695652173913,0.754195652173913,0.776408695652174,0.8132739130434783,0.7382826086956522,0.7579391304347826,10
3102,120000,0,2,2,26,2,2,2,2,0,0,109110,105891,113662,110349,112036,114584,0,11000,0,5000,4332,9404,0,109110,94891,113662,105349,107704,105180,0.90925,0.7907583333333333,0.9471833333333334,0.8779083333333333,0.8975333333333333,0.8765,8
3103,90000,1,1,2,29,2,2,2,0,0,0,7052,9370,9078,10267,10350,10564,2605,0,1500,550,529,531,0,4447,9370,7578,9717,9821,10033,0.049411111111111114,0.10411111111111111,0.0842,0.10796666666666667,0.10912222222222222,0.11147777777777777,6
3104,110000,1,1,1,51,0,0,0,0,0,0,103701,102318,92724,94573,65034,66241,3771,3656,3687,2476,2406,2427,1,99930,98662,89037,92097,62628,63814,0.9084545454545454,0.8969272727272727,0.8094272727272728,0.8372454545454545,0.5693454545454546,0.5801272727272727,0
3105,240000,1,2,1,29,0,0,0,0,0,0,81274,83030,84945,65601,66901,68086,3101,3385,2377,2387,2472,2475,1,78173,79645,82568,63214,64429,65611,0.32572083333333335,0.3318541666666667,0.34403333333333336,0.2633916666666667,0.26845416666666666,0.2733791666666667,0
3106,120000,0,2,2,37,-1,2,0,0,0,2,16241,16680,17695,17901,19608,19143,1000,1600,800,2000,0,1600,0,15241,15080,16895,15901,19608,17543,0.12700833333333333,0.12566666666666668,0.14079166666666668,0.13250833333333334,0.1634,0.14619166666666666,3
3107,290000,0,1,3,55,0,0,2,0,0,0,7970,10320,10005,10838,11663,13301,2482,0,1000,1000,2000,2000,0,5488,10320,9005,9838,9663,11301,0.018924137931034483,0.035586206896551724,0.031051724137931034,0.033924137931034486,0.03332068965517242,0.038968965517241376,2
3108,90000,1,2,2,27,-1,-1,0,0,0,0,18674,88907,90659,82827,79359,81401,92858,4100,3200,3100,3500,3500,0,-74184,84807,87459,79727,75859,77901,-0.8242666666666667,0.9423,0.9717666666666667,0.8858555555555555,0.8428777777777777,0.8655666666666667,-2
3109,50000,0,2,1,38,3,2,3,2,2,2,33759,36388,35527,36247,35367,37537,3500,0,1600,0,2900,0,1,30259,36388,33927,36247,32467,37537,0.60518,0.72776,0.67854,0.72494,0.64934,0.75074,14
3110,490000,0,3,1,28,0,0,0,0,0,0,108157,107692,108590,109389,110491,111158,4056,3993,3831,4111,3939,4001,1,104101,103699,104759,105278,106552,107157,0.21245102040816327,0.21163061224489796,0.21379387755102042,0.2148530612244898,0.2174530612244898,0.2186877551020408,0
3111,300000,0,3,1,40,0,0,0,0,0,0,39883,42349,44095,46502,47578,48959,3000,2600,3000,2000,2000,2000,1,36883,39749,41095,44502,45578,46959,0.12294333333333334,0.13249666666666668,0.13698333333333335,0.14834,0.15192666666666665,0.15653,0
3112,500000,0,1,2,42,2,0,0,0,0,0,419352,428101,436809,443840,452841,468305,17008,17326,16101,16634,23501,20623,0,402344,410775,420708,427206,429340,447682,0.804688,0.82155,0.841416,0.854412,0.85868,0.895364,2
3113,20000,0,2,2,28,0,0,0,0,0,0,17973,17835,18795,18252,17589,17480,1318,1278,635,802,350,0,0,16655,16557,18160,17450,17239,17480,0.83275,0.82785,0.908,0.8725,0.86195,0.874,0
3114,280000,1,1,2,35,-1,-1,-1,-1,-1,-1,6494,28723,9432,3472,3472,10237,28723,9432,3472,3472,10237,12129,0,-22229,19291,5960,0,-6765,-1892,-0.07938928571428572,0.06889642857142857,0.021285714285714286,0.0,-0.024160714285714285,-0.006757142857142857,-6
3115,260000,0,3,2,48,0,0,0,0,0,0,266762,268508,266858,194413,189687,162473,11500,10000,5731,5654,5275,4000,0,255262,258508,261127,188759,184412,158473,0.9817769230769231,0.9942615384615384,1.0043346153846153,0.7259961538461538,0.709276923076923,0.6095115384615385,0
3116,50000,0,3,2,29,-2,-2,-2,-2,-2,-2,0,0,0,0,0,0,0,0,0,0,0,0,0,0,0,0,0,0,0,0.0,0.0,0.0,0.0,0.0,0.0,-12
3117,200000,0,1,1,34,-2,-2,-2,-2,-2,-2,1242,4006,941,2357,2945,1143,4034,945,2366,2947,1143,744,1,-2792,3061,-1425,-590,1802,399,-0.01396,0.015305,-0.007125,-0.00295,0.00901,0.001995,-12
3118,500000,0,2,2,32,-1,-1,-1,-1,0,-1,10339,6405,-4617,16879,5195,290,6405,99,22480,0,580,36753,0,3934,6306,-27097,16879,4615,-36463,0.007868,0.012612,-0.054194,0.033758,0.00923,-0.072926,-5
3119,360000,1,2,2,25,-1,-1,-1,-1,-1,-1,947,4075,6385,991,4632,2014,4098,6401,997,4641,2014,5,0,-3151,-2326,5388,-3650,2618,2009,-0.008752777777777778,-0.006461111111111111,0.014966666666666666,-0.010138888888888888,0.0072722222222222225,0.005580555555555556,-6
3120,130000,0,2,2,29,0,0,0,0,0,0,58299,59352,51420,48140,34893,33986,2626,8585,1620,698,725,843,0,55673,50767,49800,47442,34168,33143,0.42825384615384615,0.3905153846153846,0.3830769230769231,0.36493846153846154,0.26283076923076926,0.2549461538461538,0
3121,180000,1,2,1,30,1,-1,-1,-1,0,0,1591,150,8834,19565,14170,9017,150,8857,19565,502,3000,2707,1,1441,-8707,-10731,19063,11170,6310,0.008005555555555556,-0.04837222222222222,-0.059616666666666665,0.10590555555555556,0.06205555555555556,0.035055555555555555,-2
3122,180000,0,2,1,33,0,0,-1,-1,0,0,177017,107267,11426,96562,144345,141659,20135,12099,96562,49000,140000,6000,1,156882,95168,-85136,47562,4345,135659,0.8715666666666667,0.5287111111111111,-0.4729777777777778,0.2642333333333333,0.02413888888888889,0.7536611111111111,-2
3123,100000,1,3,1,30,1,-2,-2,-2,-2,-2,-602,-602,-602,-602,-602,-602,0,0,0,0,0,0,1,-602,-602,-602,-602,-602,-602,-0.00602,-0.00602,-0.00602,-0.00602,-0.00602,-0.00602,-9
3124,210000,0,1,2,33,1,-2,-2,-2,-1,-1,0,0,0,0,700,0,0,0,0,700,0,0,0,0,0,0,-700,700,0,0.0,0.0,0.0,-0.0033333333333333335,0.0033333333333333335,0.0,-7
3125,90000,1,1,2,29,1,-1,-1,-2,-2,-2,0,194,0,0,0,0,194,0,0,0,0,217,0,-194,194,0,0,0,-217,-0.0021555555555555555,0.0021555555555555555,0.0,0.0,0.0,-0.0024111111111111113,-7
3126,50000,1,1,2,26,2,0,0,2,2,2,25875,27132,29695,30908,30112,32123,2000,3000,2000,0,2500,0,0,23875,24132,27695,30908,27612,32123,0.4775,0.48264,0.5539,0.61816,0.55224,0.64246,8
3127,50000,1,2,2,22,2,2,2,2,2,2,15006,14475,16227,16662,16253,17982,0,2000,1000,0,2000,0,0,15006,12475,15227,16662,14253,17982,0.30012,0.2495,0.30454,0.33324,0.28506,0.35964,12
3128,60000,0,2,1,50,-1,-1,-1,-1,0,0,7888,13989,9588,18041,14458,12710,14026,9700,18064,4016,5029,2828,1,-6138,4289,-8476,14025,9429,9882,-0.1023,0.07148333333333333,-0.14126666666666668,0.23375,0.15715,0.1647,-4
3129,360000,0,1,1,35,-1,-1,-1,-1,-1,0,3738,2019,4979,0,4974,4974,2019,4979,0,4974,0,72322,1,1719,-2960,4979,-4974,4974,-67348,0.004775,-0.008222222222222223,0.013830555555555556,-0.013816666666666666,0.013816666666666666,-0.1870777777777778,-5
3130,280000,1,2,1,49,2,2,2,0,0,0,28788,31315,30529,33562,34557,35600,3315,0,3562,1557,1600,3175,1,25473,31315,26967,32005,32957,32425,0.090975,0.11183928571428571,0.09631071428571429,0.11430357142857143,0.11770357142857144,0.11580357142857142,6
3131,130000,1,3,1,40,0,0,-2,-2,-2,-2,102650,0,0,0,0,0,0,0,0,0,0,0,1,102650,0,0,0,0,0,0.7896153846153846,0.0,0.0,0.0,0.0,0.0,-8
3132,500000,1,2,2,30,0,0,0,0,0,0,98618,73464,84741,72510,69053,64841,25464,43095,7522,9065,8841,12000,0,73154,30369,77219,63445,60212,52841,0.146308,0.060738,0.154438,0.12689,0.120424,0.105682,0
3133,360000,0,2,2,26,0,0,0,0,-1,0,89635,80129,75246,72996,73177,67271,3122,2007,1500,73177,2452,2256,0,86513,78122,73746,-181,70725,65015,0.24031388888888888,0.21700555555555556,0.20485,-0.0005027777777777778,0.19645833333333335,0.18059722222222221,-1
3134,200000,0,2,1,38,0,0,0,0,0,0,105729,106296,110031,112410,128894,131588,3806,5449,5694,20000,4774,5101,1,101923,100847,104337,92410,124120,126487,0.509615,0.504235,0.521685,0.46205,0.6206,0.632435,0
3135,50000,0,2,1,44,0,0,0,0,0,0,45335,46027,30286,26275,26823,27371,1524,1427,941,972,992,1000,1,43811,44600,29345,25303,25831,26371,0.87622,0.892,0.5869,0.50606,0.51662,0.52742,0
3136,80000,1,1,1,54,2,2,2,0,0,0,12894,15449,14909,14915,15382,16374,3084,0,550,707,1400,200,1,9810,15449,14359,14208,13982,16174,0.122625,0.1931125,0.1794875,0.1776,0.174775,0.202175,6
3137,60000,1,3,2,41,0,0,0,0,0,0,56309,58369,59237,59851,32002,32388,3000,2400,1812,3200,2000,4000,0,53309,55969,57425,56651,30002,28388,0.8884833333333333,0.9328166666666666,0.9570833333333333,0.9441833333333334,0.5000333333333333,0.47313333333333335,0
3138,400000,1,1,1,32,1,-1,-1,-1,-1,-1,0,3328,3328,3828,4893,4687,6656,3328,3828,4893,4687,3008,1,-6656,0,-500,-1065,206,1679,-0.01664,0.0,-0.00125,-0.0026625,0.000515,0.0041975,-4
3139,120000,1,1,2,25,1,-2,-2,-2,-2,-2,0,0,0,0,0,0,0,0,0,0,0,0,0,0,0,0,0,0,0,0.0,0.0,0.0,0.0,0.0,0.0,-9
3140,100000,1,2,2,23,0,0,-1,-1,-1,-1,82323,45756,9187,5408,12920,9656,1000,9187,5408,12920,9656,4737,0,81323,36569,3779,-7512,3264,4919,0.81323,0.36569,0.03779,-0.07512,0.03264,0.04919,-4
3141,340000,1,2,2,47,0,0,0,0,0,0,196112,183453,167592,162628,142779,139548,6446,6207,5758,4853,4940,4600,0,189666,177246,161834,157775,137839,134948,0.5578411764705883,0.5213117647058824,0.47598235294117647,0.46404411764705883,0.40540882352941177,0.39690588235294116,0
3142,180000,1,3,2,26,0,0,0,0,0,0,71702,66234,57253,53736,46213,39701,2950,2200,2000,5000,2000,2300,0,68752,64034,55253,48736,44213,37401,0.38195555555555555,0.3557444444444444,0.30696111111111113,0.2707555555555556,0.24562777777777778,0.20778333333333332,0
3143,50000,0,2,1,52,0,0,2,0,0,0,43286,47744,46706,48066,49026,49755,5500,0,2500,2000,2000,2058,1,37786,47744,44206,46066,47026,47697,0.75572,0.95488,0.88412,0.92132,0.94052,0.95394,2
3144,200000,1,2,1,36,-1,0,0,0,0,0,136286,183615,184792,195062,195156,192436,50000,7000,15000,7500,7500,10000,1,86286,176615,169792,187562,187656,182436,0.43143,0.883075,0.84896,0.93781,0.93828,0.91218,-1
3145,50000,0,2,1,27,0,0,0,0,0,0,46806,46176,47151,47251,20515,19404,2000,5300,1500,1100,1000,1000,1,44806,40876,45651,46151,19515,18404,0.89612,0.81752,0.91302,0.92302,0.3903,0.36808,0
3146,140000,1,1,1,42,2,2,2,0,0,0,141321,141836,139070,134168,135678,136494,4300,1003,4854,5500,5200,5100,1,137021,140833,134216,128668,130478,131394,0.9787214285714285,1.00595,0.9586857142857143,0.9190571428571429,0.9319857142857143,0.9385285714285714,6
3147,60000,1,3,1,63,0,0,0,0,0,0,59471,59021,49580,38140,29843,27719,2400,1940,1477,1025,1006,1261,1,57071,57081,48103,37115,28837,26458,0.9511833333333334,0.95135,0.8017166666666666,0.6185833333333334,0.4806166666666667,0.4409666666666667,0
3148,320000,1,2,1,47,-1,-1,2,-1,2,-1,10159,37758,15591,39240,28424,25120,38075,0,39424,0,25120,35375,1,-27916,37758,-23833,39240,3304,-10255,-0.0872375,0.11799375,-0.074478125,0.122625,0.010325,-0.032046875,0
3149,500000,1,2,1,38,0,0,0,0,0,0,242546,184601,189136,172674,20253,29576,7000,8000,9000,791,10000,7000,1,235546,176601,180136,171883,10253,22576,0.471092,0.353202,0.360272,0.343766,0.020506,0.045152,0
3150,10000,0,2,2,23,0,0,0,0,0,-2,3714,4158,4654,3080,0,0,1104,1000,31,0,0,0,0,2610,3158,4623,3080,0,0,0.261,0.3158,0.4623,0.308,0.0,0.0,-2
3151,60000,1,2,2,26,2,2,2,2,2,0,56685,55208,59175,60218,55447,55305,0,5000,2511,6,3000,3000,0,56685,50208,56664,60212,52447,52305,0.94475,0.8368,0.9444,1.0035333333333334,0.8741166666666667,0.87175,10
3152,300000,1,2,2,26,0,0,0,0,0,0,212323,216844,220004,18715,18675,18693,8420,7117,1285,702,810,542,0,203903,209727,218719,18013,17865,18151,0.6796766666666667,0.69909,0.7290633333333333,0.06004333333333333,0.05955,0.06050333333333333,0
3153,360000,0,1,2,27,0,0,0,0,0,0,375392,373004,371567,375352,316076,314588,13290,14012,20000,16000,16000,290000,0,362102,358992,351567,359352,300076,24588,1.005838888888889,0.9972,0.976575,0.9982,0.8335444444444444,0.0683,0
3154,80000,1,1,2,22,0,0,0,0,0,0,48305,48823,41495,36733,27692,27872,1739,1701,1439,980,1005,1216,0,46566,47122,40056,35753,26687,26656,0.582075,0.589025,0.5007,0.4469125,0.3335875,0.3332,0
3155,210000,1,1,2,27,-1,-1,-1,-1,-1,-2,4426,0,1349,10368,0,0,0,1349,10368,0,0,0,0,4426,-1349,-9019,10368,0,0,0.021076190476190478,-0.0064238095238095235,-0.04294761904761905,0.04937142857142857,0.0,0.0,-7
3156,340000,1,2,1,52,0,0,0,0,0,0,331508,319742,255166,197695,201907,195961,12100,10000,7000,7000,7000,8000,1,319408,309742,248166,190695,194907,187961,0.939435294117647,0.9110058823529412,0.7299,0.5608676470588235,0.5732558823529412,0.5528264705882353,0
3157,60000,1,2,1,24,3,2,2,2,0,0,33866,33041,35284,31602,32221,30208,0,2900,0,1200,1409,1115,1,33866,30141,35284,30402,30812,29093,0.5644333333333333,0.50235,0.5880666666666666,0.5067,0.5135333333333333,0.48488333333333333,9
3158,390000,1,2,1,30,0,0,0,0,0,0,98984,102158,96446,87912,89991,91470,5700,4000,3200,3500,3100,3000,1,93284,98158,93246,84412,86891,88470,0.2391897435897436,0.2516871794871795,0.2390923076923077,0.21644102564102563,0.2227974358974359,0.22684615384615384,0
3159,70000,1,1,2,24,0,0,0,0,0,0,110176,56378,57572,58130,59289,61331,2700,2700,2110,2125,3000,2300,0,107476,53678,55462,56005,56289,59031,1.5353714285714286,0.7668285714285714,0.7923142857142857,0.8000714285714285,0.8041285714285714,0.8433,0
3160,30000,1,2,2,37,2,0,0,0,0,0,25037,18486,19082,19145,15839,9335,2000,2000,2500,2000,2000,4000,0,23037,16486,16582,17145,13839,5335,0.7679,0.5495333333333333,0.5527333333333333,0.5715,0.4613,0.17783333333333334,2
3161,150000,0,1,1,54,-2,-1,-1,-2,-2,-2,4015,499,-948,-1580,316,316,501,632,0,1896,316,782,1,3514,-133,-948,-3476,0,-466,0.023426666666666665,-0.0008866666666666667,-0.00632,-0.023173333333333334,0.0,-0.003106666666666667,-10
3162,190000,1,1,2,47,-1,-1,-1,-1,-1,-1,314,3031,597,1640,306,39506,3031,597,1648,306,39506,697,0,-2717,2434,-1051,1334,-39200,38809,-0.0143,0.012810526315789474,-0.005531578947368421,0.007021052631578947,-0.2063157894736842,0.2042578947368421,-6
3163,50000,1,1,2,23,0,0,0,0,0,0,49711,50820,41981,2888,2640,2140,2019,2564,1000,0,500,6859,0,47692,48256,40981,2888,2140,-4719,0.95384,0.96512,0.81962,0.05776,0.0428,-0.09438,0
3164,50000,0,3,1,32,0,0,0,0,0,-2,46727,47973,48990,49261,0,0,2000,2005,1745,0,0,0,1,44727,45968,47245,49261,0,0,0.89454,0.91936,0.9449,0.98522,0.0,0.0,-2
3165,60000,1,1,2,27,-1,-1,2,0,0,0,1130,7,7,11965,11958,12069,7,0,11958,0,611,0,0,1123,7,-11951,11965,11347,12069,0.018716666666666666,0.00011666666666666667,-0.19918333333333332,0.19941666666666666,0.18911666666666666,0.20115,0
3166,200000,0,1,1,58,-2,-2,-2,-2,-2,-2,0,0,0,0,0,0,0,0,0,0,0,0,1,0,0,0,0,0,0,0.0,0.0,0.0,0.0,0.0,0.0,-12
3167,20000,0,2,1,43,2,2,2,2,0,0,17233,18639,20035,19333,18135,14366,2000,2000,0,1000,500,1950,1,15233,16639,20035,18333,17635,12416,0.76165,0.83195,1.00175,0.91665,0.88175,0.6208,8
3168,200000,0,1,1,34,-2,-2,-2,-2,-2,-2,7468,5023,618,605,3098,805,5048,621,608,3114,1003,2164,1,2420,4402,10,-2509,2095,-1359,0.0121,0.02201,5e-05,-0.012545,0.010475,-0.006795,-12
3169,320000,1,2,1,53,0,0,0,0,0,0,8513,151835,153327,155528,158745,161937,150000,8510,5000,4500,4544,5000,1,-141487,143325,148327,151028,154201,156937,-0.442146875,0.447890625,0.463521875,0.4719625,0.481878125,0.490428125,0
3170,480000,0,3,1,46,0,0,0,0,0,2,277803,287770,296399,314867,331653,324093,16000,15000,25000,22000,5000,10000,1,261803,272770,271399,292867,326653,314093,0.5454229166666666,0.5682708333333333,0.5654145833333334,0.6101395833333333,0.6805270833333333,0.6543604166666667,2
3171,500000,1,1,1,49,-1,-1,-1,-1,-1,-1,4007,9933,14557,53328,58052,37435,10021,14576,53850,58332,37616,46591,1,-6014,-4643,-39293,-5004,20436,-9156,-0.012028,-0.009286,-0.078586,-0.010008,0.040872,-0.018312,-6
3172,70000,1,2,1,33,0,0,0,0,0,-1,43981,33439,24926,10681,7431,4705,1683,3160,3000,3000,5060,5032,1,42298,30279,21926,7681,2371,-327,0.6042571428571428,0.43255714285714286,0.3132285714285714,0.10972857142857143,0.03387142857142857,-0.004671428571428571,-1
3173,50000,0,2,2,23,2,2,0,0,0,0,52156,51041,50205,20218,20263,19864,0,1310,705,750,730,700,0,52156,49731,49500,19468,19533,19164,1.04312,0.99462,0.99,0.38936,0.39066,0.38328,4
3174,140000,1,1,2,32,0,0,0,0,2,2,142043,0,137909,138999,137275,136141,7000,0,5000,9100,3400,0,0,135043,0,132909,129899,133875,136141,0.9645928571428571,0.0,0.94935,0.92785,0.95625,0.9724357142857143,4
3175,30000,1,3,2,40,-1,2,-1,0,-1,-1,780,390,650,260,370,-20,0,650,0,500,0,800,0,780,-260,650,-240,370,-820,0.026,-0.008666666666666666,0.021666666666666667,-0.008,0.012333333333333333,-0.027333333333333334,-2
3176,210000,0,1,1,52,0,0,0,-1,-1,-1,44933,38542,39332,11140,8463,10406,1793,8242,12000,8534,11000,7500,1,43140,30300,27332,2606,-2537,2906,0.20542857142857143,0.1442857142857143,0.13015238095238096,0.01240952380952381,-0.012080952380952381,0.013838095238095238,-3
3177,180000,1,2,2,39,0,0,0,0,0,0,166915,117351,115402,105844,98396,101390,6000,7030,8000,5396,5390,5006,0,160915,110321,107402,100448,93006,96384,0.8939722222222222,0.6128944444444444,0.5966777777777778,0.5580444444444445,0.5167,0.5354666666666666,0
3178,30000,1,3,2,22,0,0,-1,0,0,-1,8922,6698,187,1187,0,1405,1275,187,1000,0,1405,623,0,7647,6511,-813,1187,-1405,782,0.2549,0.21703333333333333,-0.0271,0.03956666666666667,-0.04683333333333333,0.026066666666666665,-2
3179,200000,1,2,2,28,-1,-1,-2,-2,-2,-2,1243,0,0,0,0,0,0,0,0,0,0,1434,0,1243,0,0,0,0,-1434,0.006215,0.0,0.0,0.0,0.0,-0.00717,-10
3180,80000,0,2,1,41,0,0,0,0,0,0,15824,12781,9994,10704,9201,6275,2000,2000,4000,1000,1000,1000,1,13824,10781,5994,9704,8201,5275,0.1728,0.1347625,0.074925,0.1213,0.1025125,0.0659375,0
3181,140000,1,2,2,25,0,0,0,0,2,0,33740,34154,21945,23581,23066,23531,1363,1952,2000,0,1000,1018,0,32377,32202,19945,23581,22066,22513,0.23126428571428573,0.23001428571428573,0.1424642857142857,0.16843571428571427,0.1576142857142857,0.16080714285714287,2
3182,30000,0,1,2,29,1,2,2,2,2,2,25264,24560,29128,29845,30257,30779,0,5000,1500,1200,1300,0,0,25264,19560,27628,28645,28957,30779,0.8421333333333333,0.652,0.9209333333333334,0.9548333333333333,0.9652333333333334,1.0259666666666667,11
3183,120000,1,3,1,30,1,2,0,0,0,0,119511,116086,117580,120041,80578,82280,3,4351,5000,3000,3000,3200,1,119508,111735,112580,117041,77578,79080,0.9959,0.931125,0.9381666666666667,0.9753416666666667,0.6464833333333333,0.659,3
3184,50000,0,2,2,29,1,2,2,2,0,0,37170,36297,39863,38924,39744,40533,0,4500,0,1600,1600,1600,0,37170,31797,39863,37324,38144,38933,0.7434,0.63594,0.79726,0.74648,0.76288,0.77866,7
3185,160000,0,1,1,30,-1,0,0,0,0,0,16754,44946,40453,40951,40709,35569,40453,2002,1500,2000,1000,6443,1,-23699,42944,38953,38951,39709,29126,-0.14811875,0.2684,0.24345625,0.24344375,0.24818125,0.1820375,-1
3186,180000,0,1,1,44,0,0,0,0,0,0,18896,20166,16995,15324,6758,5730,2006,6995,282,0,200,0,1,16890,13171,16713,15324,6558,5730,0.09383333333333334,0.07317222222222222,0.09285,0.08513333333333334,0.03643333333333333,0.03183333333333333,0
3187,150000,1,4,2,46,0,0,-1,0,0,-2,4463,3034,1170,1170,0,0,1013,1170,0,0,0,0,0,3450,1864,1170,1170,0,0,0.023,0.012426666666666667,0.0078,0.0078,0.0,0.0,-3
3188,30000,0,2,2,23,0,0,0,0,0,0,27044,28384,29037,29667,29669,29995,2000,1427,1291,1029,1229,549,0,25044,26957,27746,28638,28440,29446,0.8348,0.8985666666666666,0.9248666666666666,0.9546,0.948,0.9815333333333334,0
3189,200000,1,1,1,49,-1,-1,-1,-1,-1,-1,950,950,950,950,0,1900,950,950,950,0,1900,950,1,0,0,0,950,-1900,950,0.0,0.0,0.0,0.00475,-0.0095,0.00475,-6
3190,150000,1,1,2,29,-2,-2,-2,-2,-2,-2,0,0,0,0,0,0,0,0,0,0,0,0,0,0,0,0,0,0,0,0.0,0.0,0.0,0.0,0.0,0.0,-12
3191,50000,1,3,1,35,-1,-1,0,0,0,0,10458,37907,33604,25303,17841,6980,37907,1599,1200,0,0,3570,1,-27449,36308,32404,25303,17841,3410,-0.54898,0.72616,0.64808,0.50606,0.35682,0.0682,-2
3192,350000,0,1,1,35,0,0,2,-1,2,2,19734,5338,3042,2418,2233,7176,3000,0,2500,0,5000,0,1,16734,5338,542,2418,-2767,7176,0.047811428571428574,0.015251428571428572,0.0015485714285714287,0.006908571428571429,-0.007905714285714285,0.020502857142857142,5
3193,50000,1,2,2,31,0,0,0,0,0,2,21704,22741,23867,25464,27348,26774,1400,1500,2000,2620,0,1164,0,20304,21241,21867,22844,27348,25610,0.40608,0.42482,0.43734,0.45688,0.54696,0.5122,2
3194,50000,0,2,2,26,0,0,0,0,0,0,47169,48197,47738,47676,46694,47807,1804,1746,1681,1695,1890,4005,0,45365,46451,46057,45981,44804,43802,0.9073,0.92902,0.92114,0.91962,0.89608,0.87604,0
3195,70000,1,1,2,24,0,0,2,0,0,0,8244,10569,8159,8241,9103,9361,2500,0,1000,1000,409,1000,0,5744,10569,7159,7241,8694,8361,0.08205714285714286,0.15098571428571428,0.10227142857142857,0.10344285714285714,0.1242,0.11944285714285714,2
3196,420000,1,2,2,25,-1,2,0,0,0,-2,2804,2615,3392,4392,-796,-796,0,1000,1000,0,0,20500,0,2804,1615,2392,4392,-796,-21296,0.006676190476190476,0.003845238095238095,0.005695238095238095,0.010457142857142858,-0.0018952380952380952,-0.050704761904761905,-1
3197,20000,0,2,2,28,0,0,0,2,0,0,10926,12899,18394,16806,36070,19257,2500,9000,0,2000,2000,1500,0,8426,3899,18394,14806,34070,17757,0.4213,0.19495,0.9197,0.7403,1.7035,0.88785,2
3198,300000,1,1,1,36,-2,-1,-1,-2,-2,-2,540,1283,843,0,444,0,1283,843,0,444,0,0,1,-743,440,843,-444,444,0,-0.0024766666666666665,0.0014666666666666667,0.00281,-0.00148,0.00148,0.0,-10
3199,200000,1,2,1,52,0,0,0,0,0,0,290122,274868,280828,286702,293038,299317,7100,7500,7500,8000,8000,4500,1,283022,267368,273328,278702,285038,294817,1.41511,1.33684,1.36664,1.39351,1.42519,1.474085,0
3200,160000,1,1,2,30,-2,-2,-2,-2,-1,-1,2000,1000,1000,1000,12234,11960,1000,1000,1000,12234,1200,65157,0,1000,0,0,-11234,11034,-53197,0.00625,0.0,0.0,-0.0702125,0.0689625,-0.33248125,-10
3201,270000,1,4,1,33,-2,-2,-2,-2,-2,-2,0,0,1205,0,0,0,0,1205,0,0,0,0,1,0,-1205,1205,0,0,0,0.0,-0.004462962962962963,0.004462962962962963,0.0,0.0,0.0,-12
3202,60000,0,2,1,46,2,0,0,0,0,0,59748,60684,59532,30193,27726,26520,2500,2108,1008,1160,2000,4000,1,57248,58576,58524,29033,25726,22520,0.9541333333333334,0.9762666666666666,0.9754,0.48388333333333333,0.4287666666666667,0.37533333333333335,2
3203,160000,1,2,2,32,0,0,0,0,0,-1,3826,4751,6604,8604,7072,766,1147,2000,2000,0,766,2303,0,2679,2751,4604,8604,6306,-1537,0.01674375,0.01719375,0.028775,0.053775,0.0394125,-0.00960625,-1
3204,20000,1,2,2,27,0,0,0,0,0,0,7486,7826,9574,12101,17128,13395,2000,4574,5101,5128,3395,5385,0,5486,3252,4473,6973,13733,8010,0.2743,0.1626,0.22365,0.34865,0.68665,0.4005,0
3205,380000,1,2,1,51,1,-2,-2,-2,-1,-1,0,0,0,0,630,1297,0,0,0,630,1613,1618,1,0,0,0,-630,-983,-321,0.0,0.0,0.0,-0.0016578947368421052,-0.002586842105263158,-0.0008447368421052631,-7
3206,20000,0,2,2,25,0,0,0,0,0,2,14989,15999,17043,18236,19376,18958,1263,1307,1500,1408,0,674,0,13726,14692,15543,16828,19376,18284,0.6863,0.7346,0.77715,0.8414,0.9688,0.9142,2
3207,10000,0,3,2,45,1,2,2,2,0,0,9503,7238,9407,8126,8838,9039,0,2310,0,1000,500,335,0,9503,4928,9407,7126,8338,8704,0.9503,0.4928,0.9407,0.7126,0.8338,0.8704,7
3208,340000,1,2,2,25,-2,-2,-2,-2,-2,-2,-2,-2,466,-3,1292,586,0,468,0,649,1178,0,0,-2,-470,466,-652,114,586,-5.882352941176471e-06,-0.0013823529411764706,0.0013705882352941176,-0.0019176470588235294,0.00033529411764705885,0.0017235294117647058,-12
3209,170000,1,2,1,42,-1,-1,-1,-1,-1,-1,415,415,415,415,1215,1390,415,415,415,1215,1390,1215,1,0,0,0,-800,-175,175,0.0,0.0,0.0,-0.004705882352941176,-0.0010294117647058824,0.0010294117647058824,-6
3210,50000,1,2,2,37,1,2,0,0,0,0,26305,25583,26649,27584,28135,28878,0,1481,1416,967,1156,1000,0,26305,24102,25233,26617,26979,27878,0.5261,0.48204,0.50466,0.53234,0.53958,0.55756,3
3211,10000,0,2,2,27,1,-1,0,0,0,0,-2000,2475,4428,6368,9046,10000,4475,2000,2000,2780,2000,0,0,-6475,475,2428,3588,7046,10000,-0.6475,0.0475,0.2428,0.3588,0.7046,1.0,0
3212,350000,1,1,2,46,-1,-1,-1,-2,-2,-2,5372,12179,0,0,0,0,12277,0,0,0,0,0,0,-6905,12179,0,0,0,0,-0.01972857142857143,0.03479714285714286,0.0,0.0,0.0,0.0,-9
3213,50000,0,2,2,46,0,0,0,0,0,0,29254,26289,21751,20154,16784,17352,1737,1300,668,8000,1000,3100,0,27517,24989,21083,12154,15784,14252,0.55034,0.49978,0.42166,0.24308,0.31568,0.28504,0
3214,50000,1,3,1,32,0,0,0,0,0,0,33231,34544,35976,15996,32714,16720,1868,2300,1239,600,600,600,1,31363,32244,34737,15396,32114,16120,0.62726,0.64488,0.69474,0.30792,0.64228,0.3224,0
3215,360000,1,1,1,41,-2,-2,-2,-2,-2,-2,0,0,0,0,0,0,0,0,0,0,0,0,1,0,0,0,0,0,0,0.0,0.0,0.0,0.0,0.0,0.0,-12
3216,220000,0,1,2,37,2,2,0,0,0,0,185955,181587,186054,188465,192758,196493,0,9000,7000,7500,7100,7500,0,185955,172587,179054,180965,185658,188993,0.84525,0.7844863636363636,0.8138818181818182,0.8225681818181818,0.8439,0.8590590909090909,4
3217,250000,1,1,2,27,0,-1,-1,-2,-2,-2,8769,990,0,0,955,8175,990,0,0,955,8200,2434,0,7779,990,0,-955,-7245,5741,0.031116,0.00396,0.0,-0.00382,-0.02898,0.022964,-8
3218,170000,0,2,2,24,0,0,0,0,0,0,108717,69632,56537,113576,138419,101452,8092,20121,100071,50122,6468,278311,0,100625,49511,-43534,63454,131951,-176859,0.5919117647058824,0.2912411764705882,-0.2560823529411765,0.37325882352941175,0.7761823529411764,-1.0403470588235295,0
3219,160000,1,1,2,27,0,0,-2,-1,-1,-1,13234,0,6000,15866,4168,2067,0,6000,15866,4168,2067,11826,0,13234,-6000,-9866,11698,2101,-9759,0.0827125,-0.0375,-0.0616625,0.0731125,0.01313125,-0.06099375,-5
3220,180000,1,2,1,29,0,0,0,0,0,0,26000,26310,26662,26166,26176,25442,1800,1500,1056,950,1000,1050,1,24200,24810,25606,25216,25176,24392,0.13444444444444445,0.13783333333333334,0.14225555555555555,0.1400888888888889,0.13986666666666667,0.1355111111111111,0
3221,50000,1,1,1,35,1,-1,-1,0,0,-2,0,354,134,134,0,0,354,134,0,0,0,190,1,-354,220,134,134,0,-190,-0.00708,0.0044,0.00268,0.00268,0.0,-0.0038,-3
3222,300000,0,2,1,38,-1,-1,-1,0,0,-1,374,1685,1485,990,495,495,2000,1485,0,0,495,495,1,-1626,200,1485,990,0,0,-0.00542,0.0006666666666666666,0.00495,0.0033,0.0,0.0,-4
3223,150000,1,2,2,40,0,0,0,0,0,0,76282,78800,67443,68720,70572,72275,3705,4000,3000,3000,3000,4000,0,72577,74800,64443,65720,67572,68275,0.48384666666666665,0.49866666666666665,0.42962,0.4381333333333333,0.45048,0.45516666666666666,0
3224,20000,1,2,2,38,1,4,3,2,0,0,21769,21139,20521,19817,14932,10812,0,0,0,448,380,345,0,21769,21139,20521,19369,14552,10467,1.08845,1.05695,1.02605,0.96845,0.7276,0.52335,10
3225,90000,1,2,1,55,2,2,0,0,0,0,81998,83674,80890,31565,33049,22694,4003,3000,3000,3000,2000,2000,1,77995,80674,77890,28565,31049,20694,0.8666111111111111,0.8963777777777778,0.8654444444444445,0.3173888888888889,0.3449888888888889,0.22993333333333332,4
3226,270000,1,3,1,43,0,0,0,0,0,0,46107,42151,40546,36822,31700,29133,1700,1700,1500,1100,1200,1200,1,44407,40451,39046,35722,30500,27933,0.16447037037037038,0.14981851851851852,0.1446148148148148,0.1323037037037037,0.11296296296296296,0.10345555555555555,0
3227,380000,1,3,2,39,0,0,0,0,0,0,55241,49773,81365,87341,87358,103740,10000,60218,10076,15012,20667,15000,0,45241,-10445,71289,72329,66691,88740,0.11905526315789473,-0.027486842105263157,0.18760263157894738,0.19033947368421053,0.17550263157894735,0.2335263157894737,0
3228,50000,1,1,2,24,-2,-2,-2,-2,-2,-2,220,220,677,1200,666,1480,220,677,1200,666,1480,3710,0,0,-457,-523,534,-814,-2230,0.0,-0.00914,-0.01046,0.01068,-0.01628,-0.0446,-12
3229,200000,1,2,2,29,-1,0,0,0,0,0,3334,4772,7675,10519,6980,8702,1500,3000,3000,1000,2000,2000,0,1834,1772,4675,9519,4980,6702,0.00917,0.00886,0.023375,0.047595,0.0249,0.03351,-1
3230,90000,1,2,1,25,0,0,0,0,0,0,57846,50663,45515,42599,38559,36337,2018,2033,2016,2010,2010,1114,1,55828,48630,43499,40589,36549,35223,0.6203111111111111,0.5403333333333333,0.4833222222222222,0.4509888888888889,0.4061,0.39136666666666664,0
3231,310000,0,2,2,33,-2,-2,-2,-2,-2,-2,4040,4048,3959,205,3199,5104,4068,3964,205,3209,5109,1434,0,-28,84,3754,-3004,-1910,3670,-9.032258064516129e-05,0.00027096774193548386,0.012109677419354838,-0.009690322580645162,-0.006161290322580645,0.011838709677419354,-12
3232,180000,1,2,2,34,0,0,0,0,0,0,41699,42812,44132,24594,25686,26780,1800,2100,1500,1500,1500,1200,0,39899,40712,42632,23094,24186,25580,0.22166111111111111,0.22617777777777778,0.23684444444444444,0.1283,0.13436666666666666,0.1421111111111111,0
3233,500000,0,1,2,35,-1,-1,-1,-1,-1,-2,4814,12939,19502,128406,-200,-200,13275,19522,128406,0,0,0,0,-8461,-6583,-108904,128406,-200,-200,-0.016922,-0.013166,-0.217808,0.256812,-0.0004,-0.0004,-7
3234,360000,1,2,1,59,1,-2,-2,-2,-2,-2,0,0,0,0,0,0,0,0,0,0,0,0,1,0,0,0,0,0,0,0.0,0.0,0.0,0.0,0.0,0.0,-9
3235,500000,0,1,2,30,0,0,0,0,0,0,192257,201402,444462,418237,424244,383145,40000,300018,15000,17000,15000,11100,0,152257,-98616,429462,401237,409244,372045,0.304514,-0.197232,0.858924,0.802474,0.818488,0.74409,0
3236,360000,1,2,1,33,0,0,-2,-1,-1,-1,3177,0,0,1672,0,986,0,0,1672,0,986,780,1,3177,0,-1672,1672,-986,206,0.008825,0.0,-0.004644444444444444,0.004644444444444444,-0.002738888888888889,0.0005722222222222222,-5
3237,100000,1,2,1,25,0,0,0,0,0,0,99203,97294,99377,101577,99453,101879,3485,3654,3900,3729,4200,3702,1,95718,93640,95477,97848,95253,98177,0.95718,0.9364,0.95477,0.97848,0.95253,0.98177,0
3238,300000,0,2,1,38,0,0,0,2,2,2,181387,171685,181780,177363,189423,188567,8000,14500,0,15150,7700,0,1,173387,157185,181780,162213,181723,188567,0.5779566666666667,0.52395,0.6059333333333333,0.54071,0.6057433333333333,0.6285566666666667,6
3239,190000,0,3,1,29,-2,-2,-2,-2,-2,-2,51632,9803,3427,924,-876,-969,1000,3524,929,869,7,1587,1,50632,6279,2498,55,-883,-2556,0.26648421052631577,0.03304736842105263,0.013147368421052632,0.00028947368421052634,-0.004647368421052632,-0.013452631578947369,-12
3240,90000,1,1,2,28,2,3,2,0,0,2,88627,86357,84131,85225,90347,85725,0,0,3400,6500,0,3301,0,88627,86357,80731,78725,90347,82424,0.9847444444444444,0.9595222222222223,0.8970111111111111,0.8747222222222222,1.0038555555555555,0.9158222222222222,9
3241,50000,1,2,1,39,2,2,2,2,0,0,78874,74268,66468,56847,50680,26729,4725,1400,0,1545,2022,51000,1,74149,72868,66468,55302,48658,-24271,1.48298,1.45736,1.32936,1.10604,0.97316,-0.48542,8
3242,280000,1,2,2,25,1,2,-1,-1,-1,-1,6714,4526,3868,389,389,384,22,4277,390,390,385,166196,0,6692,249,3478,-1,4,-165812,0.0239,0.0008892857142857143,0.012421428571428571,-3.5714285714285714e-06,1.4285714285714285e-05,-0.5921857142857143,-1
3243,380000,1,2,1,30,-2,-2,-2,-2,-2,-2,3745,738,1175,576,576,-2,745,1180,578,578,0,580,1,3000,-442,597,-2,576,-582,0.007894736842105263,-0.001163157894736842,0.0015710526315789474,-5.263157894736842e-06,0.0015157894736842106,-0.0015315789473684211,-12
3244,100000,1,1,1,49,1,2,0,0,0,2,103307,97590,99560,95952,98744,97896,0,4700,4400,6000,2000,4000,1,103307,92890,95160,89952,96744,93896,1.03307,0.9289,0.9516,0.89952,0.96744,0.93896,5
3245,200000,1,1,1,36,-2,-2,-2,-2,-2,-2,588,608,4695,2008,164,3383,608,4695,2008,164,3383,4331,1,-20,-4087,2687,1844,-3219,-948,-0.0001,-0.020435,0.013435,0.00922,-0.016095,-0.00474,-12
3246,440000,1,1,1,35,0,0,0,0,0,0,128808,133340,133075,109705,111202,116169,10000,5000,5000,7126,10000,10000,1,118808,128340,128075,102579,101202,106169,0.2700181818181818,0.2916818181818182,0.29107954545454545,0.2331340909090909,0.23000454545454546,0.24129318181818182,0
3247,200000,1,2,1,50,-2,-1,0,0,-1,0,3414,6640,7428,10234,5380,7532,6640,1025,10249,5380,5000,2261,1,-3226,5615,-2821,4854,380,5271,-0.01613,0.028075,-0.014105,0.02427,0.0019,0.026355,-4
3248,450000,0,1,1,34,-2,-2,-2,-2,-2,-2,-9,1844,0,0,0,0,1853,0,0,0,0,0,1,-1862,1844,0,0,0,0,-0.0041377777777777775,0.0040977777777777774,0.0,0.0,0.0,0.0,-12
3249,50000,1,3,1,45,0,0,0,0,0,0,49212,42376,20009,20877,19642,18769,1611,1700,1547,785,1000,888,1,47601,40676,18462,20092,18642,17881,0.95202,0.81352,0.36924,0.40184,0.37284,0.35762,0
3250,160000,0,1,1,51,2,3,2,0,0,0,79244,77441,75598,82277,84955,87549,0,0,8000,4000,4000,4000,1,79244,77441,67598,78277,80955,83549,0.495275,0.48400625,0.4224875,0.48923125,0.50596875,0.52218125,7
3251,60000,1,1,2,28,1,2,2,-2,-2,-1,21501,20650,0,0,0,2285,0,0,0,0,2285,0,0,21501,20650,0,0,-2285,2285,0.35835,0.3441666666666667,0.0,0.0,-0.03808333333333333,0.03808333333333333,0
3252,20000,0,2,1,36,2,2,2,0,0,0,9735,12564,12077,12779,13033,13308,3000,0,1212,466,485,900,1,6735,12564,10865,12313,12548,12408,0.33675,0.6282,0.54325,0.61565,0.6274,0.6204,6
3253,170000,1,3,1,40,0,0,0,0,0,0,73784,73815,53032,29086,93786,92728,3663,3426,1317,93276,3197,3185,1,70121,70389,51715,-64190,90589,89543,0.4124764705882353,0.41405294117647057,0.30420588235294116,-0.37758823529411767,0.5328764705882353,0.5267235294117647,0
3254,140000,1,2,1,38,0,0,2,0,0,0,84539,96604,90785,95736,95912,97070,18000,0,10000,5000,6000,6000,1,66539,96604,80785,90736,89912,91070,0.47527857142857144,0.6900285714285714,0.5770357142857143,0.6481142857142858,0.6422285714285715,0.6505,2
3255,60000,1,2,2,26,0,0,0,0,2,2,48867,49979,51316,54046,55036,53985,2200,2470,4200,2000,0,6200,0,46667,47509,47116,52046,55036,47785,0.7777833333333334,0.7918166666666666,0.7852666666666667,0.8674333333333333,0.9172666666666667,0.7964166666666667,4
3256,360000,1,2,1,49,-1,-1,-1,-1,-1,-1,801,908,1081,1538,0,804,913,1081,1538,0,804,200,1,-112,-173,-457,1538,-804,604,-0.0003111111111111111,-0.0004805555555555556,-0.0012694444444444444,0.004272222222222222,-0.0022333333333333333,0.0016777777777777778,-6
3257,200000,0,2,1,65,-1,-1,-1,-1,-1,-1,1269,3784,5755,2255,8014,3635,3789,5860,2282,8042,3640,4850,1,-2520,-2076,3473,-5787,4374,-1215,-0.0126,-0.01038,0.017365,-0.028935,0.02187,-0.006075,-6
3258,50000,0,2,1,57,4,3,2,0,0,0,51187,50106,48608,19600,20000,0,0,0,392,400,0,0,1,51187,50106,48216,19200,20000,0,1.02374,1.00212,0.96432,0.384,0.4,0.0,9
3259,70000,1,2,2,26,0,0,0,0,0,-1,50680,51256,47394,7879,-1940,27545,2000,1500,0,0,30000,656,0,48680,49756,47394,7879,-31940,26889,0.6954285714285714,0.7108,0.6770571428571428,0.11255714285714286,-0.4562857142857143,0.38412857142857143,-1
3260,20000,0,1,2,31,-1,-1,-1,-1,-1,-1,1261,390,390,390,0,780,390,390,390,0,780,0,0,871,0,0,390,-780,780,0.04355,0.0,0.0,0.0195,-0.039,0.039,-6
3261,30000,0,2,2,44,1,-2,-2,-2,-2,-2,0,0,0,0,0,0,0,0,0,0,0,0,0,0,0,0,0,0,0,0.0,0.0,0.0,0.0,0.0,0.0,-9
3262,30000,1,2,1,42,0,0,0,0,0,0,22943,47912,25023,25768,26410,27960,1700,1755,1500,1000,1909,1000,1,21243,46157,23523,24768,24501,26960,0.7081,1.5385666666666666,0.7841,0.8256,0.8167,0.8986666666666666,0
3263,110000,1,1,2,26,0,0,0,0,0,0,103705,94786,94708,83765,73122,74366,3500,3500,3000,3700,12488,100,0,100205,91286,91708,80065,60634,74266,0.9109545454545455,0.8298727272727273,0.833709090909091,0.7278636363636364,0.5512181818181818,0.6751454545454545,0
3264,160000,1,2,1,35,0,0,0,0,0,0,17742,12939,7035,4596,4635,2744,2000,1000,500,1000,1000,2000,1,15742,11939,6535,3596,3635,744,0.0983875,0.07461875,0.04084375,0.022475,0.02271875,0.00465,0
3265,130000,1,1,1,43,-2,-2,-2,-2,-2,-2,2798,2732,8072,5723,6232,8873,3228,8141,5744,6232,8873,3982,1,-430,-5409,2328,-509,-2641,4891,-0.0033076923076923075,-0.04160769230769231,0.01790769230769231,-0.003915384615384616,-0.020315384615384617,0.037623076923076926,-12
3266,300000,1,1,1,38,-2,-2,-2,-2,-2,-2,390,0,0,0,0,0,0,0,0,0,0,1100,1,390,0,0,0,0,-1100,0.0013,0.0,0.0,0.0,0.0,-0.0036666666666666666,-12
3267,200000,1,2,1,46,1,2,2,0,0,2,30783,33017,30413,32582,34727,36036,3058,0,3000,3000,2002,0,1,27725,33017,27413,29582,32725,36036,0.138625,0.165085,0.137065,0.14791,0.163625,0.18018,7
3268,250000,1,2,1,45,-1,0,0,0,-1,-1,3233,13244,12462,8977,1503,96834,12716,12158,8777,1503,96834,2204,1,-9483,1086,3685,7474,-95331,94630,-0.037932,0.004344,0.01474,0.029896,-0.381324,0.37852,-3
3269,330000,0,1,2,32,0,0,-2,-2,-2,-2,16352,0,0,0,0,0,0,0,0,0,0,0,0,16352,0,0,0,0,0,0.04955151515151515,0.0,0.0,0.0,0.0,0.0,-8
3270,210000,1,2,1,47,0,0,0,0,0,0,17952,18894,20296,21704,24086,26414,1500,2000,2000,3000,3000,1000,1,16452,16894,18296,18704,21086,25414,0.07834285714285714,0.08044761904761905,0.08712380952380952,0.08906666666666667,0.10040952380952381,0.12101904761904762,0
3271,280000,0,2,1,33,0,0,0,0,0,-1,22331,22341,23359,23647,-1353,93696,1371,1389,1175,0,95049,3308,1,20960,20952,22184,23647,-96402,90388,0.07485714285714286,0.07482857142857142,0.07922857142857143,0.08445357142857143,-0.3442928571428571,0.3228142857142857,-1
3272,20000,1,2,1,30,1,-2,-1,2,2,-2,0,0,780,780,0,0,0,780,0,0,0,0,1,0,-780,780,780,0,0,0.0,-0.039,0.039,0.039,0.0,0.0,0
3273,50000,1,3,1,52,0,0,0,0,-1,2,22377,23380,24488,25775,1080,540,1380,1488,1775,1080,0,540,1,20997,21892,22713,24695,1080,0,0.41994,0.43784,0.45426,0.4939,0.0216,0.0,1
3274,240000,1,2,1,32,0,0,0,0,-2,-2,153104,102049,105086,0,0,0,4500,5014,0,0,0,1418,1,148604,97035,105086,0,0,-1418,0.6191833333333333,0.4043125,0.43785833333333335,0.0,0.0,-0.005908333333333333,-4
3275,260000,1,2,2,28,-1,0,0,0,0,0,75841,69490,67107,28081,12767,4200,3008,2005,3036,5000,2200,1000,0,72833,67485,64071,23081,10567,3200,0.28012692307692305,0.2595576923076923,0.24642692307692307,0.08877307692307693,0.04064230769230769,0.012307692307692308,-1
3276,230000,0,2,1,39,1,-1,2,0,0,-1,-430,16659,1982,1982,991,5400,18675,0,991,0,5400,0,1,-19105,16659,991,1982,-4409,5400,-0.08306521739130435,0.0724304347826087,0.004308695652173913,0.008617391304347827,-0.019169565217391306,0.023478260869565216,1
3277,50000,1,1,2,29,0,0,0,0,-1,0,22120,14577,16275,23790,2250,2100,4000,3096,12000,2250,500,0,0,18120,11481,4275,21540,1750,2100,0.3624,0.22962,0.0855,0.4308,0.035,0.042,-1
3278,350000,0,1,2,33,-2,-2,-2,-1,0,0,6015,8751,686,430667,161089,119339,8797,691,238241,1009,596,10356,0,-2782,8060,-237555,429658,160493,108983,-0.007948571428571428,0.02302857142857143,-0.6787285714285715,1.2275942857142856,0.45855142857142855,0.31138,-7
3279,210000,1,1,2,46,-1,-1,-1,0,0,-1,15655,3918,29881,24247,21664,1556,4854,30366,0,433,1556,14047,0,10801,-26448,29881,23814,20108,-12491,0.05143333333333333,-0.12594285714285713,0.1422904761904762,0.1134,0.09575238095238095,-0.059480952380952384,-4
3280,150000,1,1,2,33,-2,-2,-2,-2,-2,-2,24393,26847,32702,33459,27800,2261,27007,32715,33475,27808,2261,169465,0,-2614,-5868,-773,5651,25539,-167204,-0.017426666666666667,-0.03912,-0.0051533333333333336,0.037673333333333336,0.17026,-1.1146933333333333,-12
3281,100000,0,1,1,37,0,0,0,0,0,0,99516,87274,96414,74161,45585,40178,10184,20000,5150,5000,10000,10000,1,89332,67274,91264,69161,35585,30178,0.89332,0.67274,0.91264,0.69161,0.35585,0.30178,0
3282,250000,0,1,2,30,-2,-2,-2,-2,-2,-2,2729,2538,6244,1297,1763,1907,2543,6247,1300,1766,1912,1000,0,186,-3709,4944,-469,-149,907,0.000744,-0.014836,0.019776,-0.001876,-0.000596,0.003628,-12
3283,100000,1,2,1,35,-1,-1,-1,0,0,-1,29048,0,4069,37069,20233,22227,0,4069,33000,20000,22227,20000,1,29048,-4069,-28931,17069,-1994,2227,0.29048,-0.04069,-0.28931,0.17069,-0.01994,0.02227,-4
3284,210000,1,1,2,33,0,0,-2,-2,-2,-2,6309,0,0,0,0,0,0,0,0,0,0,0,0,6309,0,0,0,0,0,0.030042857142857142,0.0,0.0,0.0,0.0,0.0,-8
3285,110000,1,3,1,46,0,0,2,2,0,0,94025,101460,102724,100188,102110,107014,8942,3800,0,3685,6580,4703,1,85083,97660,102724,96503,95530,102311,0.7734818181818182,0.8878181818181818,0.9338545454545455,0.8773,0.8684545454545455,0.9301,4
3286,500000,1,1,2,29,0,0,0,0,0,0,33107,34773,35426,28479,15729,7905,7000,6664,1500,501,5000,3000,0,26107,28109,33926,27978,10729,4905,0.052214,0.056218,0.067852,0.055956,0.021458,0.00981,0
3287,750000,1,1,2,28,1,-1,-1,0,0,-1,9500,9655,401003,399493,400993,409483,250000,401003,7990,11000,417990,3080,0,-240500,-391348,393013,388493,-16997,406403,-0.32066666666666666,-0.5217973333333333,0.5240173333333333,0.5179906666666667,-0.022662666666666668,0.5418706666666666,-2
3288,80000,1,2,2,24,0,0,0,0,0,0,72383,73620,53728,31989,20058,196,3500,2354,2027,800,196,184,0,68883,71266,51701,31189,19862,12,0.8610375,0.890825,0.6462625,0.3898625,0.248275,0.00015,0
3289,90000,1,2,2,26,0,0,0,2,0,0,86183,87561,92996,89866,48574,41746,4100,8548,0,1527,1617,1490,0,82083,79013,92996,88339,46957,40256,0.9120333333333334,0.8779222222222223,1.033288888888889,0.9815444444444444,0.5217444444444445,0.4472888888888889,2
3290,160000,0,1,2,33,2,2,2,2,2,2,101430,103870,106719,107485,108326,110635,5000,6000,4000,4100,4200,4200,0,96430,97870,102719,103385,104126,106435,0.6026875,0.6116875,0.64199375,0.64615625,0.6507875,0.66521875,12
3291,320000,1,1,2,29,-2,-1,2,-1,-1,-1,0,192,192,2518,255,1945,192,0,2518,255,1945,301,0,-192,192,-2326,2263,-1690,1644,-0.0006,0.0006,-0.00726875,0.007071875,-0.00528125,0.0051375,-4
3292,200000,0,2,2,32,0,0,0,0,0,0,196550,178609,180357,168935,88883,88973,8001,6500,6146,3300,2476,5749,0,188549,172109,174211,165635,86407,83224,0.942745,0.860545,0.871055,0.828175,0.432035,0.41612,0
3293,150000,1,2,2,24,1,2,0,0,0,0,170971,165806,146001,113907,115578,111863,39,6000,3937,4077,4504,23066,0,170932,159806,142064,109830,111074,88797,1.1395466666666667,1.0653733333333333,0.9470933333333333,0.7322,0.7404933333333333,0.59198,3
3294,180000,0,1,2,39,-2,-2,-2,-2,-2,-2,0,444,182,0,0,0,444,182,0,0,0,540,0,-444,262,182,0,0,-540,-0.0024666666666666665,0.0014555555555555556,0.001011111111111111,0.0,0.0,-0.003,-12
3295,180000,1,1,2,30,-1,-1,-1,-1,-2,-1,1650,196,2500,0,0,3650,196,2500,0,0,3650,3859,0,1454,-2304,2500,0,-3650,-209,0.008077777777777777,-0.0128,0.013888888888888888,0.0,-0.020277777777777777,-0.001161111111111111,-7
3296,10000,0,2,2,27,2,2,2,0,0,2,6743,9060,8768,9465,10212,10198,2600,0,1000,900,300,0,0,4143,9060,7768,8565,9912,10198,0.4143,0.906,0.7768,0.8565,0.9912,1.0198,8
3297,200000,1,3,1,48,-2,-2,-2,-2,-2,-2,119139,5844,3666,37005,47376,1292,5844,3694,37177,47376,1292,46626,1,113295,2150,-33511,-10371,46084,-45334,0.566475,0.01075,-0.167555,-0.051855,0.23042,-0.22667,-12
3298,200000,0,2,1,41,1,2,2,2,2,-1,11201,1383,976,1126,563,413,980,0,563,0,413,2513,1,10221,1383,413,1126,150,-2100,0.051105,0.006915,0.002065,0.00563,0.00075,-0.0105,8
3299,60000,1,1,2,36,-1,2,-1,0,0,-1,2130,1940,7801,1308,3058,2190,0,7801,1158,1900,2190,2153,0,2130,-5861,6643,-592,868,37,0.0355,-0.09768333333333333,0.11071666666666667,-0.009866666666666666,0.014466666666666666,0.0006166666666666666,-1
3300,300000,1,1,2,27,-1,-1,-1,-1,0,0,4850,42189,83754,120927,105303,82475,42198,83754,120927,0,716,25213,0,-37348,-41565,-37173,120927,104587,57262,-0.12449333333333333,-0.13855,-0.12391,0.40309,0.34862333333333334,0.19087333333333334,-4
3301,50000,0,3,2,41,0,0,2,-1,0,0,48238,35194,9802,26781,28542,29235,4866,126,58542,3032,2000,2000,0,43372,35068,-48740,23749,26542,27235,0.86744,0.70136,-0.9748,0.47498,0.53084,0.5447,1
3302,90000,1,1,1,44,-1,-1,-2,-2,-2,-2,539,0,0,0,0,0,0,0,0,0,0,0,1,539,0,0,0,0,0,0.005988888888888889,0.0,0.0,0.0,0.0,0.0,-10
3303,260000,0,2,1,51,-2,-2,-2,-2,-2,-2,0,0,0,0,0,0,0,0,0,0,0,0,1,0,0,0,0,0,0,0.0,0.0,0.0,0.0,0.0,0.0,-12
3304,140000,0,2,2,39,1,-1,0,-1,0,0,10091,18324,8808,27319,19278,11505,18539,1000,27329,386,1000,16215,0,-8448,17324,-18521,26933,18278,-4710,-0.06034285714285714,0.12374285714285714,-0.13229285714285716,0.19237857142857143,0.13055714285714284,-0.03364285714285714,-1
3305,130000,1,2,2,29,-1,-1,2,0,0,-1,1110,1170,780,390,0,780,1170,0,0,0,780,0,0,-60,1170,780,390,-780,780,-0.00046153846153846153,0.009,0.006,0.003,-0.006,0.006,-1
3306,30000,0,3,2,38,1,2,0,0,0,0,30771,29975,27541,27785,28839,29412,0,2000,1000,1500,1052,591,0,30771,27975,26541,26285,27787,28821,1.0257,0.9325,0.8847,0.8761666666666666,0.9262333333333334,0.9607,3
3307,80000,0,3,1,38,-1,-1,2,0,-1,2,6270,14412,12540,1261,2705,1261,19421,0,0,2705,0,1261,1,-13151,14412,12540,-1444,2705,0,-0.1643875,0.18015,0.15675,-0.01805,0.0338125,0.0,1
3308,30000,1,2,1,42,0,0,0,0,0,2,27276,30470,27699,28257,30695,30059,3671,1500,1018,2900,0,869,1,23605,28970,26681,25357,30695,29190,0.7868333333333334,0.9656666666666667,0.8893666666666666,0.8452333333333333,1.0231666666666666,0.973,2
3309,160000,0,1,2,27,-1,-1,-1,-1,-1,-1,11924,0,4477,2682,29011,4000,0,4477,2682,29011,4000,5459,0,11924,-4477,1795,-26329,25011,-1459,0.074525,-0.02798125,0.01121875,-0.16455625,0.15631875,-0.00911875,-6
3310,20000,0,2,1,64,-1,-1,-1,-1,-1,-1,528,0,264,264,255,678,0,264,264,255,687,0,1,528,-264,0,9,-432,678,0.0264,-0.0132,0.0,0.00045,-0.0216,0.0339,-6
3311,230000,1,1,2,45,0,0,0,0,0,0,204625,205816,205294,194263,212257,206084,15006,15026,15000,20000,15030,15030,0,189619,190790,190294,174263,197227,191054,0.8244304347826087,0.8295217391304348,0.8273652173913043,0.7576652173913043,0.8575086956521739,0.8306695652173913,0
3312,220000,1,2,2,28,-1,-1,-2,-2,-2,-2,3700,0,0,0,0,0,0,0,0,0,0,0,0,3700,0,0,0,0,0,0.01681818181818182,0.0,0.0,0.0,0.0,0.0,-10
3313,200000,1,2,1,39,1,-1,0,0,-1,-1,0,21801,62433,-82,16550,5239,21801,42745,0,16632,5265,0,1,-21801,-20944,62433,-16714,11285,5239,-0.109005,-0.10472,0.312165,-0.08357,0.056425,0.026195,-2
3314,80000,1,2,1,27,0,-1,-1,-1,-1,-1,20417,3061,7920,2830,3092,2315,3082,7932,2838,3112,2333,0,1,17335,-4871,5082,-282,759,2315,0.2166875,-0.0608875,0.063525,-0.003525,0.0094875,0.0289375,-5
3315,450000,1,1,1,35,-1,-1,-1,-1,-1,-1,6126,6869,16895,7312,6213,5073,6869,16918,7316,6213,5073,15532,1,-743,-10049,9579,1099,1140,-10459,-0.001651111111111111,-0.02233111111111111,0.021286666666666666,0.0024422222222222224,0.002533333333333333,-0.023242222222222223,-6
3316,30000,0,2,1,53,0,0,0,0,0,0,18112,18456,19004,19030,24541,26305,1329,1267,683,8000,2731,0,1,16783,17189,18321,11030,21810,26305,0.5594333333333333,0.5729666666666666,0.6107,0.36766666666666664,0.727,0.8768333333333334,0
3317,400000,0,1,1,48,-2,-2,-2,-2,-2,-2,3173,4265,8403,9096,28896,52196,4265,8427,9096,28896,52196,396,1,-1092,-4162,-693,-19800,-23300,51800,-0.00273,-0.010405,-0.0017325,-0.0495,-0.05825,0.1295,-12
3318,80000,1,3,1,32,2,0,0,0,2,0,26856,24758,23044,22919,21890,22003,1700,1400,2400,0,1000,1500,1,25156,23358,20644,22919,20890,20503,0.31445,0.291975,0.25805,0.2864875,0.261125,0.2562875,4
3319,140000,1,2,2,27,-1,-1,-2,-2,-2,-2,515,0,0,0,0,0,0,0,0,0,0,0,0,515,0,0,0,0,0,0.0036785714285714286,0.0,0.0,0.0,0.0,0.0,-10
3320,150000,1,2,2,26,-2,-2,-2,-2,-2,-2,37636,27448,29890,390,257,10700,27603,29890,21890,257,10833,212,0,10033,-2442,8000,133,-10576,10488,0.06688666666666666,-0.01628,0.05333333333333334,0.0008866666666666667,-0.07050666666666666,0.06992,-12
3321,50000,1,1,2,27,0,-1,-1,-1,-1,-1,13301,1400,780,390,42958,44849,1400,780,390,42958,3500,0,0,11901,620,390,-42568,39458,44849,0.23802,0.0124,0.0078,-0.85136,0.78916,0.89698,-5
3322,400000,0,1,2,32,-1,-1,-1,-1,0,0,525,1610,566,21373,16663,7873,1610,285,22240,4200,905,4607,0,-1085,1325,-21674,17173,15758,3266,-0.0027125,0.0033125,-0.054185,0.0429325,0.039395,0.008165,-4
3323,100000,1,2,1,28,0,0,0,0,0,0,36428,48850,20904,13955,14573,16084,6000,5000,1000,4000,5000,8000,1,30428,43850,19904,9955,9573,8084,0.30428,0.4385,0.19904,0.09955,0.09573,0.08084,0
3324,240000,1,2,2,30,0,0,0,0,0,0,89009,71169,67528,64238,65521,65829,3071,2390,2311,2330,2392,2504,0,85938,68779,65217,61908,63129,63325,0.358075,0.28657916666666666,0.2717375,0.25795,0.2630375,0.26385416666666667,0
3325,200000,1,2,1,32,-1,-1,-1,-1,-1,-1,5150,10190,10190,10190,10594,11193,10190,10190,10190,10594,11193,10190,1,-5040,0,0,-404,-599,1003,-0.0252,0.0,0.0,-0.00202,-0.002995,0.005015,-6
3326,30000,1,2,2,22,0,0,-1,2,-1,-1,10348,9287,1900,150,2558,2829,1013,1900,0,2558,2829,3000,0,9335,7387,1900,-2408,-271,-171,0.31116666666666665,0.24623333333333333,0.06333333333333334,-0.08026666666666667,-0.009033333333333334,-0.0057,-1
3327,20000,0,2,2,47,1,2,2,2,0,0,8557,8271,11127,10657,11178,11840,0,3000,0,1000,1000,1900,0,8557,5271,11127,9657,10178,9940,0.42785,0.26355,0.55635,0.48285,0.5089,0.497,7
3328,360000,0,1,1,34,-2,-2,-2,-2,-2,-2,2433,1218,505,843,-4,2237,1230,505,843,4,2241,56,1,1203,713,-338,839,-2245,2181,0.003341666666666667,0.0019805555555555557,-0.0009388888888888888,0.0023305555555555558,-0.0062361111111111115,0.006058333333333333,-12
3329,70000,1,3,1,43,2,0,0,0,0,0,46092,40094,39610,31047,27431,16693,1700,1700,1243,1000,500,1000,1,44392,38394,38367,30047,26931,15693,0.6341714285714286,0.5484857142857142,0.5481,0.42924285714285715,0.3847285714285714,0.2241857142857143,2
3330,50000,0,2,2,27,2,-1,-1,-1,-1,2,390,390,780,216,1080,540,390,780,216,864,0,390,0,0,-390,564,-648,1080,150,0.0,-0.0078,0.01128,-0.01296,0.0216,0.003,0
3331,210000,0,3,1,49,0,0,0,0,0,0,27984,27686,29209,28326,26198,25020,1500,2000,1500,1000,1500,1300,1,26484,25686,27709,27326,24698,23720,0.1261142857142857,0.12231428571428571,0.13194761904761904,0.13012380952380953,0.1176095238095238,0.11295238095238096,0
3332,60000,1,3,1,50,-1,-1,-1,-1,-1,-1,2811,297,734,399,670,0,297,737,399,670,0,9398,1,2514,-440,335,-271,670,-9398,0.0419,-0.007333333333333333,0.005583333333333333,-0.004516666666666667,0.011166666666666667,-0.15663333333333335,-6
3333,200000,0,1,2,27,0,0,2,0,0,0,186778,206582,201714,177469,184502,191529,23000,157,10000,10000,10000,17000,0,163778,206425,191714,167469,174502,174529,0.81889,1.032125,0.95857,0.837345,0.87251,0.872645,2
3334,150000,1,1,2,40,-2,-1,-1,-1,-1,-1,798,2305,1036,5022,3938,316,2309,1036,5048,3946,316,314,0,-1511,1269,-4012,1076,3622,2,-0.010073333333333333,0.00846,-0.026746666666666665,0.007173333333333334,0.024146666666666667,1.3333333333333333e-05,-7
3335,200000,1,1,2,27,0,0,0,0,0,0,122923,124653,126355,114881,117213,124793,5704,5930,4000,4003,10033,4400,0,117219,118723,122355,110878,107180,120393,0.586095,0.593615,0.611775,0.55439,0.5359,0.601965,0
3336,50000,0,3,2,47,0,0,0,0,0,0,48593,48653,15433,15037,10527,10736,1278,1469,463,381,383,398,0,47315,47184,14970,14656,10144,10338,0.9463,0.94368,0.2994,0.29312,0.20288,0.20676,0
3337,170000,0,3,1,45,0,0,0,0,0,0,114625,117364,119552,111404,113635,98411,6305,6000,6000,3854,5000,8000,1,108320,111364,113552,107550,108635,90411,0.6371764705882353,0.6550823529411764,0.6679529411764706,0.6326470588235295,0.6390294117647058,0.5318294117647059,0
3338,50000,1,2,1,40,-1,-1,-1,-1,-1,-1,4860,8389,22049,8110,3164,10148,8389,22049,8117,3164,10148,7949,1,-3529,-13660,13932,4946,-6984,2199,-0.07058,-0.2732,0.27864,0.09892,-0.13968,0.04398,-6
3339,10000,1,3,3,48,0,0,0,0,0,0,7065,8148,9199,9558,9136,9392,1200,1200,500,500,500,0,0,5865,6948,8699,9058,8636,9392,0.5865,0.6948,0.8699,0.9058,0.8636,0.9392,0
3340,50000,0,3,1,51,0,0,0,0,2,2,38302,39299,40703,44350,43517,46821,1634,2038,4685,0,3982,0,1,36668,37261,36018,44350,39535,46821,0.73336,0.74522,0.72036,0.887,0.7907,0.93642,4
3341,80000,0,1,2,33,0,0,0,0,0,0,75454,77738,77235,76835,34751,0,4100,2000,0,0,0,0,0,71354,75738,77235,76835,34751,0,0.891925,0.946725,0.9654375,0.9604375,0.4343875,0.0,0
3342,440000,1,1,2,35,0,0,0,0,0,0,330759,337794,274075,252584,216547,179221,13100,11000,10000,9000,7100,5500,0,317659,326794,264075,243584,209447,173721,0.7219522727272727,0.7427136363636364,0.6001704545454546,0.5536,0.4760159090909091,0.39482045454545456,0
3343,50000,0,2,2,45,0,0,0,0,0,0,48406,49880,47206,19189,19008,19687,2286,1302,678,695,1000,687,0,46120,48578,46528,18494,18008,19000,0.9224,0.97156,0.93056,0.36988,0.36016,0.38,0
3344,120000,1,2,2,43,-1,-1,-1,-1,-1,-1,316,71316,316,316,2766,1996,71316,316,316,2766,1996,2054,0,-71000,71000,0,-2450,770,-58,-0.5916666666666667,0.5916666666666667,0.0,-0.020416666666666666,0.006416666666666667,-0.00048333333333333334,-6
3345,60000,1,4,2,33,0,0,0,0,0,0,52176,39107,39547,39555,40216,41039,2000,2000,1500,2000,2200,2000,0,50176,37107,38047,37555,38016,39039,0.8362666666666667,0.61845,0.6341166666666667,0.6259166666666667,0.6336,0.65065,0
3346,210000,1,1,3,31,-1,-1,-1,0,0,0,1332,3825,33515,78075,109374,108869,3848,33515,48075,39374,1000,1357,0,-2516,-29690,-14560,38701,108374,107512,-0.01198095238095238,-0.14138095238095238,-0.06933333333333333,0.1842904761904762,0.5160666666666667,0.5119619047619047,-3
3347,240000,1,2,1,36,0,0,0,0,0,0,214122,217850,212593,180867,173780,168880,19000,10000,7000,10000,8000,10000,1,195122,207850,205593,170867,165780,158880,0.8130083333333333,0.8660416666666667,0.8566375,0.7119458333333334,0.69075,0.662,0
3348,150000,0,1,2,27,0,0,0,0,0,0,85500,86009,86108,89006,89775,87725,3956,4031,10006,3266,4040,1698,0,81544,81978,76102,85740,85735,86027,0.5436266666666667,0.54652,0.5073466666666666,0.5716,0.5715666666666667,0.5735133333333333,0
3349,90000,1,3,2,42,0,0,0,0,0,0,91240,92795,93557,47166,48406,49695,4895,4806,1547,3000,3000,1720,0,86345,87989,92010,44166,45406,47975,0.9593888888888888,0.9776555555555556,1.0223333333333333,0.49073333333333335,0.5045111111111111,0.5330555555555555,0
3350,150000,1,2,1,28,0,0,0,0,0,0,97069,100743,103528,105623,106583,108909,5300,5300,5300,4200,4200,4200,1,91769,95443,98228,101423,102383,104709,0.6117933333333333,0.6362866666666667,0.6548533333333333,0.6761533333333334,0.6825533333333333,0.69806,0
3351,170000,1,1,1,35,0,0,-1,-1,-1,-1,86239,75600,2800,21881,0,6780,1512,2800,21881,0,6780,530,1,84727,72800,-19081,21881,-6780,6250,0.4983941176470588,0.42823529411764705,-0.11224117647058823,0.12871176470588236,-0.03988235294117647,0.03676470588235294,-4
3352,80000,0,2,2,23,2,0,0,0,0,0,8613,12438,15212,15657,17404,19103,4000,3000,1000,2000,2000,2836,0,4613,9438,14212,13657,15404,16267,0.0576625,0.117975,0.17765,0.1707125,0.19255,0.2033375,2
3353,160000,1,4,2,31,-1,-1,-1,0,-1,-1,1790,0,31568,17638,1285,2705,0,31568,353,1285,2705,0,0,1790,-31568,31215,16353,-1420,2705,0.0111875,-0.1973,0.19509375,0.10220625,-0.008875,0.01690625,-5
3354,150000,0,1,2,26,0,0,0,2,0,0,29712,28045,31732,26989,33624,29786,3200,6300,0,10000,2000,2000,0,26512,21745,31732,16989,31624,27786,0.17674666666666666,0.14496666666666666,0.21154666666666666,0.11326,0.21082666666666666,0.18524,2
3355,30000,1,3,1,46,1,2,2,2,2,2,12289,11806,13268,12758,13549,14673,0,1970,0,1000,1500,0,1,12289,9836,13268,11758,12049,14673,0.40963333333333335,0.32786666666666664,0.44226666666666664,0.39193333333333336,0.40163333333333334,0.4891,11
3356,120000,1,1,1,34,1,-2,-2,-2,-2,-2,0,0,0,0,0,0,0,0,0,0,0,0,1,0,0,0,0,0,0,0.0,0.0,0.0,0.0,0.0,0.0,-9
3357,30000,0,2,1,54,0,0,0,0,3,2,6551,8482,10184,12408,11922,12167,2049,1851,2400,0,587,0,1,4502,6631,7784,12408,11335,12167,0.15006666666666665,0.22103333333333333,0.2594666666666667,0.4136,0.37783333333333335,0.4055666666666667,5
3358,40000,1,2,2,24,0,0,0,0,0,0,38221,34975,19606,21272,22923,24539,3107,3000,2000,2000,2000,0,0,35114,31975,17606,19272,20923,24539,0.87785,0.799375,0.44015,0.4818,0.523075,0.613475,0
3359,50000,0,2,1,40,0,0,0,0,0,0,30211,48389,52230,18887,17693,18074,21190,5144,591,577,609,505,1,9021,43245,51639,18310,17084,17569,0.18042,0.8649,1.03278,0.3662,0.34168,0.35138,0
3360,30000,0,2,1,23,-1,-1,-1,-1,-1,-1,390,390,390,0,780,0,390,390,0,780,0,0,1,0,0,390,-780,780,0,0.0,0.0,0.013,-0.026,0.026,0.0,-6
3361,200000,0,1,1,37,-1,-1,0,0,0,0,2896,10706,10323,8440,4963,10222,10720,3014,1027,2022,10017,2030,1,-7824,7692,9296,6418,-5054,8192,-0.03912,0.03846,0.04648,0.03209,-0.02527,0.04096,-2
3362,120000,0,2,1,44,0,0,0,0,0,0,92007,87939,82094,59105,53442,46775,5417,2847,2066,1919,2200,0,1,86590,85092,80028,57186,51242,46775,0.7215833333333334,0.7091,0.6669,0.47655,0.42701666666666666,0.38979166666666665,0
3363,110000,1,1,2,29,1,2,0,0,0,0,113093,106321,107630,106354,79154,69988,3,4334,4250,2946,2506,2458,0,113090,101987,103380,103408,76648,67530,1.0280909090909092,0.9271545454545455,0.9398181818181818,0.9400727272727273,0.6968,0.613909090909091,3
3364,50000,0,2,1,49,1,2,0,0,0,0,16747,16181,17912,19606,20969,25302,0,2000,2000,2000,5000,0,1,16747,14181,15912,17606,15969,25302,0.33494,0.28362,0.31824,0.35212,0.31938,0.50604,3
3365,200000,1,2,2,38,0,0,0,2,-1,0,18703,9733,7078,1195,43115,43869,1533,2395,0,45000,1600,2000,0,17170,7338,7078,-43805,41515,41869,0.08585,0.03669,0.03539,-0.219025,0.207575,0.209345,1
3366,360000,1,2,2,28,-1,-1,-1,0,0,-2,12393,3434,79795,49160,2847,-13,3445,80401,32083,2907,13,20303,0,8948,-76967,47712,46253,2834,-20316,0.024855555555555554,-0.21379722222222222,0.13253333333333334,0.12848055555555554,0.007872222222222221,-0.056433333333333335,-5
3367,180000,1,2,1,39,-2,-2,-2,-2,-2,-2,0,0,0,0,0,0,0,0,0,0,0,289,1,0,0,0,0,0,-289,0.0,0.0,0.0,0.0,0.0,-0.0016055555555555556,-12
3368,10000,0,2,3,28,0,0,0,0,0,0,5757,6805,7662,8034,8256,8957,1300,1128,500,500,1000,500,0,4457,5677,7162,7534,7256,8457,0.4457,0.5677,0.7162,0.7534,0.7256,0.8457,0
3369,30000,1,2,1,43,2,2,2,2,2,2,28264,28703,26622,24022,24368,20859,2000,1300,2,1608,0,900,1,26264,27403,26620,22414,24368,19959,0.8754666666666666,0.9134333333333333,0.8873333333333333,0.7471333333333333,0.8122666666666667,0.6653,12
3370,150000,1,2,1,24,0,-1,-1,-1,-1,-1,1473,1473,3323,5953,2559,4509,1473,3323,5970,2571,4515,4019,1,0,-1850,-2647,3382,-1956,490,0.0,-0.012333333333333333,-0.017646666666666668,0.022546666666666666,-0.01304,0.003266666666666667,-5
3371,60000,1,2,3,28,0,0,0,0,0,0,34580,15924,18124,28644,18656,15952,1300,2500,1000,1688,1000,1000,0,33280,13424,17124,26956,17656,14952,0.5546666666666666,0.22373333333333334,0.2854,0.44926666666666665,0.2942666666666667,0.2492,0
3372,50000,0,1,2,29,0,0,0,2,0,0,5249,14427,19819,18567,23535,28620,10000,6000,0,5630,6000,5000,0,-4751,8427,19819,12937,17535,23620,-0.09502,0.16854,0.39638,0.25874,0.3507,0.4724,2
3373,140000,1,2,2,50,0,0,0,0,0,0,128949,133778,131241,25994,25769,24552,7000,6000,3000,5000,4000,6000,0,121949,127778,128241,20994,21769,18552,0.8710642857142857,0.9127,0.9160071428571429,0.14995714285714284,0.15549285714285715,0.13251428571428572,0
3374,20000,0,3,1,29,0,0,0,0,0,0,14576,16318,17388,17850,17737,27240,2000,1354,2113,1000,1000,1000,1,12576,14964,15275,16850,16737,26240,0.6288,0.7482,0.76375,0.8425,0.83685,1.312,0
3375,60000,1,2,1,57,0,0,0,0,0,0,20866,22131,22685,24938,25085,28862,2000,2000,2950,926,4600,0,1,18866,20131,19735,24012,20485,28862,0.31443333333333334,0.3355166666666667,0.3289166666666667,0.4002,0.34141666666666665,0.4810333333333333,0
3376,480000,1,3,1,42,-2,-2,-2,-2,-2,-2,7245,0,0,0,790,0,0,0,0,790,0,0,1,7245,0,0,-790,790,0,0.01509375,0.0,0.0,-0.0016458333333333333,0.0016458333333333333,0.0,-12
3377,50000,1,2,1,35,3,2,0,0,0,0,50437,49317,42052,22679,19099,19648,0,2000,1500,1000,1000,1000,1,50437,47317,40552,21679,18099,18648,1.00874,0.94634,0.81104,0.43358,0.36198,0.37296,5
3378,240000,0,2,1,39,1,-1,-1,-1,-1,-2,0,1263,-13,1667,-300,-300,1263,0,1680,0,0,1442,1,-1263,1263,-1693,1667,-300,-1742,-0.0052625,0.0052625,-0.007054166666666667,0.006945833333333333,-0.00125,-0.007258333333333334,-5
3379,400000,1,1,1,29,0,0,0,0,0,0,5074,4097,7716,12538,17305,22499,1097,3716,5000,5000,5668,7000,1,3977,381,2716,7538,11637,15499,0.0099425,0.0009525,0.00679,0.018845,0.0290925,0.0387475,0
3380,20000,0,3,2,28,-1,2,2,2,0,0,3515,4301,5075,4845,6753,9615,1000,1000,0,2000,3000,2000,0,2515,3301,5075,2845,3753,7615,0.12575,0.16505,0.25375,0.14225,0.18765,0.38075,5
3381,140000,1,2,1,26,0,0,0,0,0,0,41547,40925,36775,35877,34812,33899,2000,1800,1300,1400,1400,1000,1,39547,39125,35475,34477,33412,32899,0.2824785714285714,0.2794642857142857,0.25339285714285714,0.2462642857142857,0.23865714285714285,0.23499285714285714,0
3382,180000,0,1,2,30,1,-2,-2,-2,-1,-1,-203,-698,-193,-688,817,1157,0,1000,0,2000,1000,2000,0,-203,-1698,-193,-2688,-183,-843,-0.0011277777777777777,-0.009433333333333334,-0.0010722222222222222,-0.014933333333333333,-0.0010166666666666666,-0.004683333333333334,-7
3383,120000,1,1,2,26,-1,-1,-1,-1,-1,-1,594,1052,736,420,2189,1482,1052,736,420,2189,500,0,0,-458,316,316,-1769,1689,1482,-0.0038166666666666666,0.0026333333333333334,0.0026333333333333334,-0.014741666666666667,0.014075,0.01235,-6
3384,180000,1,4,1,54,0,0,0,0,0,0,87695,88545,90403,92245,94082,96050,3200,3279,3343,3366,3483,3507,1,84495,85266,87060,88879,90599,92543,0.46941666666666665,0.4737,0.4836666666666667,0.4937722222222222,0.5033277777777778,0.5141277777777777,0
3385,140000,1,1,2,25,-1,-1,-1,-1,-1,-1,30077,2809,7541,10661,2214,6020,2809,7541,10661,2214,6020,0,0,27268,-4732,-3120,8447,-3806,6020,0.19477142857142857,-0.0338,-0.022285714285714287,0.060335714285714284,-0.027185714285714285,0.043,-6
3386,50000,1,3,1,39,0,0,2,-1,0,0,58300,59727,142,29886,30510,31276,7876,161,74354,927,1089,9100,1,50424,59566,-74212,28959,29421,22176,1.00848,1.19132,-1.48424,0.57918,0.58842,0.44352,1
3387,20000,0,2,2,22,0,0,0,0,-1,-1,18462,16699,19674,19258,9546,12051,1510,3875,759,10000,19126,1946,0,16952,12824,18915,9258,-9580,10105,0.8476,0.6412,0.94575,0.4629,-0.479,0.50525,-2
3388,20000,0,2,2,23,0,0,0,0,0,0,20432,16941,18066,19259,20071,19800,1280,1405,1598,1410,1021,0,0,19152,15536,16468,17849,19050,19800,0.9576,0.7768,0.8234,0.89245,0.9525,0.99,0
3389,80000,1,2,2,26,1,-2,-2,-2,-2,-2,0,0,0,0,0,0,0,3100,0,0,0,0,0,0,-3100,0,0,0,0,0.0,-0.03875,0.0,0.0,0.0,0.0,-9
3390,180000,1,2,2,26,-1,-1,-1,-1,-1,-1,5000,1600,2700,12000,0,1995,1600,2700,12000,0,1995,0,0,3400,-1100,-9300,12000,-1995,1995,0.01888888888888889,-0.006111111111111111,-0.051666666666666666,0.06666666666666667,-0.011083333333333334,0.011083333333333334,-6
3391,150000,0,2,1,45,2,3,3,2,0,0,152180,157719,155368,123906,128597,105967,9500,2000,0,8000,9000,15000,1,142680,155719,155368,115906,119597,90967,0.9512,1.0381266666666666,1.0357866666666666,0.7727066666666667,0.7973133333333333,0.6064466666666667,10
3392,30000,1,2,1,24,0,0,0,0,0,0,3740,4616,5837,6778,6912,7057,1100,1300,1200,247,256,258,1,2640,3316,4637,6531,6656,6799,0.088,0.11053333333333333,0.15456666666666666,0.2177,0.22186666666666666,0.22663333333333333,0
3393,30000,1,2,1,21,0,0,0,0,0,0,28404,29009,29831,29992,21754,18519,1467,1679,1230,827,1000,1000,1,26937,27330,28601,29165,20754,17519,0.8979,0.911,0.9533666666666667,0.9721666666666666,0.6918,0.5839666666666666,0
3394,60000,1,2,2,57,0,0,0,0,0,0,53584,41935,30077,30246,30257,29768,2000,2000,2300,2000,3000,1500,0,51584,39935,27777,28246,27257,28268,0.8597333333333333,0.6655833333333333,0.46295,0.47076666666666667,0.4542833333333333,0.47113333333333335,0
3395,360000,1,3,2,27,-2,-2,-2,-2,-2,-1,0,750,-2,468,-8,2496,750,2,470,0,2504,1153,0,-750,748,-472,468,-2512,1343,-0.0020833333333333333,0.0020777777777777778,-0.0013111111111111112,0.0013,-0.006977777777777778,0.0037305555555555555,-11
3396,360000,0,1,2,26,0,-1,-1,0,-1,-1,11910,1356,4073,17812,2981,1936,1500,5000,15000,3000,2000,1033,0,10410,-3644,-10927,14812,981,903,0.028916666666666667,-0.010122222222222222,-0.030352777777777777,0.04114444444444444,0.002725,0.0025083333333333333,-4
3397,30000,0,2,1,29,0,0,0,0,0,-2,29852,30348,31570,32661,0,0,1600,1738,1829,0,0,0,1,28252,28610,29741,32661,0,0,0.9417333333333333,0.9536666666666667,0.9913666666666666,1.0887,0.0,0.0,-2
3398,50000,1,2,2,34,0,0,0,0,0,0,31673,27572,29022,29368,16930,17284,1449,1899,1245,576,596,578,0,30224,25673,27777,28792,16334,16706,0.60448,0.51346,0.55554,0.57584,0.32668,0.33412,0
3399,30000,1,2,2,23,0,0,0,0,0,2,11284,12294,13320,14031,15593,15201,1503,1529,1240,1802,0,707,0,9781,10765,12080,12229,15593,14494,0.32603333333333334,0.35883333333333334,0.4026666666666667,0.40763333333333335,0.5197666666666667,0.48313333333333336,2
3400,150000,0,2,1,40,0,0,0,0,0,0,172935,46462,42407,28265,25402,21514,35749,3016,1201,601,2002,1020,1,137186,43446,41206,27664,23400,20494,0.9145733333333333,0.28964,0.27470666666666665,0.18442666666666666,0.156,0.13662666666666667,0
3401,450000,1,3,2,40,-1,-1,-1,-1,0,0,5453,25948,53938,14602,18065,19239,26731,55367,15174,10528,10037,48551,0,-21278,-29419,38764,4074,8028,-29312,-0.04728444444444444,-0.06537555555555556,0.08614222222222222,0.009053333333333333,0.01784,-0.06513777777777778,-4
3402,160000,0,1,2,31,-1,-1,-1,-1,-1,-1,813,1351,0,2773,215,2026,1351,0,2773,215,2026,0,0,-538,1351,-2773,2558,-1811,2026,-0.0033625,0.00844375,-0.01733125,0.0159875,-0.01131875,0.0126625,-6
3403,200000,1,1,2,31,1,-1,-1,-1,-1,-1,0,6372,2180,6605,970,0,6372,2182,6605,970,0,0,0,-6372,4190,-4425,5635,970,0,-0.03186,0.02095,-0.022125,0.028175,0.00485,0.0,-4
3404,200000,1,4,2,29,-2,-2,-2,-2,-2,-2,2618,784,611,0,0,150,784,611,0,0,150,478,0,1834,173,611,0,-150,-328,0.00917,0.000865,0.003055,0.0,-0.00075,-0.00164,-12
3405,120000,1,1,2,35,1,-2,-1,-1,-1,-1,0,0,234,4394,3164,5700,0,234,4394,3164,5700,300,0,0,-234,-4160,1230,-2536,5400,0.0,-0.00195,-0.034666666666666665,0.01025,-0.021133333333333334,0.045,-5
3406,400000,1,2,2,25,0,0,0,0,0,0,393159,44917,52366,29995,22722,24479,2522,17213,1000,1000,2100,154700,0,390637,27704,51366,28995,20622,-130221,0.9765925,0.06926,0.128415,0.0724875,0.051555,-0.3255525,0
3407,10000,1,3,1,51,1,2,0,0,2,2,2731,2541,3499,4441,4233,5566,0,1000,1000,0,2000,1170,1,2731,1541,2499,4441,2233,4396,0.2731,0.1541,0.2499,0.4441,0.2233,0.4396,7
3408,120000,1,3,1,61,1,2,0,0,0,0,121709,78369,61849,57737,59174,60651,99,8800,2700,3000,2600,2200,1,121610,69569,59149,54737,56574,58451,1.0134166666666666,0.5797416666666667,0.49290833333333334,0.45614166666666667,0.47145,0.48709166666666665,3
3409,290000,1,2,1,34,0,0,0,0,-1,0,53437,44037,5441,7371,38832,41955,1274,1200,2033,38832,3900,188423,1,52163,42837,3408,-31461,34932,-146468,0.17987241379310345,0.1477137931034483,0.011751724137931035,-0.10848620689655172,0.12045517241379311,-0.5050620689655172,-1
3410,50000,1,1,1,43,0,0,0,0,2,0,49390,50612,29975,30559,29433,30045,2449,1778,2382,0,1251,1051,1,46941,48834,27593,30559,28182,28994,0.93882,0.97668,0.55186,0.61118,0.56364,0.57988,2
3411,10000,0,2,2,45,1,2,0,0,0,0,9298,9093,8528,9319,9477,9736,1000,1200,1142,300,400,340,0,8298,7893,7386,9019,9077,9396,0.8298,0.7893,0.7386,0.9019,0.9077,0.9396,3
3412,310000,1,1,2,32,-1,-1,-1,-1,-2,-2,13560,-65,6500,0,0,0,0,6565,0,0,0,0,0,13560,-6630,6500,0,0,0,0.04374193548387097,-0.021387096774193547,0.020967741935483872,0.0,0.0,0.0,-8
3413,290000,1,1,1,39,-2,-2,-2,-2,-2,-2,79298,-40,122380,0,32720,-200,0,122420,0,32720,200,0,1,79298,-122460,122380,-32720,32520,-200,0.27344137931034485,-0.4222758620689655,0.422,-0.11282758620689655,0.11213793103448276,-0.000689655172413793,-12
3414,150000,1,2,2,38,0,0,0,0,0,0,26495,24906,6763,6581,6733,6882,1291,1101,1098,250,247,300,0,25204,23805,5665,6331,6486,6582,0.16802666666666666,0.1587,0.037766666666666664,0.04220666666666667,0.04324,0.04388,0
3415,50000,1,2,1,34,2,2,2,2,2,2,44654,45650,46320,45290,48322,49094,2000,1700,0,3760,1700,0,1,42654,43950,46320,41530,46622,49094,0.85308,0.879,0.9264,0.8306,0.93244,0.98188,12
3416,210000,1,2,1,40,-1,-1,-1,-1,-1,-1,12555,560,5287,2000,900,406,560,5287,2000,900,406,900,1,11995,-4727,3287,1100,494,-494,0.05711904761904762,-0.02250952380952381,0.015652380952380952,0.005238095238095238,0.0023523809523809526,-0.0023523809523809526,-6
3417,150000,1,2,2,42,0,0,0,0,0,0,89341,79904,72182,61014,49502,46055,5000,6000,3000,2000,10000,5000,0,84341,73904,69182,59014,39502,41055,0.5622733333333333,0.4926933333333333,0.4612133333333333,0.39342666666666665,0.2633466666666667,0.2737,0
3418,20000,1,1,2,23,0,0,2,0,0,0,11672,8584,8279,8444,8621,8868,2424,0,284,294,371,500,0,9248,8584,7995,8150,8250,8368,0.4624,0.4292,0.39975,0.4075,0.4125,0.4184,2
3419,360000,0,1,2,34,0,0,-1,0,0,0,14867,14612,13739,7995,9480,9952,1079,14598,1017,5022,5049,3304,0,13788,14,12722,2973,4431,6648,0.0383,3.888888888888889e-05,0.03533888888888889,0.008258333333333333,0.012308333333333333,0.018466666666666666,-1
3420,30000,1,2,2,38,0,0,0,0,0,0,29632,30239,30526,29219,30012,28422,1492,1661,1238,1031,1083,0,0,28140,28578,29288,28188,28929,28422,0.938,0.9526,0.9762666666666666,0.9396,0.9643,0.9474,0
3421,90000,1,2,2,23,0,0,0,0,0,0,29357,26003,27090,27767,28108,29848,1500,1500,1800,1100,2200,1500,0,27857,24503,25290,26667,25908,28348,0.3095222222222222,0.27225555555555553,0.281,0.2963,0.28786666666666666,0.3149777777777778,0
3422,210000,1,1,2,28,-1,-1,-1,0,0,0,11442,3738,7526,10217,11737,8114,3738,7526,5000,5000,162,27760,0,7704,-3788,2526,5217,11575,-19646,0.03668571428571429,-0.01803809523809524,0.012028571428571428,0.024842857142857142,0.055119047619047616,-0.09355238095238096,-3
3423,50000,0,3,2,47,0,0,0,0,0,0,29789,28699,29305,27595,27745,28086,1763,1759,1439,979,1164,1300,0,28026,26940,27866,26616,26581,26786,0.56052,0.5388,0.55732,0.53232,0.53162,0.53572,0
3424,150000,0,1,1,41,2,2,2,0,0,2,113358,124745,121249,124237,132252,134925,14779,0,5000,10000,5000,0,1,98579,124745,116249,114237,127252,134925,0.6571933333333333,0.8316333333333333,0.7749933333333333,0.76158,0.8483466666666667,0.8995,8
3425,120000,0,1,2,32,-1,-1,-1,-1,-1,-1,890,390,390,1480,0,6477,390,390,1480,0,6477,0,0,500,0,-1090,1480,-6477,6477,0.004166666666666667,0.0,-0.009083333333333334,0.012333333333333333,-0.053975,0.053975,-6
3426,440000,0,2,1,48,0,0,0,0,0,0,23424,24222,24077,23241,24600,16344,3000,3000,2000,5000,0,5000,1,20424,21222,22077,18241,24600,11344,0.04641818181818182,0.04823181818181818,0.050175,0.041456818181818185,0.05590909090909091,0.025781818181818184,0
3427,130000,0,1,2,37,0,0,0,0,0,0,109383,106149,44841,45451,46564,47516,5300,1700,1300,1500,1500,1400,0,104083,104449,43541,43951,45064,46116,0.8006384615384615,0.8034538461538462,0.33493076923076925,0.3380846153846154,0.3466461538461538,0.35473846153846156,0
3428,80000,1,2,2,25,-2,-2,-2,-2,-2,-1,0,0,0,0,0,442,0,0,0,0,442,1102,0,0,0,0,0,-442,-660,0.0,0.0,0.0,0.0,-0.005525,-0.00825,-11
3429,500000,1,1,2,45,-2,-2,-2,-2,-2,-2,0,0,1742,27291,0,0,0,1742,27291,0,0,6386,0,0,-1742,-25549,27291,0,-6386,0.0,-0.003484,-0.051098,0.054582,0.0,-0.012772,-12
3430,310000,1,2,1,34,0,0,0,0,0,0,87842,42594,26198,26766,27341,28891,3021,1600,1000,1000,2000,3000,1,84821,40994,25198,25766,25341,25891,0.27361612903225807,0.13223870967741935,0.08128387096774194,0.08311612903225807,0.08174516129032258,0.08351935483870968,0
3431,230000,0,1,1,38,-2,-2,-2,-2,-2,-2,0,0,0,0,0,0,0,0,0,0,0,0,1,0,0,0,0,0,0,0.0,0.0,0.0,0.0,0.0,0.0,-12
3432,30000,1,3,1,39,2,2,2,2,2,2,20652,24993,24293,25896,26435,25859,4700,0,2010,1100,0,2100,1,15952,24993,22283,24796,26435,23759,0.5317333333333333,0.8331,0.7427666666666667,0.8265333333333333,0.8811666666666667,0.7919666666666667,12
3433,500000,0,2,1,38,0,0,0,0,-1,0,49201,59372,49677,49515,42568,48268,30107,10026,7241,50091,25000,5078,1,19094,49346,42436,-576,17568,43190,0.038188,0.098692,0.084872,-0.001152,0.035136,0.08638,-1
3434,20000,0,2,1,39,2,2,2,2,2,2,20591,20284,20645,20750,20300,20482,1500,1000,718,3,1800,0,1,19091,19284,19927,20747,18500,20482,0.95455,0.9642,0.99635,1.03735,0.925,1.0241,12
3435,30000,1,3,1,62,0,0,0,0,0,0,18563,19647,20725,21774,22114,22607,1700,1700,1700,1000,1000,2000,1,16863,17947,19025,20774,21114,20607,0.5621,0.5982333333333333,0.6341666666666667,0.6924666666666667,0.7038,0.6869,0
3436,130000,0,1,1,39,2,-1,-1,-1,-1,-1,390,390,390,1068,3169,390,390,390,1068,3169,390,390,1,0,0,-678,-2101,2779,0,0.0,0.0,-0.005215384615384616,-0.01616153846153846,0.021376923076923078,0.0,-3
3437,130000,0,2,1,33,0,0,0,0,0,0,39251,40772,40437,9919,10295,7964,2500,3200,1200,500,447,1000,1,36751,37572,39237,9419,9848,6964,0.2827,0.2890153846153846,0.3018230769230769,0.07245384615384616,0.07575384615384616,0.05356923076923077,0
3438,360000,0,3,2,40,-1,-1,-1,0,0,0,2569,316,4919,5559,5353,5401,316,4919,1000,110,1025,2684,0,2253,-4603,3919,5449,4328,2717,0.006258333333333334,-0.012786111111111111,0.01088611111111111,0.01513611111111111,0.012022222222222222,0.0075472222222222225,-3
3439,450000,1,1,2,35,-1,-1,-1,-1,-1,-1,7256,812,17563,12483,26081,22985,816,17651,12554,26212,23114,2512,0,6440,-16839,5009,-13729,2967,20473,0.014311111111111111,-0.03742,0.01113111111111111,-0.030508888888888887,0.006593333333333333,0.04549555555555555,-6
3440,430000,1,1,1,37,-1,-1,-1,-1,-1,-1,1669,412,23547,5064,13258,2249,416,23547,5064,13258,2249,3686,1,1253,-23135,18483,-8194,11009,-1437,0.002913953488372093,-0.05380232558139535,0.04298372093023256,-0.019055813953488373,0.025602325581395347,-0.003341860465116279,-6
3441,60000,1,3,2,23,0,0,0,0,0,0,60465,60100,58795,47818,28357,29309,3000,2148,3049,3000,3002,1021,0,57465,57952,55746,44818,25355,28288,0.95775,0.9658666666666667,0.9291,0.7469666666666667,0.4225833333333333,0.47146666666666665,0
3442,200000,0,1,1,31,-1,0,0,0,0,0,58008,72062,72912,80819,84186,83710,20000,20000,10000,20000,10000,10000,1,38008,52062,62912,60819,74186,73710,0.19004,0.26031,0.31456,0.304095,0.37093,0.36855,-1
3443,210000,1,1,1,38,-1,-1,2,2,-1,-1,2360,4707,4465,0,9306,5855,4465,0,0,9306,5855,9840,1,-2105,4707,4465,-9306,3451,-3985,-0.010023809523809523,0.022414285714285713,0.021261904761904763,-0.044314285714285716,0.016433333333333335,-0.018976190476190476,0
3444,80000,1,1,2,22,1,2,2,-1,-1,-1,6261,6170,4258,7032,6348,1606,1000,0,7032,6348,1606,0,0,5261,6170,-2774,684,4742,1606,0.0657625,0.077125,-0.034675,0.00855,0.059275,0.020075,2
3445,220000,0,1,2,35,-1,0,0,-2,-2,-2,53419,53358,0,0,0,0,7000,0,0,0,0,0,0,46419,53358,0,0,0,0,0.21099545454545454,0.24253636363636363,0.0,0.0,0.0,0.0,-7
3446,270000,1,3,1,47,-1,-1,-1,2,2,-2,123,123,123,123,0,0,123,123,0,0,0,0,1,0,0,123,123,0,0,0.0,0.0,0.00045555555555555556,0.00045555555555555556,0.0,0.0,-1
3447,120000,1,2,2,26,0,0,0,0,0,2,87151,88304,89657,41720,29022,28422,3500,3103,1800,2381,0,1100,0,83651,85201,87857,39339,29022,27322,0.6970916666666667,0.7100083333333334,0.7321416666666667,0.327825,0.24185,0.22768333333333332,2
3448,200000,0,2,2,37,1,-2,-2,-2,-2,-2,0,0,0,0,0,0,0,0,0,0,0,0,0,0,0,0,0,0,0,0.0,0.0,0.0,0.0,0.0,0.0,-9
3449,140000,0,1,2,41,2,2,2,0,0,0,138379,143684,139902,142729,142406,142694,9000,0,6800,40000,5600,5900,0,129379,143684,133102,102729,136806,136794,0.9241357142857143,1.0263142857142857,0.9507285714285715,0.7337785714285714,0.9771857142857143,0.9771,6
3450,370000,1,1,2,28,0,0,0,0,0,0,68452,71014,72547,74501,76058,77572,3513,3046,3000,2589,2603,2695,0,64939,67968,69547,71912,73455,74877,0.17551081081081082,0.1836972972972973,0.18796486486486486,0.19435675675675676,0.19852702702702701,0.20237027027027027,0
3451,160000,0,2,2,57,0,0,0,0,0,0,152689,148126,144978,141639,138383,134951,5500,5300,5053,5010,4850,5000,0,147189,142826,139925,136629,133533,129951,0.91993125,0.8926625,0.87453125,0.85393125,0.83458125,0.81219375,0
3452,20000,0,2,2,24,0,0,0,0,0,0,19102,18054,19026,19406,18258,18694,1318,1290,670,663,740,536,0,17784,16764,18356,18743,17518,18158,0.8892,0.8382,0.9178,0.93715,0.8759,0.9079,0
3453,30000,0,1,2,36,2,0,0,0,0,0,24796,26088,27032,26723,23143,17106,2000,1804,2014,1521,1204,1500,0,22796,24284,25018,25202,21939,15606,0.7598666666666667,0.8094666666666667,0.8339333333333333,0.8400666666666666,0.7313,0.5202,2
3454,100000,1,3,1,28,3,4,3,2,0,-1,110946,106423,101256,48876,28468,3875,0,0,0,1603,3875,55,1,110946,106423,101256,47273,24593,3820,1.10946,1.06423,1.01256,0.47273,0.24593,0.0382,11
3455,10000,0,2,2,26,2,2,7,7,7,7,2400,2400,2400,2400,2400,2400,0,0,0,0,0,0,0,2400,2400,2400,2400,2400,2400,0.24,0.24,0.24,0.24,0.24,0.24,32
3456,180000,0,1,2,41,0,-1,-1,-1,0,0,16366,18339,2766,97996,55156,36213,18339,2766,97996,1861,1196,3000,0,-1973,15573,-95230,96135,53960,33213,-0.01096111111111111,0.08651666666666667,-0.5290555555555555,0.5340833333333334,0.29977777777777775,0.18451666666666666,-3
3457,330000,0,1,1,37,-2,-2,-2,-1,-1,-1,18807,15865,34284,2780,20247,1806,2087,10054,2840,21101,1814,1861,1,16720,5811,31444,-18321,18433,-55,0.050666666666666665,0.017609090909090908,0.09528484848484849,-0.05551818181818182,0.05585757575757576,-0.00016666666666666666,-9
3458,30000,1,2,2,53,-1,-1,0,0,0,0,356,15666,16863,7380,8580,10000,15700,2000,2000,1200,2200,0,0,-15344,13666,14863,6180,6380,10000,-0.5114666666666666,0.45553333333333335,0.49543333333333334,0.206,0.21266666666666667,0.3333333333333333,-2
3459,200000,0,3,2,48,0,0,0,0,-1,-1,87035,79529,67675,56519,11884,14343,2915,2646,2208,12503,14869,0,0,84120,76883,65467,44016,-2985,14343,0.4206,0.384415,0.327335,0.22008,-0.014925,0.071715,-2
3460,150000,1,2,2,33,-2,-2,-2,-2,-2,-2,6806,2774,0,500,399,0,2779,0,500,399,0,0,0,4027,2774,-500,101,399,0,0.026846666666666668,0.018493333333333334,-0.0033333333333333335,0.0006733333333333333,0.00266,0.0,-12
3461,150000,0,1,1,29,-1,-1,-1,0,0,-2,46745,20853,90787,11232,0,0,20995,91269,56,0,0,0,1,25750,-70416,90731,11232,0,0,0.17166666666666666,-0.46944,0.6048733333333334,0.07488,0.0,0.0,-5
3462,250000,0,2,2,42,0,0,0,0,0,0,212787,218035,223068,228051,233072,237879,9000,9000,9000,9000,9000,9000,0,203787,209035,214068,219051,224072,228879,0.815148,0.83614,0.856272,0.876204,0.896288,0.915516,0
3463,150000,0,1,2,35,0,0,0,0,0,0,150359,147471,151713,130107,78623,79743,15000,20000,5000,2000,7000,15000,0,135359,127471,146713,128107,71623,64743,0.9023933333333334,0.8498066666666667,0.9780866666666667,0.8540466666666666,0.47748666666666667,0.43162,0
3464,150000,1,2,2,42,0,0,0,0,0,0,255207,249205,245393,29526,6990,0,6301,8000,5000,6800,0,0,0,248906,241205,240393,22726,6990,0,1.6593733333333334,1.6080333333333334,1.60262,0.15150666666666668,0.0466,0.0,0
3465,50000,1,2,1,40,0,0,2,0,0,0,6732,9052,8763,9924,9967,10176,2441,0,1313,356,369,508,1,4291,9052,7450,9568,9598,9668,0.08582,0.18104,0.149,0.19136,0.19196,0.19336,2
3466,360000,1,1,1,31,0,0,0,0,0,-1,6656,6722,8605,28405,-105,3895,2000,4000,20000,5000,4000,889,1,4656,2722,-11395,23405,-4105,3006,0.012933333333333333,0.007561111111111111,-0.03165277777777778,0.06501388888888888,-0.011402777777777777,0.00835,-1
3467,60000,0,2,2,38,0,0,0,0,0,0,42184,42108,41300,40840,40366,39737,2014,1616,1566,1700,1600,1400,0,40170,40492,39734,39140,38766,38337,0.6695,0.6748666666666666,0.6622333333333333,0.6523333333333333,0.6461,0.63895,0
3468,30000,1,2,2,31,0,0,0,-2,-2,-2,26830,30900,0,0,0,0,5000,0,0,0,0,0,0,21830,30900,0,0,0,0,0.7276666666666667,1.03,0.0,0.0,0.0,0.0,-6
3469,310000,0,1,2,38,-2,-2,-2,-2,-2,-2,995,988,993,993,1495,995,993,1005,1000,1502,1000,1000,0,2,-17,-7,-509,495,-5,6.451612903225806e-06,-5.4838709677419355e-05,-2.258064516129032e-05,-0.0016419354838709678,0.0015967741935483872,-1.6129032258064517e-05,-12
3470,280000,1,1,1,34,0,0,0,0,0,0,232834,218803,202031,111603,94050,76232,9001,6369,3864,3501,3001,1701,1,223833,212434,198167,108102,91049,74531,0.7994035714285714,0.7586928571428572,0.7077392857142857,0.38607857142857144,0.325175,0.26618214285714287,0
3471,20000,0,3,1,40,0,0,0,0,0,0,18987,19909,16623,17634,17985,18362,1258,1282,1293,644,667,743,1,17729,18627,15330,16990,17318,17619,0.88645,0.93135,0.7665,0.8495,0.8659,0.88095,0
3472,700000,1,1,1,39,0,0,0,0,-2,-1,99259,102345,109636,326,2016,61707,5000,10000,326,2016,61707,17785,1,94259,92345,109310,-1690,-59691,43922,0.1346557142857143,0.13192142857142858,0.15615714285714286,-0.0024142857142857143,-0.08527285714285714,0.06274571428571428,-3
3473,260000,1,1,2,27,0,0,0,0,0,0,109588,111132,112014,107404,46866,11950,5000,5000,3000,2000,433,1000,0,104588,106132,109014,105404,46433,10950,0.40226153846153845,0.4082,0.41928461538461537,0.4054,0.17858846153846153,0.04211538461538462,0
3474,210000,1,2,1,31,0,0,0,0,0,0,205243,209502,203831,178410,130619,115700,7736,7100,8300,4800,4396,4200,1,197507,202402,195531,173610,126223,111500,0.9405095238095238,0.9638190476190476,0.9311,0.8267142857142857,0.6010619047619048,0.530952380952381,0
3475,130000,1,2,2,27,1,-2,-2,-2,-2,-2,0,0,0,0,0,0,0,0,0,0,0,0,0,0,0,0,0,0,0,0.0,0.0,0.0,0.0,0.0,0.0,-9
3476,160000,1,3,1,39,0,0,0,0,0,0,40892,42416,43367,44344,45486,50520,2500,3000,2000,1856,6000,2000,1,38392,39416,41367,42488,39486,48520,0.23995,0.24635,0.25854375,0.26555,0.2467875,0.30325,0
3477,30000,1,2,1,43,0,0,2,0,0,2,26806,30035,29274,31460,33890,31224,4000,0,3000,2900,0,1091,1,22806,30035,26274,28560,33890,30133,0.7602,1.0011666666666668,0.8758,0.952,1.1296666666666666,1.0044333333333333,4
3478,360000,0,2,1,26,-2,-1,-1,-2,-2,-2,0,2500,0,0,0,0,2500,0,0,0,0,0,1,-2500,2500,0,0,0,0,-0.006944444444444444,0.006944444444444444,0.0,0.0,0.0,0.0,-10
3479,140000,1,2,1,41,0,0,0,0,0,2,41814,43616,44710,45661,50880,49934,2500,2100,2000,6000,0,2000,1,39314,41516,42710,39661,50880,47934,0.28081428571428574,0.29654285714285716,0.30507142857142855,0.2832928571428571,0.36342857142857143,0.3423857142857143,2
3480,170000,0,2,1,37,-2,-2,-2,-2,-2,-2,0,0,0,0,0,0,0,0,0,0,0,0,1,0,0,0,0,0,0,0.0,0.0,0.0,0.0,0.0,0.0,-12
3481,200000,1,3,1,36,0,0,0,0,0,0,167385,171476,175956,171340,177236,181978,8000,8045,8000,8000,7000,18000,1,159385,163431,167956,163340,170236,163978,0.796925,0.817155,0.83978,0.8167,0.85118,0.81989,0
3482,280000,1,1,1,29,0,0,0,0,0,0,58308,61024,62665,63730,57916,59122,4000,3000,2315,2103,2500,2000,1,54308,58024,60350,61627,55416,57122,0.19395714285714286,0.20722857142857143,0.21553571428571427,0.22009642857142858,0.1979142857142857,0.20400714285714286,0
3483,430000,1,2,1,30,2,0,0,0,0,0,332721,277080,219739,210142,179350,130328,10896,8123,7522,7003,4700,5000,1,321825,268957,212217,203139,174650,125328,0.7484302325581396,0.6254813953488372,0.4935279069767442,0.47241627906976746,0.4061627906976744,0.29146046511627904,2
3484,50000,1,2,2,31,0,-1,-1,-2,-1,-1,9514,2067,-6,-409,793,2385,2100,405,0,2385,2385,3000,0,7414,1662,-6,-2794,-1592,-615,0.14828,0.03324,-0.00012,-0.05588,-0.03184,-0.0123,-6
3485,50000,0,1,2,39,0,0,0,0,0,0,57436,58483,55825,54888,58115,57299,2055,2655,1862,4007,2517,37793,0,55381,55828,53963,50881,55598,19506,1.10762,1.11656,1.07926,1.01762,1.11196,0.39012,0
3486,60000,1,3,1,44,-1,0,0,0,0,0,63236,64683,66510,58622,47317,48726,2500,3000,2292,1526,2000,2000,1,60736,61683,64218,57096,45317,46726,1.0122666666666666,1.02805,1.0703,0.9516,0.7552833333333333,0.7787666666666667,-1
3487,90000,1,3,1,44,-1,-1,3,2,-1,-1,421,9522,9223,8480,2181,2983,9422,0,79,2181,2991,2453,1,-9001,9522,9144,6299,-810,530,-0.1000111111111111,0.1058,0.1016,0.06998888888888889,-0.009,0.005888888888888889,1
3488,270000,0,1,1,50,2,4,3,3,2,2,213616,208784,212058,207226,202394,231339,0,8000,0,0,32236,3000,1,213616,200784,212058,207226,170158,228339,0.7911703703703704,0.7436444444444444,0.7854,0.7675037037037037,0.6302148148148148,0.8457,16
3489,170000,0,2,2,27,-1,-1,-1,-1,0,0,711,176,465,1422,582,291,176,1000,1422,291,0,291,0,535,-824,-957,1131,582,0,0.0031470588235294117,-0.004847058823529412,-0.005629411764705883,0.006652941176470588,0.003423529411764706,0.0,-4
3490,500000,0,2,2,67,-1,-1,-1,-1,-1,-1,4410,2662,2533,1821,2498,3622,2681,2547,1826,2505,3630,3099,0,1729,115,707,-684,-1132,523,0.003458,0.00023,0.001414,-0.001368,-0.002264,0.001046,-6
3491,200000,1,2,1,29,0,0,0,0,0,0,74566,73700,73624,73928,72060,72393,3213,3304,3815,3004,3006,4012,1,71353,70396,69809,70924,69054,68381,0.356765,0.35198,0.349045,0.35462,0.34527,0.341905,0
3492,50000,1,1,2,28,0,0,0,0,0,0,46471,43507,44016,43396,41470,48676,1807,2016,1796,1570,10000,1778,0,44664,41491,42220,41826,31470,46898,0.89328,0.82982,0.8444,0.83652,0.6294,0.93796,0
3493,90000,1,3,2,50,0,0,0,0,0,0,83939,86583,87014,46293,47576,46663,4000,2500,2000,2000,2000,2000,0,79939,84083,85014,44293,45576,44663,0.8882111111111111,0.9342555555555555,0.9446,0.49214444444444444,0.5064,0.49625555555555556,0
3494,80000,1,2,2,23,0,0,0,0,0,0,6805,8449,10303,11737,10619,49872,2000,2000,2000,1000,40002,2009,0,4805,6449,8303,10737,-29383,47863,0.0600625,0.0806125,0.1037875,0.1342125,-0.3672875,0.5982875,0
3495,30000,1,3,1,42,0,0,0,2,2,2,21969,23306,27851,27098,29866,29276,1706,5251,0,3519,0,1368,1,20263,18055,27851,23579,29866,27908,0.6754333333333333,0.6018333333333333,0.9283666666666667,0.7859666666666667,0.9955333333333334,0.9302666666666667,6
3496,30000,0,2,2,37,2,2,2,0,0,0,25811,29066,28322,29251,15525,0,3700,0,1800,3925,0,0,0,22111,29066,26522,25326,15525,0,0.7370333333333333,0.9688666666666667,0.8840666666666667,0.8442,0.5175,0.0,6
3497,50000,0,1,1,34,0,0,0,0,0,0,45341,31383,16235,17035,15601,16349,2115,2000,2022,1000,1000,2000,1,43226,29383,14213,16035,14601,14349,0.86452,0.58766,0.28426,0.3207,0.29202,0.28698,0
3498,130000,1,2,2,29,-1,-1,-1,2,0,0,867,1110,1170,780,390,0,1200,1170,0,0,0,780,0,-333,-60,1170,780,390,-780,-0.0025615384615384615,-0.00046153846153846153,0.009,0.006,0.003,-0.006,-1
3499,180000,1,2,2,33,-2,-2,-2,-2,-2,-2,11281,3405,22630,7777,3089,8429,3411,22657,7777,3089,8429,6706,0,7870,-19252,14853,4688,-5340,1723,0.043722222222222225,-0.10695555555555555,0.08251666666666667,0.026044444444444443,-0.029666666666666668,0.009572222222222222,-12
3500,20000,1,3,1,46,0,0,2,2,2,2,11691,14179,13662,15518,14972,16925,3000,0,2088,0,2200,0,1,8691,14179,11574,15518,12772,16925,0.43455,0.70895,0.5787,0.7759,0.6386,0.84625,8
3501,130000,1,1,1,33,0,0,0,0,0,0,63505,64121,66351,73399,71007,71253,5000,5000,10000,3000,3000,3228,1,58505,59121,56351,70399,68007,68025,0.45003846153846155,0.4547769230769231,0.4334692307692308,0.5415307692307693,0.5231307692307692,0.5232692307692308,0
3502,350000,1,2,1,34,1,2,0,0,0,0,23589,22585,23263,23755,23900,25016,0,1700,1500,1000,2000,1500,1,23589,20885,21763,22755,21900,23516,0.06739714285714286,0.05967142857142857,0.06218,0.06501428571428572,0.06257142857142857,0.06718857142857143,3
3503,10000,1,2,2,24,-1,-1,-1,-1,-1,2,5666,576,1709,1470,2010,780,576,1709,1470,2010,0,1080,0,5090,-1133,239,-540,2010,-300,0.509,-0.1133,0.0239,-0.054,0.201,-0.03,-3
3504,180000,1,1,2,32,-1,-1,2,2,-1,-1,3139,5853,2821,0,2821,0,2821,0,0,2821,0,176,0,318,5853,2821,-2821,2821,-176,0.0017666666666666666,0.032516666666666666,0.015672222222222223,-0.015672222222222223,0.015672222222222223,-0.0009777777777777777,0
3505,160000,0,1,1,31,-1,-1,-1,-1,-1,-1,24465,7747,17002,17170,14685,4328,7751,17016,17185,14685,4328,5827,1,16714,-9269,-183,2485,10357,-1499,0.1044625,-0.05793125,-0.00114375,0.01553125,0.06473125,-0.00936875,-6
3506,30000,1,3,2,26,0,0,0,0,0,0,30244,29640,30451,29391,30042,28436,1701,1600,1500,1095,1500,2000,0,28543,28040,28951,28296,28542,26436,0.9514333333333334,0.9346666666666666,0.9650333333333333,0.9432,0.9514,0.8812,0
3507,20000,0,1,2,24,1,2,0,0,0,-2,18738,18016,7190,7190,0,0,20,1500,0,0,0,0,0,18718,16516,7190,7190,0,0,0.9359,0.8258,0.3595,0.3595,0.0,0.0,1
3508,50000,0,2,1,32,0,0,0,0,0,0,50764,50428,49564,21002,20230,19462,2200,1500,1500,2000,1700,2000,1,48564,48928,48064,19002,18530,17462,0.97128,0.97856,0.96128,0.38004,0.3706,0.34924,0
3509,30000,0,2,2,36,3,2,2,2,3,2,20424,19809,22478,24111,23447,24951,0,3000,2300,0,2500,0,0,20424,16809,20178,24111,20947,24951,0.6808,0.5603,0.6726,0.8037,0.6982333333333334,0.8317,14
3510,80000,0,1,2,29,0,0,0,0,0,0,31637,27137,25986,23496,23601,24650,1734,2000,2000,2000,2000,2000,0,29903,25137,23986,21496,21601,22650,0.3737875,0.3142125,0.299825,0.2687,0.2700125,0.283125,0
3511,320000,0,3,1,36,-2,-2,-2,-2,-2,-2,5360,726,6992,3741,10138,15745,726,6992,3755,10138,15745,16740,1,4634,-6266,3237,-6397,-5607,-995,0.01448125,-0.01958125,0.010115625,-0.019990625,-0.017521875,-0.003109375,-12
3512,240000,1,1,1,41,0,0,0,0,0,0,126395,129371,132218,136003,139798,142574,5000,5000,6000,6000,5098,5281,1,121395,124371,126218,130003,134700,137293,0.5058125,0.5182125,0.5259083333333333,0.5416791666666667,0.56125,0.5720541666666666,0
3513,200000,1,3,2,28,1,-2,-2,-1,-1,-1,0,0,0,304,13489,6788,0,0,304,13489,6788,188,0,0,0,-304,-13185,6701,6600,0.0,0.0,-0.00152,-0.065925,0.033505,0.033,-6
3514,400000,1,4,1,37,-2,-2,-2,-2,-2,-2,14889,929,1191,11930,11286,5766,929,1191,11930,11286,5766,16520,1,13960,-262,-10739,644,5520,-10754,0.0349,-0.000655,-0.0268475,0.00161,0.0138,-0.026885,-12
3515,80000,1,2,1,36,0,0,0,0,0,0,74652,76506,78173,79220,81351,48056,3700,3500,3000,3368,1023,1500,1,70952,73006,75173,75852,80328,46556,0.8869,0.912575,0.9396625,0.94815,1.0041,0.58195,0
3516,230000,0,1,1,41,1,-1,-1,-1,-1,-1,0,1482,2140,2360,2620,0,1482,2140,2560,2620,0,0,1,-1482,-658,-420,-260,2620,0,-0.006443478260869565,-0.0028608695652173914,-0.0018260869565217392,-0.0011304347826086956,0.011391304347826087,0.0,-4
3517,50000,1,2,2,29,0,0,0,0,0,0,26159,27222,27954,26702,26993,25758,1800,1500,1800,1000,1200,1200,0,24359,25722,26154,25702,25793,24558,0.48718,0.51444,0.52308,0.51404,0.51586,0.49116,0
3518,110000,0,2,1,32,0,0,0,0,0,2,110198,107710,83913,47369,48905,46046,3851,3021,1649,3513,0,1664,1,106347,104689,82264,43856,48905,44382,0.9667909090909091,0.9517181818181818,0.7478545454545454,0.3986909090909091,0.4445909090909091,0.40347272727272726,2
3519,50000,1,2,1,48,0,-1,-1,0,-1,-1,5994,1478,2946,1473,1473,1473,1478,4419,0,1473,1473,1473,1,4516,-2941,2946,0,0,0,0.09032,-0.05882,0.05892,0.0,0.0,0.0,-4
3520,70000,0,1,2,31,1,2,2,0,0,0,65779,34480,33632,35747,38981,43331,3000,0,3000,4000,5000,0,0,62779,34480,30632,31747,33981,43331,0.8968428571428572,0.49257142857142855,0.4376,0.45352857142857145,0.4854428571428571,0.6190142857142857,5
3521,140000,0,1,2,31,-1,-1,-1,-1,-1,-2,4900,393,0,814,0,0,393,0,814,0,0,0,0,4507,393,-814,814,0,0,0.03219285714285714,0.002807142857142857,-0.0058142857142857145,0.0058142857142857145,0.0,0.0,-7
3522,50000,1,2,1,27,2,0,0,0,-1,0,50151,48945,36467,18890,30288,30003,1724,1819,2664,31057,1064,1073,1,48427,47126,33803,-12167,29224,28930,0.96854,0.94252,0.67606,-0.24334,0.58448,0.5786,1
3523,290000,1,1,2,31,-1,-1,-1,-1,-1,-1,21720,1240,3682,4694,5258,1248,1240,3682,4704,5258,1248,9600,0,20480,-2442,-1022,-564,4010,-8352,0.07062068965517242,-0.008420689655172413,-0.0035241379310344827,-0.0019448275862068965,0.013827586206896551,-0.0288,-6
3524,370000,0,1,2,30,0,-1,-1,0,0,0,6592,3563,184429,180508,178220,72656,4000,192718,5000,5000,3000,2000,0,2592,-189155,179429,175508,175220,70656,0.0070054054054054056,-0.5112297297297297,0.4849432432432432,0.4743459459459459,0.47356756756756757,0.19096216216216216,-2
3525,200000,1,1,2,40,1,-2,-2,-2,-2,-2,0,0,0,0,0,0,0,0,0,0,0,0,0,0,0,0,0,0,0,0.0,0.0,0.0,0.0,0.0,0.0,-9
3526,320000,1,2,2,26,0,0,0,0,0,0,320983,319377,319368,305308,188120,192087,14000,14033,14008,7000,7000,7600,0,306983,305344,305360,298308,181120,184487,0.959321875,0.9542,0.95425,0.9322125,0.566,0.576521875,0
3527,140000,1,2,2,42,0,0,0,0,0,0,24984,26010,27026,27714,28139,28697,1434,1450,1138,1021,1026,1061,0,23550,24560,25888,26693,27113,27636,0.1682142857142857,0.17542857142857143,0.18491428571428573,0.1906642857142857,0.1936642857142857,0.1974,0
3528,200000,1,1,2,42,-1,-1,2,-1,-1,-1,660,1320,660,1320,1320,1710,1320,0,1320,1320,1710,27077,0,-660,1320,-660,0,-390,-25367,-0.0033,0.0066,-0.0033,0.0,-0.00195,-0.126835,-3
3529,450000,1,1,3,37,1,-2,-2,-2,-2,-2,0,0,0,0,0,0,0,0,0,0,0,0,0,0,0,0,0,0,0,0.0,0.0,0.0,0.0,0.0,0.0,-9
3530,230000,0,2,2,31,0,0,0,0,0,0,170041,174811,177733,182106,183965,186979,9800,6418,8000,7000,6618,11000,0,160241,168393,169733,175106,177347,175979,0.6967,0.7321434782608696,0.7379695652173913,0.7613304347826086,0.7710739130434783,0.7651260869565217,0
3531,50000,0,2,1,26,0,0,-2,-1,-1,0,102800,0,0,2624,45567,46557,0,0,2624,45567,1747,2000,1,102800,0,-2624,-42943,43820,44557,2.056,0.0,-0.05248,-0.85886,0.8764,0.89114,-4
3532,130000,0,1,2,27,0,0,0,0,0,0,32464,33805,34810,35194,35951,36703,1867,1872,1256,1500,1500,1500,0,30597,31933,33554,33694,34451,35203,0.23536153846153846,0.24563846153846153,0.2581076923076923,0.2591846153846154,0.26500769230769233,0.27079230769230767,0
3533,140000,1,1,2,40,0,0,-1,0,0,-2,51270,54000,4117,6817,0,0,4500,4117,3000,0,0,0,0,46770,49883,1117,6817,0,0,0.3340714285714286,0.3563071428571429,0.007978571428571429,0.04869285714285714,0.0,0.0,-3
3534,150000,0,1,1,51,0,0,2,0,0,0,128968,138260,134573,136026,97517,47027,12900,0,5399,4224,1830,1889,1,116068,138260,129174,131802,95687,45138,0.7737866666666666,0.9217333333333333,0.86116,0.87868,0.6379133333333333,0.30092,2
3535,230000,1,2,2,42,0,0,0,0,0,0,64489,58611,54463,53008,52835,40015,3100,5000,5000,10000,3000,5000,0,61389,53611,49463,43008,49835,35015,0.2669086956521739,0.2330913043478261,0.21505652173913042,0.1869913043478261,0.21667391304347827,0.1522391304347826,0
3536,100000,1,1,2,36,0,0,2,0,0,2,10672,11025,5791,3623,5554,5309,2355,0,500,2000,0,1000,0,8317,11025,5291,1623,5554,4309,0.08317,0.11025,0.05291,0.01623,0.05554,0.04309,4
3537,150000,0,3,2,39,1,-1,-1,-2,-2,-2,214450,147280,150000,0,-5000,0,5180,5000,0,0,5000,0,0,209270,142280,150000,0,-10000,0,1.3951333333333333,0.9485333333333333,1.0,0.0,-0.06666666666666667,0.0,-7
3538,80000,1,3,2,25,0,0,0,0,0,0,80804,81390,81700,79080,59873,60520,3000,3058,9013,2200,2200,2500,0,77804,78332,72687,76880,57673,58020,0.97255,0.97915,0.9085875,0.961,0.7209125,0.72525,0
3539,400000,0,2,1,46,0,0,0,0,0,0,113125,98056,141712,123382,125687,128018,8000,128000,5000,5000,5000,5000,1,105125,-29944,136712,118382,120687,123018,0.2628125,-0.07486,0.34178,0.295955,0.3017175,0.307545,0
3540,200000,1,1,2,31,0,0,0,0,0,0,191953,189147,191673,192051,193348,193337,6887,7019,7000,7200,7200,7000,0,185066,182128,184673,184851,186148,186337,0.92533,0.91064,0.923365,0.924255,0.93074,0.931685,0
3541,300000,1,1,2,55,-2,-2,-2,-2,-2,-2,0,0,0,0,0,0,0,0,0,0,0,951,0,0,0,0,0,0,-951,0.0,0.0,0.0,0.0,0.0,-0.00317,-12
3542,70000,1,2,3,24,1,2,0,0,0,0,4177,2657,2752,1048,462,830,0,1500,0,0,1123,0,0,4177,1157,2752,1048,-661,830,0.05967142857142857,0.016528571428571427,0.03931428571428571,0.014971428571428571,-0.009442857142857143,0.011857142857142858,3
3543,100000,0,2,2,26,0,0,0,0,0,0,80117,46939,17841,15317,12630,11750,2683,2500,3000,6000,2500,1000,0,77434,44439,14841,9317,10130,10750,0.77434,0.44439,0.14841,0.09317,0.1013,0.1075,0
3544,390000,0,1,2,28,-1,0,0,0,0,0,10439,25143,35165,44543,45631,45793,15007,10529,10000,1773,2000,1592,0,-4568,14614,25165,42770,43631,44201,-0.011712820512820512,0.037471794871794875,0.06452564102564103,0.10966666666666666,0.11187435897435898,0.11333589743589743,-1
3545,30000,0,1,2,36,0,0,0,0,0,0,9934,10305,1394,1594,566,0,1000,1000,200,0,0,0,0,8934,9305,1194,1594,566,0,0.2978,0.31016666666666665,0.0398,0.05313333333333333,0.018866666666666667,0.0,0
3546,200000,1,1,2,28,-2,-2,-2,-2,-2,-2,0,0,0,0,0,0,0,0,0,0,0,510,0,0,0,0,0,0,-510,0.0,0.0,0.0,0.0,0.0,-0.00255,-12
3547,50000,1,1,2,22,0,0,0,0,0,0,8000,6881,8127,8763,8956,4224,1118,1364,1000,193,89,54,0,6882,5517,7127,8570,8867,4170,0.13764,0.11034,0.14254,0.1714,0.17734,0.0834,0
3548,160000,0,1,1,38,1,-1,-1,-2,-2,-2,0,499,0,0,0,0,499,0,0,0,0,0,1,-499,499,0,0,0,0,-0.00311875,0.00311875,0.0,0.0,0.0,0.0,-7
3549,20000,0,1,2,25,1,2,2,0,0,0,17147,19557,18935,19005,17862,20393,3000,0,653,900,3000,27,0,14147,19557,18282,18105,14862,20366,0.70735,0.97785,0.9141,0.90525,0.7431,1.0183,5
3550,50000,0,2,2,28,0,0,0,0,0,0,48566,47893,48760,22967,39687,23755,2000,2313,813,875,1008,695,0,46566,45580,47947,22092,38679,23060,0.93132,0.9116,0.95894,0.44184,0.77358,0.4612,0
3551,260000,1,3,1,41,0,0,0,0,0,0,264549,227021,233426,230319,127897,118868,10000,12007,9170,4853,4531,3909,1,254549,215014,224256,225466,123366,114959,0.9790346153846153,0.826976923076923,0.862523076923077,0.8671769230769231,0.4744846153846154,0.44215,0
3552,360000,0,1,2,29,-1,-1,-1,-1,0,-1,1360,7995,-7,3651,2085,1102,8035,0,3658,10,1107,584,0,-6675,7995,-3665,3641,978,518,-0.018541666666666668,0.022208333333333333,-0.010180555555555556,0.01011388888888889,0.0027166666666666667,0.0014388888888888889,-5
3553,90000,0,1,1,34,2,0,0,0,0,0,54933,55460,56599,58155,60058,61250,2009,2057,2500,3000,2189,2282,1,52924,53403,54099,55155,57869,58968,0.5880444444444445,0.5933666666666667,0.6011,0.6128333333333333,0.6429888888888889,0.6552,2
3554,120000,0,3,1,36,-2,-2,-2,-2,-2,-2,326,326,326,326,326,652,326,326,326,326,652,0,1,0,0,0,0,-326,652,0.0,0.0,0.0,0.0,-0.0027166666666666667,0.005433333333333333,-12
3555,200000,1,1,1,32,0,0,0,0,0,-1,36154,23885,24718,25213,68126,9636,9216,7013,15000,10000,10000,10000,1,26938,16872,9718,15213,58126,-364,0.13469,0.08436,0.04859,0.076065,0.29063,-0.00182,-1
3556,200000,1,1,2,28,0,0,0,0,0,0,140407,142965,188990,188742,187267,190249,8031,55015,5327,5505,5525,6039,0,132376,87950,183663,183237,181742,184210,0.66188,0.43975,0.918315,0.916185,0.90871,0.92105,0
3557,230000,1,2,1,39,0,0,-2,-2,-2,-2,24510,0,0,0,0,0,0,0,0,0,0,0,1,24510,0,0,0,0,0,0.10656521739130435,0.0,0.0,0.0,0.0,0.0,-8
3558,180000,1,2,2,37,1,2,0,0,0,0,37095,32881,33627,128051,106834,105551,0,3042,109470,4000,4000,7028,0,37095,29839,-75843,124051,102834,98523,0.20608333333333334,0.1657722222222222,-0.42135,0.6891722222222222,0.5713,0.54735,3
3559,140000,1,2,1,37,0,0,0,0,0,0,58075,59504,61544,62925,64280,67079,3000,3000,3000,3000,4000,4000,1,55075,56504,58544,59925,60280,63079,0.39339285714285716,0.4036,0.4181714285714286,0.4280357142857143,0.43057142857142855,0.4505642857142857,0
3560,70000,1,2,2,22,0,0,0,0,0,0,53399,49108,49674,44568,31156,30954,1841,2243,1467,1076,1096,1494,0,51558,46865,48207,43492,30060,29460,0.7365428571428572,0.6695,0.6886714285714286,0.6213142857142857,0.42942857142857144,0.4208571428571429,0
3561,60000,1,2,1,37,2,2,2,2,2,2,42101,43594,44700,45465,46215,47125,2500,2100,1800,1800,1800,2000,1,39601,41494,42900,43665,44415,45125,0.6600166666666667,0.6915666666666667,0.715,0.72775,0.74025,0.7520833333333333,12
3562,200000,0,1,2,30,-2,-2,-2,-2,-2,-2,0,0,0,0,0,0,0,0,0,0,0,0,0,0,0,0,0,0,0,0.0,0.0,0.0,0.0,0.0,0.0,-12
3563,180000,0,1,1,45,1,-2,-2,-2,-2,-2,0,0,0,0,0,0,0,0,0,0,0,0,1,0,0,0,0,0,0,0.0,0.0,0.0,0.0,0.0,0.0,-9
3564,210000,1,1,2,34,-1,-1,-1,-1,-1,-1,5081,4053,3853,3942,2338,1767,4055,3856,3945,2338,1767,0,0,1026,197,-92,1604,571,1767,0.004885714285714286,0.0009380952380952381,-0.0004380952380952381,0.007638095238095238,0.002719047619047619,0.008414285714285714,-6
3565,80000,1,3,1,46,0,0,0,0,0,0,70324,66864,32990,30059,28786,29371,3000,2003,1500,1200,1200,1500,1,67324,64861,31490,28859,27586,27871,0.84155,0.8107625,0.393625,0.3607375,0.344825,0.3483875,0
3566,360000,0,1,2,45,-1,-1,-1,-1,-1,-2,287,29646,9251,18860,-40,-40,29794,9297,18954,0,0,0,0,-29507,20349,-9703,18860,-40,-40,-0.08196388888888889,0.056525,-0.026952777777777777,0.05238888888888889,-0.00011111111111111112,-0.00011111111111111112,-7
3567,180000,0,3,1,43,-1,-1,-1,-1,-1,-1,3690,15618,4685,238,218,6690,15682,4699,238,218,6710,11949,1,-11992,10919,4447,20,-6492,-5259,-0.06662222222222222,0.06066111111111111,0.024705555555555557,0.00011111111111111112,-0.036066666666666664,-0.029216666666666665,-6
3568,360000,1,2,1,43,-1,-1,-1,-1,-1,-1,1999,10145,4005,19158,3569,31171,10145,4723,19158,3569,31171,3283,1,-8146,5422,-15153,15589,-27602,27888,-0.022627777777777778,0.015061111111111112,-0.042091666666666666,0.04330277777777778,-0.07667222222222222,0.07746666666666667,-6
3569,70000,0,1,2,24,0,0,0,0,0,-1,12109,15328,16854,16741,15154,6060,5328,4000,3000,3007,6060,5133,0,6781,11328,13854,13734,9094,927,0.09687142857142857,0.16182857142857143,0.1979142857142857,0.1962,0.1299142857142857,0.013242857142857143,-1
3570,80000,1,2,1,50,-1,-1,-1,0,0,0,2587,2587,50097,48753,50000,49209,2587,50097,2000,2000,1933,1700,1,0,-47510,48097,46753,48067,47509,0.0,-0.593875,0.6012125,0.5844125,0.6008375,0.5938625,-3
3571,410000,0,2,1,36,-2,-2,-2,-2,-2,-2,41116,38144,31177,27185,13818,8477,5071,3041,3096,3845,212,3,1,36045,35103,28081,23340,13606,8474,0.08791463414634146,0.08561707317073171,0.06849024390243902,0.056926829268292685,0.033185365853658534,0.02066829268292683,-12
3572,360000,1,2,1,48,0,0,0,0,0,0,226430,231878,234192,190211,173557,146511,9100,7300,5800,5600,5600,4100,1,217330,224578,228392,184611,167957,142411,0.6036944444444444,0.6238277777777778,0.6344222222222222,0.5128083333333333,0.4665472222222222,0.39558611111111114,0
3573,210000,0,2,1,53,1,-1,2,-1,-1,-1,-197,3195,1821,1683,0,1986,3392,2,1683,0,1986,1188,1,-3589,3193,138,1683,-1986,798,-0.01709047619047619,0.015204761904761905,0.0006571428571428571,0.008014285714285715,-0.009457142857142857,0.0038,-1
3574,110000,1,2,2,28,0,0,0,-2,-2,-2,5660,1150,0,0,0,0,2000,0,0,0,0,0,0,3660,1150,0,0,0,0,0.03327272727272727,0.010454545454545454,0.0,0.0,0.0,0.0,-6
3575,20000,0,1,2,28,0,0,0,0,0,0,7032,14244,14065,16161,11106,12500,12500,3000,4000,2000,2000,5000,0,-5468,11244,10065,14161,9106,7500,-0.2734,0.5622,0.50325,0.70805,0.4553,0.375,0
3576,160000,1,2,1,42,2,2,-2,-2,-2,-2,346,0,0,0,0,0,0,0,0,0,0,0,1,346,0,0,0,0,0,0.0021625,0.0,0.0,0.0,0.0,0.0,-4
3577,30000,0,3,1,47,0,0,0,0,0,0,28923,29803,25373,23231,23913,21120,1586,1365,1663,5106,1050,0,1,27337,28438,23710,18125,22863,21120,0.9112333333333333,0.9479333333333333,0.7903333333333333,0.6041666666666666,0.7621,0.704,0
3578,140000,1,1,2,32,0,0,0,0,0,0,112933,114564,118713,121248,123232,126242,5000,6000,6000,5500,5000,6000,0,107933,108564,112713,115748,118232,120242,0.77095,0.7754571428571428,0.8050928571428572,0.8267714285714286,0.8445142857142857,0.8588714285714286,0
3579,60000,1,2,2,48,-2,-2,-2,-1,0,0,53044,51158,29452,1696,38585,38884,1607,1675,1696,38000,1500,1400,0,51437,49483,27756,-36304,37085,37484,0.8572833333333333,0.8247166666666667,0.4626,-0.6050666666666666,0.6180833333333333,0.6247333333333334,-7
3580,30000,0,2,2,47,0,0,0,0,0,0,29554,28893,29537,30087,17534,15145,1895,1539,1089,718,400,5000,0,27659,27354,28448,29369,17134,10145,0.9219666666666667,0.9118,0.9482666666666667,0.9789666666666667,0.5711333333333334,0.33816666666666667,0
3581,20000,1,3,2,54,0,0,0,0,0,0,16120,17160,18083,15096,15396,15720,1308,1231,1244,544,565,1500,0,14812,15929,16839,14552,14831,14220,0.7406,0.79645,0.84195,0.7276,0.74155,0.711,0
3582,400000,1,1,1,31,-1,-1,-1,-1,-1,-1,5581,2833,1162,325,325,325,2833,1162,325,325,325,325,1,2748,1671,837,0,0,0,0.00687,0.0041775,0.0020925,0.0,0.0,0.0,-6
3583,230000,1,1,2,31,0,0,0,0,0,0,81734,82238,80623,90997,62063,62003,3687,4539,2220,3214,2407,2061,0,78047,77699,78403,87783,59656,59942,0.33933478260869565,0.3378217391304348,0.3408826086956522,0.3816652173913043,0.2593739130434783,0.2606173913043478,0
3584,300000,1,1,2,31,0,0,0,-1,-1,0,34515,60700,33843,5045,10288,12565,30000,5000,5045,10288,5000,5000,0,4515,55700,28798,-5243,5288,7565,0.01505,0.18566666666666667,0.09599333333333333,-0.017476666666666668,0.017626666666666665,0.025216666666666665,-2
3585,500000,1,2,1,36,0,0,0,0,0,-1,4952,6607,8544,15351,5839,9192,3008,4005,8048,131,9213,111,1,1944,2602,496,15220,-3374,9081,0.003888,0.005204,0.000992,0.03044,-0.006748,0.018162,-1
3586,280000,0,2,1,53,0,0,0,0,0,-1,278127,42518,31900,21342,11500,2000,1700,1500,1400,2000,2000,2900,1,276427,41018,30500,19342,9500,-900,0.9872392857142858,0.14649285714285715,0.10892857142857143,0.06907857142857143,0.033928571428571426,-0.0032142857142857142,-1
3587,70000,1,1,2,28,2,2,2,2,2,2,59794,58267,63931,64585,66207,67577,0,6672,2300,2800,2600,0,0,59794,51595,61631,61785,63607,67577,0.8542,0.7370714285714286,0.8804428571428572,0.8826428571428572,0.9086714285714286,0.9653857142857143,12
3588,210000,0,2,1,44,-2,-2,-2,-2,-2,-2,245,245,141,-104,-104,-104,245,141,88,0,0,0,1,0,104,53,-104,-104,-104,0.0,0.0004952380952380952,0.0002523809523809524,-0.0004952380952380952,-0.0004952380952380952,-0.0004952380952380952,-12
3589,210000,1,3,2,36,0,0,0,0,0,0,203447,206683,99411,63322,73433,75381,6549,4500,2407,12700,3200,4000,0,196898,202183,97004,50622,70233,71381,0.9376095238095238,0.9627761904761905,0.4619238095238095,0.24105714285714286,0.33444285714285715,0.33990952380952383,0
3590,30000,1,1,2,22,0,0,0,0,0,0,29362,29819,30582,28983,27947,26630,1800,3000,1404,559,533,1000,0,27562,26819,29178,28424,27414,25630,0.9187333333333333,0.8939666666666667,0.9726,0.9474666666666667,0.9138,0.8543333333333333,0
3591,280000,0,1,1,38,1,-1,-1,-1,-1,-1,4608,5393,2369,3700,5024,5188,5410,2380,3709,5849,5606,5299,1,-802,3013,-1340,-2149,-582,-111,-0.002864285714285714,0.010760714285714285,-0.0047857142857142855,-0.007675,-0.0020785714285714288,-0.00039642857142857145,-4
3592,100000,0,2,1,36,0,0,0,0,0,0,46202,47239,48258,49218,99677,51738,1784,1803,1763,1843,4654,2297,1,44418,45436,46495,47375,95023,49441,0.44418,0.45436,0.46495,0.47375,0.95023,0.49441,0
3593,70000,0,2,1,42,4,4,4,4,4,4,59130,59831,61873,63359,64221,65706,2272,3614,3100,2500,3100,1000,1,56858,56217,58773,60859,61121,64706,0.8122571428571429,0.8031,0.8396142857142858,0.8694142857142857,0.8731571428571429,0.9243714285714286,24
3594,280000,0,1,1,35,0,0,0,0,0,2,59188,146368,244092,210226,177595,153181,100000,101585,90762,50119,282,50436,1,-40812,44783,153330,160107,177313,102745,-0.14575714285714286,0.1599392857142857,0.5476071428571428,0.5718107142857143,0.6332607142857143,0.36694642857142856,2
3595,200000,1,1,2,35,-2,-2,-2,-2,-2,-2,441,0,3514,4042,8606,1870,0,3514,4042,8606,1870,10332,0,441,-3514,-528,-4564,6736,-8462,0.002205,-0.01757,-0.00264,-0.02282,0.03368,-0.04231,-12
3596,30000,1,1,2,23,4,4,3,2,3,2,29944,29399,28632,30363,29594,30932,206,0,2500,0,2000,0,0,29738,29399,26132,30363,27594,30932,0.9912666666666666,0.9799666666666667,0.8710666666666667,1.0121,0.9198,1.0310666666666666,18
3597,80000,0,2,2,29,1,2,0,0,0,0,75234,76417,76916,51070,52727,54847,3007,5090,2001,3000,3000,3000,0,72227,71327,74915,48070,49727,51847,0.9028375,0.8915875,0.9364375,0.600875,0.6215875,0.6480875,3
3598,470000,0,1,1,57,0,0,0,0,0,0,83852,85008,83882,66207,65549,60805,3477,4100,2022,2100,2156,1740,1,80375,80908,81860,64107,63393,59065,0.17101063829787233,0.17214468085106382,0.17417021276595746,0.13639787234042552,0.13487872340425533,0.12567021276595744,0
3599,240000,0,2,2,32,1,-2,-2,-2,-2,-2,0,0,0,0,0,0,0,0,0,0,0,0,0,0,0,0,0,0,0,0.0,0.0,0.0,0.0,0.0,0.0,-9
3600,160000,1,3,1,38,2,2,2,2,0,0,113336,116136,118474,115127,111864,102418,6000,5500,0,3700,3200,3400,1,107336,110636,118474,111427,108664,99018,0.67085,0.691475,0.7404625,0.69641875,0.67915,0.6188625,8
3601,50000,1,1,2,29,0,0,2,2,2,2,10532,13145,12637,13922,13556,14528,2800,0,1500,0,1200,0,0,7732,13145,11137,13922,12356,14528,0.15464,0.2629,0.22274,0.27844,0.24712,0.29056,8
3602,440000,1,1,1,37,-1,-1,-1,-1,-1,-1,5302,13333,686,-414,2736,12586,13333,1383,0,3150,13000,5500,1,-8031,11950,686,-3564,-10264,7086,-0.018252272727272728,0.02715909090909091,0.001559090909090909,-0.0081,-0.023327272727272728,0.016104545454545455,-6
3603,240000,1,3,2,37,1,-2,-1,-1,-1,-1,-3,-3,2486,2500,580,490,0,2489,2500,580,490,177,0,-3,-2492,-14,1920,90,313,-1.25e-05,-0.010383333333333333,-5.833333333333333e-05,0.008,0.000375,0.0013041666666666666,-5
3604,440000,0,1,2,29,-2,-2,-1,0,0,0,26430,23509,278956,274859,99618,103884,1249,279048,10758,5000,5080,2515,0,25181,-255539,268198,269859,94538,101369,0.05722954545454546,-0.5807704545454545,0.6095409090909091,0.613315909090909,0.21485909090909092,0.2303840909090909,-5
3605,240000,1,2,2,26,0,0,0,0,0,0,184501,177846,167934,169133,175175,146093,7627,6003,5504,10158,6000,6012,0,176874,171843,162430,158975,169175,140081,0.736975,0.7160125,0.6767916666666667,0.6623958333333333,0.7048958333333334,0.5836708333333334,0
3606,230000,1,1,1,44,1,-1,-1,-1,-1,-2,3884,949,2864,933,0,0,949,2873,933,0,0,0,1,2935,-1924,1931,933,0,0,0.012760869565217391,-0.008365217391304348,0.008395652173913044,0.004056521739130434,0.0,0.0,-5
3607,30000,0,2,2,35,2,0,0,2,2,2,18915,20290,24727,24031,25579,25030,2000,5100,0,1949,0,912,0,16915,15190,24727,22082,25579,24118,0.5638333333333333,0.5063333333333333,0.8242333333333334,0.7360666666666666,0.8526333333333334,0.8039333333333334,8
3608,390000,0,1,1,35,0,0,0,0,0,0,28804,43996,47532,49414,51380,50661,20000,5006,5006,5008,3004,3006,1,8804,38990,42526,44406,48376,47655,0.022574358974358975,0.09997435897435897,0.10904102564102564,0.11386153846153846,0.12404102564102563,0.1221923076923077,0
3609,300000,0,2,1,29,-1,-1,-2,-2,-2,-2,1874,-200,-200,-200,-200,-200,0,0,0,0,0,0,1,1874,-200,-200,-200,-200,-200,0.006246666666666667,-0.0006666666666666666,-0.0006666666666666666,-0.0006666666666666666,-0.0006666666666666666,-0.0006666666666666666,-10
3610,100000,1,2,1,41,0,0,0,0,0,0,111925,107224,107126,101859,79519,74368,4000,7000,3533,2673,3500,4303,1,107925,100224,103593,99186,76019,70065,1.07925,1.00224,1.03593,0.99186,0.76019,0.70065,0
3611,50000,0,2,1,36,1,-2,-2,-2,-2,-1,0,0,0,0,0,2949,0,0,0,0,2322,0,1,0,0,0,0,-2322,2949,0.0,0.0,0.0,0.0,-0.04644,0.05898,-8
3612,360000,1,1,2,27,1,-2,-2,-2,-2,-2,0,0,0,0,0,0,0,0,0,0,0,0,0,0,0,0,0,0,0,0.0,0.0,0.0,0.0,0.0,0.0,-9
3613,330000,0,4,1,33,0,0,0,0,0,0,26586,23818,24164,25042,25665,24059,1700,1522,1400,1000,820,770,1,24886,22296,22764,24042,24845,23289,0.07541212121212121,0.06756363636363637,0.06898181818181819,0.07285454545454545,0.07528787878787879,0.07057272727272727,0
3614,200000,0,1,2,29,-1,-1,-1,0,0,-1,389,389,1167,778,389,389,390,1168,1,1,390,778,0,-1,-779,1166,777,-1,-389,-5e-06,-0.003895,0.00583,0.003885,-5e-06,-0.001945,-4
3615,170000,1,4,1,37,-2,-2,-1,-1,-1,-1,743,0,16474,4650,2359,0,0,16474,4650,2359,0,1977,1,743,-16474,11824,2291,2359,-1977,0.004370588235294117,-0.09690588235294118,0.0695529411764706,0.013476470588235295,0.013876470588235294,-0.011629411764705883,-8
3616,260000,0,1,2,37,0,0,0,0,0,0,36664,22228,39330,39880,78787,52790,1690,19342,15000,53787,22790,3217,0,34974,2886,24330,-13907,55997,49573,0.13451538461538462,0.0111,0.09357692307692307,-0.05348846153846154,0.21537307692307692,0.19066538461538463,0
3617,90000,1,1,2,24,0,0,0,0,0,0,85365,88054,90370,26420,27398,28295,4054,4444,1420,1398,1345,3265,0,81311,83610,88950,25022,26053,25030,0.9034555555555556,0.929,0.9883333333333333,0.2780222222222222,0.2894777777777778,0.2781111111111111,0
3618,230000,1,1,2,24,1,2,0,0,2,0,20887,18705,17295,18335,9320,1858,0,1200,3000,0,254,1637,0,20887,17505,14295,18335,9066,221,0.09081304347826087,0.07610869565217392,0.06215217391304348,0.07971739130434782,0.03941739130434783,0.0009608695652173913,5
3619,50000,0,2,2,22,-1,0,0,2,0,0,5696,6723,8619,8334,8510,8728,1277,2173,0,459,513,161,0,4419,4550,8619,7875,7997,8567,0.08838,0.091,0.17238,0.1575,0.15994,0.17134,1
3620,50000,1,2,2,23,0,0,0,0,0,0,47662,41023,42162,6765,19286,9558,2000,2102,255,3000,191,0,0,45662,38921,41907,3765,19095,9558,0.91324,0.77842,0.83814,0.0753,0.3819,0.19116,0
3621,380000,0,1,1,39,-1,-1,-2,-1,-1,-2,6347,0,0,46350,0,0,0,0,46350,0,0,24000,1,6347,0,-46350,46350,0,-24000,0.016702631578947368,0.0,-0.12197368421052632,0.12197368421052632,0.0,-0.06315789473684211,-8
3622,150000,0,1,2,28,0,-1,-1,-1,0,0,123767,18479,7672,1736,82188,67578,20732,7672,1736,82178,5000,2600,0,103035,10807,5936,-80442,77188,64978,0.6869,0.07204666666666666,0.039573333333333335,-0.53628,0.5145866666666666,0.43318666666666666,-3
3623,80000,1,2,2,23,1,-1,2,-1,-1,-1,998,6858,1879,1145,7328,3703,6861,11,1146,7329,3704,426,0,-5863,6847,733,-6184,3624,3277,-0.0732875,0.0855875,0.0091625,-0.0773,0.0453,0.0409625,-1
3624,200000,1,1,2,27,0,0,0,0,0,0,157607,155693,155290,147604,146719,143317,7194,6760,5018,5370,5294,5300,0,150413,148933,150272,142234,141425,138017,0.752065,0.744665,0.75136,0.71117,0.707125,0.690085,0
3625,500000,0,1,1,45,-1,-1,-1,-1,-1,-1,1366,9489,51322,12150,12463,11872,9543,51322,12176,12463,11872,22547,1,-8177,-41833,39146,-313,591,-10675,-0.016354,-0.083666,0.078292,-0.000626,0.001182,-0.02135,-6
3626,90000,1,2,1,36,1,-2,-2,-2,-2,-1,-191,-191,-191,-191,-191,209,0,0,0,0,550,3780,1,-191,-191,-191,-191,-741,-3571,-0.0021222222222222224,-0.0021222222222222224,-0.0021222222222222224,-0.0021222222222222224,-0.008233333333333334,-0.03967777777777778,-8
3627,190000,0,2,2,28,-2,-2,-2,-2,-2,-2,0,0,0,0,0,0,0,0,0,0,0,0,0,0,0,0,0,0,0,0.0,0.0,0.0,0.0,0.0,0.0,-12
3628,150000,1,2,2,26,2,0,0,0,0,0,56956,58756,59945,60751,62120,63315,2716,2761,2400,2500,2400,1860,0,54240,55995,57545,58251,59720,61455,0.3616,0.3733,0.3836333333333333,0.38834,0.39813333333333334,0.4097,2
3629,350000,1,2,1,35,-1,-1,2,-1,-1,-1,439,884,421,267,575,932,884,0,267,575,932,0,1,-445,884,154,-308,-357,932,-0.0012714285714285714,0.0025257142857142856,0.00044,-0.00088,-0.00102,0.002662857142857143,-3
3630,500000,1,1,2,29,0,0,0,0,-1,-1,28555,33055,42392,36641,12149,426518,5000,10000,5132,12159,426529,20016,0,23555,23055,37260,24482,-414380,406502,0.04711,0.04611,0.07452,0.048964,-0.82876,0.813004,-2
3631,210000,1,1,1,26,1,2,-1,-1,-1,2,5589,2687,3746,5000,5618,3618,14,4062,5005,5618,0,1354,1,5575,-1375,-1259,-618,5618,2264,0.02654761904761905,-0.006547619047619048,-0.005995238095238095,-0.002942857142857143,0.02675238095238095,0.01078095238095238,2
3632,150000,0,3,1,42,0,0,0,0,0,0,148826,148568,151864,147485,106607,98109,6000,6012,5012,5000,4000,4000,1,142826,142556,146852,142485,102607,94109,0.9521733333333333,0.9503733333333333,0.9790133333333333,0.9499,0.6840466666666667,0.6273933333333334,0
3633,110000,0,3,2,46,0,0,0,0,0,0,56700,57875,59044,59756,61004,62213,2681,2724,2287,2362,2374,2454,0,54019,55151,56757,57394,58630,59759,0.4910818181818182,0.5013727272727273,0.5159727272727272,0.5217636363636363,0.533,0.5432636363636364,0
3634,210000,1,3,1,52,-1,-1,-1,-1,-1,-1,65265,38627,142285,22092,35141,56188,39000,150109,180,58000,56200,20000,1,26265,-111482,142105,-35908,-21059,36188,0.12507142857142858,-0.5308666666666667,0.6766904761904762,-0.1709904761904762,-0.10028095238095239,0.17232380952380952,-6
3635,330000,1,2,2,28,0,0,0,0,0,0,37637,38676,40786,41767,42501,43359,1500,2600,1500,1400,1400,1500,0,36137,36076,39286,40367,41101,41859,0.1095060606060606,0.10932121212121212,0.11904848484848485,0.12232424242424242,0.12454848484848485,0.12684545454545454,0
3636,80000,0,1,2,23,0,0,0,0,0,2,59976,60130,59744,44031,48089,44789,2926,2550,1848,6084,38,4,0,57050,57580,57896,37947,48051,44785,0.713125,0.71975,0.7237,0.4743375,0.6006375,0.5598125,2
3637,180000,1,1,2,33,1,-1,-1,-1,-2,-1,0,4163,7683,0,0,9500,4163,7683,200,0,9500,0,0,-4163,-3520,7483,0,-9500,9500,-0.02312777777777778,-0.019555555555555555,0.041572222222222226,0.0,-0.05277777777777778,0.05277777777777778,-5
3638,240000,0,2,1,48,0,-1,-1,-2,-1,-1,3972,783,0,0,3853,29252,783,0,0,3853,29252,16747,1,3189,783,0,-3853,-25399,12505,0.0132875,0.0032625,0.0,-0.016054166666666668,-0.10582916666666667,0.05210416666666667,-6
3639,60000,0,2,1,36,0,0,0,0,0,0,46064,47320,48337,49332,50536,51694,2000,1805,1800,2000,2000,2000,1,44064,45515,46537,47332,48536,49694,0.7344,0.7585833333333334,0.7756166666666666,0.7888666666666667,0.8089333333333333,0.8282333333333334,0
3640,120000,0,3,2,26,0,0,0,0,0,0,88143,83432,78471,77711,79250,55860,6000,4100,3000,3000,2000,0,0,82143,79332,75471,74711,77250,55860,0.684525,0.6611,0.628925,0.6225916666666667,0.64375,0.4655,0
3641,360000,1,3,1,44,-1,-1,-1,-1,-1,-1,2877,1852,2068,2185,9561,321,1861,2078,2361,9608,322,322,1,1016,-226,-293,-7423,9239,-1,0.002822222222222222,-0.0006277777777777778,-0.0008138888888888888,-0.020619444444444444,0.02566388888888889,-2.777777777777778e-06,-6
3642,70000,1,2,2,22,2,2,2,2,0,0,69242,71007,72596,70467,48129,47751,3500,3300,0,2000,2000,2000,0,65742,67707,72596,68467,46129,45751,0.9391714285714285,0.9672428571428572,1.0370857142857144,0.9781,0.6589857142857143,0.6535857142857143,8
3643,390000,1,2,1,45,1,-2,-2,-2,-2,-2,0,0,0,0,0,0,0,0,0,0,0,3971,1,0,0,0,0,0,-3971,0.0,0.0,0.0,0.0,0.0,-0.010182051282051283,-9
3644,400000,1,2,1,29,0,0,0,0,0,0,400134,398857,404205,360199,356656,364089,17000,15029,30000,12000,12000,23000,1,383134,383828,374205,348199,344656,341089,0.957835,0.95957,0.9355125,0.8704975,0.86164,0.8527225,0
3645,90000,1,1,2,25,0,0,0,0,0,0,14550,15205,15523,15850,15849,17309,2000,2000,5000,2000,2000,5000,0,12550,13205,10523,13850,13849,12309,0.13944444444444445,0.14672222222222223,0.11692222222222222,0.15388888888888888,0.15387777777777778,0.13676666666666668,0
3646,240000,0,3,1,41,1,2,2,2,2,-2,101060,104498,106628,102650,0,0,6000,4650,0,0,0,0,1,95060,99848,106628,102650,0,0,0.39608333333333334,0.4160333333333333,0.4442833333333333,0.42770833333333336,0.0,0.0,7
3647,210000,1,1,2,26,0,0,0,0,0,0,23245,8487,17950,18915,19359,21604,3487,10000,2000,1000,3000,1000,0,19758,-1513,15950,17915,16359,20604,0.09408571428571429,-0.007204761904761905,0.07595238095238095,0.08530952380952381,0.0779,0.09811428571428571,0
3648,220000,1,1,1,49,-2,-2,-2,-2,-2,-2,0,0,0,0,4488,540,0,0,0,4488,540,0,1,0,0,0,-4488,3948,540,0.0,0.0,0.0,-0.0204,0.017945454545454546,0.0024545454545454545,-12
3649,210000,0,2,1,35,0,0,0,0,0,0,62809,64781,65847,46992,47073,47283,3018,2824,1757,1674,1717,1741,1,59791,61957,64090,45318,45356,45542,0.2847190476190476,0.2950333333333333,0.3051904761904762,0.2158,0.21598095238095238,0.21686666666666668,0
3650,470000,0,1,1,39,-1,-1,-1,-1,-1,-1,5572,3595,22816,2360,4206,5527,3595,22816,2360,4356,5527,6420,1,1977,-19221,20456,-1996,-1321,-893,0.004206382978723404,-0.04089574468085106,0.04352340425531915,-0.004246808510638298,-0.0028106382978723404,-0.0019,-6
3651,20000,0,3,1,49,0,0,0,0,0,0,11572,27270,14375,15200,20000,16560,2820,4000,1200,5000,10000,0,1,8752,23270,13175,10200,10000,16560,0.4376,1.1635,0.65875,0.51,0.5,0.828,0
3652,150000,1,2,1,43,0,0,0,0,0,0,158844,149298,157537,162697,113925,116382,10004,10009,8014,5008,5012,5000,1,148840,139289,149523,157689,108913,111382,0.9922666666666666,0.9285933333333334,0.99682,1.05126,0.7260866666666667,0.7425466666666667,0
3653,20000,1,2,2,22,-1,3,2,2,0,0,18021,17439,17466,17846,18310,18923,0,600,1000,1000,1000,700,0,18021,16839,16466,16846,17310,18223,0.90105,0.84195,0.8233,0.8423,0.8655,0.91115,6
3654,100000,1,1,2,27,0,0,0,0,0,0,75296,76672,78343,79111,79993,81279,3000,3400,3000,3000,3000,3000,0,72296,73272,75343,76111,76993,78279,0.72296,0.73272,0.75343,0.76111,0.76993,0.78279,0
3655,90000,1,2,2,31,0,0,0,2,2,2,23418,24443,26695,25967,26946,28346,1408,2660,0,1400,2000,1200,0,22010,21783,26695,24567,24946,27146,0.24455555555555555,0.24203333333333332,0.2966111111111111,0.2729666666666667,0.2771777777777778,0.30162222222222224,6
3656,10000,0,1,2,24,0,0,2,0,0,0,7680,10160,9844,9554,9515,9700,2616,0,400,499,500,900,0,5064,10160,9444,9055,9015,8800,0.5064,1.016,0.9444,0.9055,0.9015,0.88,2
3657,280000,1,2,1,39,0,0,2,0,0,0,213738,228963,223810,158542,162244,108143,20300,0,5600,6300,4000,4000,1,193438,228963,218210,152242,158244,104143,0.69085,0.817725,0.7793214285714286,0.5437214285714286,0.5651571428571428,0.3719392857142857,2
3658,150000,1,1,2,36,0,0,0,0,0,0,43544,47751,49096,49848,52007,54161,5000,5000,3000,3000,3000,3500,0,38544,42751,46096,46848,49007,50661,0.25696,0.2850066666666667,0.3073066666666667,0.31232,0.32671333333333336,0.33774,0
3659,50000,1,2,1,29,0,0,0,0,0,0,26052,27631,29128,29707,28825,29022,2000,2000,2500,1033,1053,1034,1,24052,25631,26628,28674,27772,27988,0.48104,0.51262,0.53256,0.57348,0.55544,0.55976,0
3660,140000,0,2,2,48,0,0,2,2,2,0,119965,124944,124901,129675,121292,121343,8506,4706,9463,16,5002,10006,0,111459,120238,115438,129659,116290,111337,0.7961357142857143,0.8588428571428571,0.8245571428571429,0.9261357142857143,0.8306428571428571,0.7952642857142858,6
3661,150000,1,1,2,25,0,0,0,0,0,0,42437,35082,19538,13277,3200,0,2265,2538,277,200,0,0,0,40172,32544,19261,13077,3200,0,0.26781333333333335,0.21696,0.12840666666666667,0.08718,0.021333333333333333,0.0,0
3662,250000,0,2,2,25,2,0,0,0,0,0,28681,30615,33726,36823,34829,23994,3000,4000,4000,5000,4000,2000,0,25681,26615,29726,31823,30829,21994,0.102724,0.10646,0.118904,0.127292,0.123316,0.087976,2
3663,200000,1,1,1,34,-2,-2,-2,-2,-2,-2,0,0,0,0,0,35979,0,0,0,0,35979,6191,1,0,0,0,0,-35979,29788,0.0,0.0,0.0,0.0,-0.179895,0.14894,-12
3664,230000,1,2,1,32,0,0,0,0,2,0,87764,73526,72376,76870,75211,76645,2630,2614,6000,0,3000,2800,1,85134,70912,66376,76870,72211,73845,0.3701478260869565,0.3083130434782609,0.2885913043478261,0.3342173913043478,0.3139608695652174,0.32106521739130434,2
3665,30000,1,1,2,34,1,2,2,2,2,2,24022,24744,24053,25624,25977,25413,1396,0,1967,903,0,1100,0,22626,24744,22086,24721,25977,24313,0.7542,0.8248,0.7362,0.8240333333333333,0.8659,0.8104333333333333,11
3666,130000,0,2,1,38,0,0,0,0,-2,-2,233617,115431,35400,0,0,0,10000,5000,0,0,0,0,1,223617,110431,35400,0,0,0,1.7201307692307692,0.8494692307692308,0.2723076923076923,0.0,0.0,0.0,-4
3667,170000,0,1,2,29,1,-2,-2,-2,-1,-1,0,0,0,0,1015,0,0,0,0,1015,0,0,0,0,0,0,-1015,1015,0,0.0,0.0,0.0,-0.005970588235294117,0.005970588235294117,0.0,-7
3668,120000,0,1,2,34,1,-1,-1,-2,-1,2,-325,279,-117,-513,1091,545,1000,0,0,2000,0,550,0,-1325,279,-117,-2513,1091,-5,-0.011041666666666667,0.002325,-0.000975,-0.020941666666666667,0.009091666666666666,-4.1666666666666665e-05,-2
3669,120000,1,1,2,45,0,0,0,0,0,2,90041,86140,87941,89737,95451,97379,3079,3185,3251,7200,3600,3900,0,86962,82955,84690,82537,91851,93479,0.7246833333333333,0.6912916666666666,0.70575,0.6878083333333334,0.765425,0.7789916666666666,2
3670,240000,1,1,1,36,-1,-1,-1,-1,-1,-1,12181,6746,12104,2788,4084,3288,6746,12104,2788,4084,3288,4788,1,5435,-5358,9316,-1296,796,-1500,0.022645833333333334,-0.022325,0.038816666666666666,-0.0054,0.0033166666666666665,-0.00625,-6
3671,30000,1,2,1,29,1,2,2,2,2,2,16609,16057,18089,17504,18727,18279,0,2300,0,1500,0,1500,1,16609,13757,18089,16004,18727,16779,0.5536333333333333,0.4585666666666667,0.6029666666666667,0.5334666666666666,0.6242333333333333,0.5593,11
3672,180000,0,4,1,34,-2,-2,-2,-2,-2,-2,0,0,0,0,0,0,0,0,0,0,0,0,1,0,0,0,0,0,0,0.0,0.0,0.0,0.0,0.0,0.0,-12
3673,280000,0,3,1,46,-1,-1,-1,0,0,0,14186,2752,41673,33715,16955,13500,2836,41721,2090,356,67,8162,1,11350,-38969,39583,33359,16888,5338,0.040535714285714286,-0.139175,0.14136785714285716,0.11913928571428571,0.060314285714285716,0.019064285714285714,-3
3674,500000,0,1,2,29,-1,-1,-1,-1,-1,-1,8898,1276,24031,41305,5405,32310,1283,24174,41306,5455,36914,12457,0,7615,-22898,-17275,35850,-31509,19853,0.01523,-0.045796,-0.03455,0.0717,-0.063018,0.039706,-6
3675,160000,1,2,2,24,0,0,0,0,0,0,52373,51839,39847,39114,39935,41269,1676,1940,1400,1451,2000,1533,0,50697,49899,38447,37663,37935,39736,0.31685625,0.31186875,0.24029375,0.23539375,0.23709375,0.24835,0
3676,50000,0,3,1,46,0,0,0,2,0,0,11401,12506,14774,14233,14744,15252,1300,3000,0,1000,1000,3000,1,10101,9506,14774,13233,13744,12252,0.20202,0.19012,0.29548,0.26466,0.27488,0.24504,2
3677,170000,1,2,2,27,1,-1,0,0,0,0,-1020,25607,23922,24399,24919,26884,27107,1500,863,903,3000,6186,0,-28127,24107,23059,23496,21919,20698,-0.16545294117647058,0.14180588235294117,0.13564117647058824,0.13821176470588234,0.12893529411764706,0.12175294117647059,0
3678,50000,1,2,2,29,2,2,2,2,0,0,48286,49286,50006,48846,45944,46925,2100,1800,0,1624,1700,3000,0,46186,47486,50006,47222,44244,43925,0.92372,0.94972,1.00012,0.94444,0.88488,0.8785,8
3679,390000,1,1,2,28,0,0,0,0,0,0,286888,291645,277888,175268,167781,147878,11000,11000,5600,5700,5600,3400,0,275888,280645,272288,169568,162181,144478,0.7074051282051282,0.7196025641025641,0.698174358974359,0.4347897435897436,0.41584871794871797,0.37045641025641024,0
3680,260000,0,2,2,31,0,0,0,0,0,0,3113,3117,2924,2784,2413,902,1300,1100,1000,300,0,1261,0,1813,2017,1924,2484,2413,-359,0.006973076923076923,0.0077576923076923075,0.0074,0.009553846153846154,0.009280769230769231,-0.0013807692307692308,0
3681,130000,0,1,2,28,2,2,2,-2,-2,-2,114144,102650,0,0,0,0,0,0,0,0,0,0,0,114144,102650,0,0,0,0,0.8780307692307693,0.7896153846153846,0.0,0.0,0.0,0.0,0
3682,110000,1,3,2,29,1,2,0,0,0,0,23258,22591,23920,25217,25600,26036,0,2000,2000,1100,1000,3000,0,23258,20591,21920,24117,24600,23036,0.21143636363636364,0.1871909090909091,0.19927272727272727,0.21924545454545455,0.22363636363636363,0.2094181818181818,3
3683,300000,0,1,1,37,-2,-2,-2,-1,-1,-2,19954,22492,20477,27206,37191,7543,23348,20477,27206,177202,7543,13719,1,-3394,2015,-6729,-149996,29648,-6176,-0.011313333333333333,0.006716666666666667,-0.02243,-0.4999866666666667,0.09882666666666666,-0.020586666666666666,-10
3684,200000,1,1,1,30,1,-2,-2,-2,-2,-1,0,0,0,0,0,5659,0,0,0,0,5659,0,1,0,0,0,0,-5659,5659,0.0,0.0,0.0,0.0,-0.028295,0.028295,-8
3685,390000,1,1,2,42,0,0,0,0,0,2,98262,94122,89672,83663,84449,75445,5003,5000,3200,9000,0,5000,0,93259,89122,86472,74663,84449,70445,0.23912564102564102,0.22851794871794873,0.2217230769230769,0.19144358974358974,0.21653589743589743,0.18062820512820513,2
3686,500000,1,2,2,38,-1,-1,-1,-1,-1,-1,18410,-10,1429,-601,120195,976,0,1439,0,120796,981,4829,0,18410,-1449,1429,-121397,119214,-3853,0.03682,-0.002898,0.002858,-0.242794,0.238428,-0.007706,-6
3687,110000,1,2,2,39,0,0,0,0,0,0,111533,110367,112974,108390,107180,107309,5500,5900,5500,5000,5000,4300,0,106033,104467,107474,103390,102180,103009,0.9639363636363636,0.9497,0.9770363636363636,0.9399090909090909,0.9289090909090909,0.9364454545454546,0
3688,210000,1,2,1,35,0,0,-1,-1,-1,0,25806,5861,1666,1010,300,300,1035,1666,1010,300,0,4817,1,24771,4195,656,710,300,-4517,0.11795714285714286,0.019976190476190477,0.003123809523809524,0.0033809523809523808,0.0014285714285714286,-0.021509523809523808,-3
3689,50000,0,2,2,23,0,0,-1,-1,-2,-2,30101,0,780,0,0,0,434,780,0,0,0,0,0,29667,-780,780,0,0,0,0.59334,-0.0156,0.0156,0.0,0.0,0.0,-6
3690,110000,1,2,2,31,0,0,0,0,0,0,98006,93978,93066,88823,78144,78169,4300,4295,3000,2887,3000,3034,0,93706,89683,90066,85936,75144,75135,0.8518727272727272,0.8153,0.8187818181818182,0.7812363636363636,0.6831272727272727,0.6830454545454545,0
3691,220000,0,2,2,31,1,2,0,0,0,0,224244,210290,179645,166753,82058,20650,0,6800,6640,4100,1100,0,0,224244,203490,173005,162653,80958,20650,1.019290909090909,0.9249545454545455,0.7863863636363636,0.7393318181818181,0.3679909090909091,0.09386363636363636,3
3692,230000,1,1,1,36,-2,-2,-2,-2,-2,-2,0,1663,4777,1755,2442,2724,1663,4777,1763,2445,2727,17136,1,-1663,-3114,3014,-690,-285,-14412,-0.007230434782608696,-0.01353913043478261,0.013104347826086956,-0.003,-0.0012391304347826087,-0.0626608695652174,-12
3693,270000,1,2,1,33,0,0,0,0,0,0,121065,96197,92217,94082,96367,97793,3500,3349,3400,3800,3300,2601,1,117565,92848,88817,90282,93067,95192,0.43542592592592594,0.34388148148148145,0.32895185185185183,0.3343777777777778,0.3446925925925926,0.35256296296296297,0
3694,360000,1,2,1,35,0,-1,-1,-1,-1,-1,106010,24892,10772,21847,21835,9255,24976,10786,21916,21904,9261,22127,1,81034,14106,-11144,-57,12574,-12872,0.22509444444444446,0.039183333333333334,-0.030955555555555556,-0.00015833333333333332,0.03492777777777778,-0.035755555555555554,-5
3695,70000,1,4,1,24,0,0,0,-2,-2,-2,47663,47470,0,0,0,0,1000,0,0,0,0,0,1,46663,47470,0,0,0,0,0.6666142857142857,0.6781428571428572,0.0,0.0,0.0,0.0,-6
3696,10000,1,2,1,41,3,2,2,7,7,7,2400,2400,2400,2400,2400,2400,0,0,0,0,0,0,1,2400,2400,2400,2400,2400,2400,0.24,0.24,0.24,0.24,0.24,0.24,28
3697,80000,0,2,1,44,-1,-1,0,-1,0,0,1798,2302,1604,3612,2608,1604,2310,1100,3612,600,600,1631,1,-512,1202,-2008,3012,2008,-27,-0.0064,0.015025,-0.0251,0.03765,0.0251,-0.0003375,-3
3698,20000,0,2,2,24,0,0,2,0,0,0,15886,16337,16470,10195,11195,11995,2500,800,1500,1000,800,6720,0,13386,15537,14970,9195,10395,5275,0.6693,0.77685,0.7485,0.45975,0.51975,0.26375,2
3699,100000,1,2,2,27,0,0,0,0,0,0,48051,49247,48799,49508,50686,51815,2000,2200,1822,2000,2100,2100,0,46051,47047,46977,47508,48586,49715,0.46051,0.47047,0.46977,0.47508,0.48586,0.49715,0
3700,400000,0,1,1,54,-2,-2,-2,-2,-2,-2,1348,21411,-25,4895,48976,15319,21532,0,4920,49221,15395,0,1,-20184,21411,-4945,-44326,33581,15319,-0.05046,0.0535275,-0.0123625,-0.110815,0.0839525,0.0382975,-12
3701,50000,0,3,1,54,0,0,0,0,0,0,38607,39681,40717,41682,42857,45581,2000,2000,1642,2000,3600,0,1,36607,37681,39075,39682,39257,45581,0.73214,0.75362,0.7815,0.79364,0.78514,0.91162,0
3702,50000,1,2,1,37,2,2,3,3,3,3,1050,1050,1050,1050,1050,1050,0,0,0,0,0,0,1,1050,1050,1050,1050,1050,1050,0.021,0.021,0.021,0.021,0.021,0.021,16
3703,260000,1,2,1,30,0,0,0,0,0,0,147565,149777,151583,155493,158624,161902,7129,5179,5276,4537,4670,4717,1,140436,144598,146307,150956,153954,157185,0.5401384615384616,0.5561461538461538,0.5627192307692308,0.5806,0.5921307692307692,0.6045576923076923,0
3704,210000,1,1,2,36,-2,-2,-2,-1,-1,-1,14516,4895,5292,8866,16809,5794,4915,5292,8872,16876,5794,2415,0,9601,-397,-3580,-8010,11015,3379,0.04571904761904762,-0.0018904761904761905,-0.017047619047619048,-0.038142857142857145,0.05245238095238095,0.01609047619047619,-9
3705,10000,0,2,2,25,0,0,0,0,0,0,3684,4715,5785,7134,3535,4323,1100,1155,1500,1000,1000,1000,0,2584,3560,4285,6134,2535,3323,0.2584,0.356,0.4285,0.6134,0.2535,0.3323,0
3706,30000,1,2,1,49,0,0,0,0,2,2,23705,24709,25745,27949,27216,29138,1386,1422,2626,0,2351,1033,1,22319,23287,23119,27949,24865,28105,0.7439666666666667,0.7762333333333333,0.7706333333333333,0.9316333333333333,0.8288333333333333,0.9368333333333333,4
3707,150000,1,1,2,37,-1,-1,-2,-2,-2,-2,2195,0,0,0,0,0,0,0,0,0,0,0,0,2195,0,0,0,0,0,0.014633333333333333,0.0,0.0,0.0,0.0,0.0,-10
3708,230000,1,1,2,33,-2,-2,-2,-2,-2,-2,5869,11556,156,2403,1546,7915,11556,156,2403,1546,7915,0,0,-5687,11400,-2247,857,-6369,7915,-0.024726086956521738,0.049565217391304345,-0.009769565217391304,0.003726086956521739,-0.027691304347826087,0.03441304347826087,-12
3709,160000,0,2,2,37,0,0,0,0,0,0,119165,118392,117553,113256,112678,111924,6008,6011,3606,3803,4003,3311,0,113157,112381,113947,109453,108675,108613,0.70723125,0.70238125,0.71216875,0.68408125,0.67921875,0.67883125,0
3710,110000,1,3,1,39,0,0,0,0,0,0,73064,70373,71730,73208,75095,72530,3900,3200,2600,3000,3100,3100,1,69164,67173,69130,70208,71995,69430,0.6287636363636364,0.6106636363636364,0.6284545454545455,0.6382545454545454,0.6545,0.6311818181818182,0
3711,200000,0,2,2,35,0,0,0,0,0,0,87750,89618,91499,93317,96110,98906,3000,3000,3000,4000,4000,5000,0,84750,86618,88499,89317,92110,93906,0.42375,0.43309,0.442495,0.446585,0.46055,0.46953,0
3712,50000,0,2,1,45,0,0,0,0,0,0,50297,49944,48030,32097,31450,29695,1939,1547,1464,1078,1225,1500,1,48358,48397,46566,31019,30225,28195,0.96716,0.96794,0.93132,0.62038,0.6045,0.5639,0
3713,500000,0,2,2,32,-2,-2,-2,-2,-2,-2,71731,75357,62407,63706,59452,47868,25487,80389,50132,22208,30167,25036,0,46244,-5032,12275,41498,29285,22832,0.092488,-0.010064,0.02455,0.082996,0.05857,0.045664,-12
3714,360000,0,2,1,36,-1,-1,-1,-1,-1,-1,6783,2337,10990,74562,-28,5677,2347,11046,74934,0,5705,8503,1,4436,-8709,-63944,74562,-5733,-2826,0.012322222222222222,-0.024191666666666667,-0.1776222222222222,0.20711666666666667,-0.015925,-0.00785,-6
3715,90000,0,2,2,33,0,0,0,0,0,0,60881,65215,66748,70101,80611,89870,5000,2200,4035,12200,10000,0,0,55881,63015,62713,57901,70611,89870,0.6209,0.7001666666666667,0.6968111111111112,0.6433444444444445,0.7845666666666666,0.9985555555555555,0
3716,10000,0,3,2,24,1,-1,0,-1,0,0,-372,4253,1777,780,780,0,5253,1500,780,0,0,0,0,-5625,2753,997,780,780,0,-0.5625,0.2753,0.0997,0.078,0.078,0.0,-1
3717,630000,1,1,1,31,0,0,0,0,0,0,447263,458762,470298,480587,385587,373910,20000,20000,20000,15000,15000,15000,1,427263,438762,450298,465587,370587,358910,0.6781952380952381,0.6964476190476191,0.7147587301587301,0.7390269841269841,0.5882333333333334,0.5696984126984127,0
3718,90000,1,1,1,41,-1,-1,-1,-1,-1,-1,6160,3274,6190,307,2870,670,3276,6246,307,2870,670,1362,1,2884,-2972,5883,-2563,2200,-692,0.032044444444444445,-0.033022222222222224,0.06536666666666667,-0.02847777777777778,0.024444444444444446,-0.007688888888888889,-6
3719,80000,1,2,2,25,-1,-1,-1,-1,-1,-1,3002,1921,13454,1807,3560,3337,1921,13454,1807,3560,3337,6240,0,1081,-11533,11647,-1753,223,-2903,0.0135125,-0.1441625,0.1455875,-0.0219125,0.0027875,-0.0362875,-6
3720,360000,1,1,2,30,-1,-1,0,0,-1,-1,23725,45913,80945,54064,52342,33074,61137,79800,42015,53710,33074,119504,0,-37412,-33887,38930,354,19268,-86430,-0.10392222222222222,-0.09413055555555555,0.1081388888888889,0.0009833333333333332,0.05352222222222222,-0.24008333333333334,-4
3721,90000,1,3,1,49,0,0,0,0,0,-1,10242,10930,10549,9421,6851,2133,2006,2012,3022,2020,2139,2006,1,8236,8918,7527,7401,4712,127,0.09151111111111111,0.09908888888888889,0.08363333333333334,0.08223333333333334,0.05235555555555556,0.001411111111111111,-1
3722,50000,1,2,2,22,1,2,0,0,0,2,5139,4911,5924,6822,7411,9146,0,1102,1000,1000,2000,3000,0,5139,3809,4924,5822,5411,6146,0.10278,0.07618,0.09848,0.11644,0.10822,0.12292,5
3723,160000,1,3,1,38,-2,-2,-2,-2,-2,-2,0,0,0,0,0,0,0,0,0,0,0,0,1,0,0,0,0,0,0,0.0,0.0,0.0,0.0,0.0,0.0,-12
3724,30000,1,2,2,24,-1,0,0,0,0,0,1513,27350,28561,29684,32650,34299,26500,2048,2000,3769,5007,2007,0,-24987,25302,26561,25915,27643,32292,-0.8329,0.8434,0.8853666666666666,0.8638333333333333,0.9214333333333333,1.0764,-1
3725,80000,0,2,1,39,2,0,0,0,0,0,59999,61205,62620,63870,64114,65932,2800,3000,2901,2500,3000,5202,1,57199,58205,59719,61370,61114,60730,0.7149875,0.7275625,0.7464875,0.767125,0.763925,0.759125,2
3726,80000,0,2,2,35,1,-2,-2,-1,-1,-1,0,0,0,19980,173,0,0,0,19980,173,0,0,0,0,0,-19980,19807,173,0,0.0,0.0,-0.24975,0.2475875,0.0021625,0.0,-6
3727,50000,1,1,1,29,0,0,0,0,0,0,29719,30754,31939,33102,33918,35197,1815,2000,2000,1500,2000,1500,1,27904,28754,29939,31602,31918,33697,0.55808,0.57508,0.59878,0.63204,0.63836,0.67394,0
3728,160000,1,3,1,28,0,0,0,0,0,0,38660,38942,39787,40069,37647,38268,2500,1877,2000,3000,1400,5000,1,36160,37065,37787,37069,36247,33268,0.226,0.23165625,0.23616875,0.23168125,0.22654375,0.207925,0
3729,80000,1,1,2,28,0,0,0,0,2,2,9782,11620,14415,16177,16582,16178,2001,3000,2000,800,0,600,0,7781,8620,12415,15377,16582,15578,0.0972625,0.10775,0.1551875,0.1922125,0.207275,0.194725,4
3730,90000,1,3,2,29,-1,2,-1,-1,-1,-2,19450,3123,2121,3113,0,0,0,3509,3113,0,0,0,0,19450,-386,-992,3113,0,0,0.21611111111111111,-0.004288888888888889,-0.011022222222222221,0.03458888888888889,0.0,0.0,-4
3731,160000,0,2,1,37,2,-1,-1,-1,-1,-1,833,833,833,833,833,833,833,833,833,833,833,833,1,0,0,0,0,0,0,0.0,0.0,0.0,0.0,0.0,0.0,-3
3732,150000,0,1,1,46,2,2,2,2,2,2,148364,150565,150254,64644,40150,41250,5400,5026,1722,1500,3000,108058,1,142964,145539,148532,63144,37150,-66808,0.9530933333333333,0.97026,0.9902133333333333,0.42096,0.24766666666666667,-0.44538666666666665,12
3733,500000,0,2,1,41,0,0,0,0,0,0,478623,466444,239921,184874,47774,34617,14000,12800,4300,3063,3600,3100,1,464623,453644,235621,181811,44174,31517,0.929246,0.907288,0.471242,0.363622,0.088348,0.063034,0
3734,220000,1,2,1,35,0,0,0,0,0,0,100252,102510,107102,27361,29340,33933,3500,6000,3000,2340,5000,2000,1,96752,96510,104102,25021,24340,31933,0.43978181818181816,0.4386818181818182,0.4731909090909091,0.11373181818181818,0.11063636363636363,0.14515,0
3735,200000,1,2,1,50,-2,-2,-1,-1,-1,-1,0,0,1350,0,1265,0,0,1350,0,1265,0,0,1,0,-1350,1350,-1265,1265,0,0.0,-0.00675,0.00675,-0.006325,0.006325,0.0,-8
3736,50000,1,2,1,44,0,0,0,0,0,0,27321,24726,22581,20192,18813,17328,1415,1500,700,700,629,488,1,25906,23226,21881,19492,18184,16840,0.51812,0.46452,0.43762,0.38984,0.36368,0.3368,0
3737,200000,1,1,2,35,0,0,0,0,0,0,75203,77949,74865,72766,70444,69003,4000,4000,5012,4000,3000,4000,0,71203,73949,69853,68766,67444,65003,0.356015,0.369745,0.349265,0.34383,0.33722,0.325015,0
3738,100000,1,2,1,58,2,2,0,0,0,0,87851,85594,87095,88357,77155,80108,0,3300,2839,3000,4000,2000,1,87851,82294,84256,85357,73155,78108,0.87851,0.82294,0.84256,0.85357,0.73155,0.78108,4
3739,160000,1,2,2,40,1,-1,-1,-1,-1,-1,0,372,-7,3298,455,-325,372,0,3305,455,0,0,0,-372,372,-3312,2843,455,-325,-0.002325,0.002325,-0.0207,0.01776875,0.00284375,-0.00203125,-4
3740,200000,1,2,1,43,2,2,2,2,-1,-1,150,150,150,150,2500,0,0,0,0,2500,0,0,1,150,150,150,-2350,2500,0,0.00075,0.00075,0.00075,-0.01175,0.0125,0.0,6
3741,30000,1,2,1,22,2,2,0,0,0,2,28574,14220,14188,7058,7976,7734,0,1230,1000,1000,0,2000,1,28574,12990,13188,6058,7976,5734,0.9524666666666667,0.433,0.4396,0.20193333333333333,0.26586666666666664,0.19113333333333332,6
3742,20000,1,3,2,25,-1,-1,-1,0,0,-2,12547,14699,900,900,0,0,14745,900,0,0,0,0,0,-2198,13799,900,900,0,0,-0.1099,0.68995,0.045,0.045,0.0,0.0,-5
3743,30000,0,2,2,34,0,0,0,0,0,0,29949,24653,29779,29749,30053,29674,6000,12000,6000,6000,5000,5000,0,23949,12653,23779,23749,25053,24674,0.7983,0.4217666666666667,0.7926333333333333,0.7916333333333333,0.8351,0.8224666666666667,0
3744,420000,1,1,1,44,1,2,0,0,0,0,35545,34332,35097,33025,36945,37276,6,3016,1846,5005,2005,1462,1,35539,31316,33251,28020,34940,35814,0.08461666666666667,0.07456190476190476,0.07916904761904762,0.06671428571428571,0.08319047619047619,0.08527142857142857,3
3745,100000,1,3,2,50,0,0,2,0,0,0,84027,88734,86369,89994,89681,89849,7500,0,5001,3390,4000,10000,0,76527,88734,81368,86604,85681,79849,0.76527,0.88734,0.81368,0.86604,0.85681,0.79849,2
3746,360000,1,2,2,33,-1,-1,-2,-2,-2,-2,8552,1118,1227,1541,1389,390,1118,1227,1541,1389,390,390,0,7434,-109,-314,152,999,0,0.02065,-0.0003027777777777778,-0.0008722222222222223,0.0004222222222222222,0.002775,0.0,-10
3747,450000,0,1,1,30,0,0,-2,-2,-2,-2,25244,0,0,0,0,0,0,0,0,0,0,134745,1,25244,0,0,0,0,-134745,0.05609777777777778,0.0,0.0,0.0,0.0,-0.29943333333333333,-8
3748,20000,0,2,2,42,0,0,0,0,0,0,15717,16724,18051,18759,19132,19684,1276,1603,1311,684,860,874,0,14441,15121,16740,18075,18272,18810,0.72205,0.75605,0.837,0.90375,0.9136,0.9405,0
3749,120000,0,3,1,36,-1,-1,-1,-1,-1,0,326,326,326,326,652,326,326,326,326,652,0,290,1,0,0,0,-326,652,36,0.0,0.0,0.0,-0.0027166666666666667,0.005433333333333333,0.0003,-5
3750,80000,1,2,2,34,0,0,0,2,2,2,25935,27210,28783,30003,29385,31401,2000,2338,2000,0,2500,0,0,23935,24872,26783,30003,26885,31401,0.2991875,0.3109,0.3347875,0.3750375,0.3360625,0.3925125,6
3751,20000,1,2,1,30,0,0,0,-1,-1,-2,18354,16419,10419,780,0,0,1225,1015,780,0,0,0,1,17129,15404,9639,780,0,0,0.85645,0.7702,0.48195,0.039,0.0,0.0,-4
3752,200000,1,1,1,39,1,-2,-2,-2,-2,-2,0,0,0,0,0,0,0,0,0,0,0,0,1,0,0,0,0,0,0,0.0,0.0,0.0,0.0,0.0,0.0,-9
3753,150000,0,1,2,32,2,2,2,2,2,2,126115,128860,131426,132703,129080,136996,6300,6100,4900,0,10200,5100,0,119815,122760,126526,132703,118880,131896,0.7987666666666666,0.8184,0.8435066666666666,0.8846866666666666,0.7925333333333333,0.8793066666666667,12
3754,160000,1,3,2,32,-1,-1,-1,-1,-1,-1,1375,3503,2688,2142,7139,1872,3645,2688,2142,7139,1872,10573,0,-2270,815,546,-4997,5267,-8701,-0.0141875,0.00509375,0.0034125,-0.03123125,0.03291875,-0.05438125,-6
3755,130000,1,2,2,22,0,0,0,0,0,0,34970,14867,10341,9788,7193,9006,2012,2000,2290,1005,4078,713,0,32958,12867,8051,8783,3115,8293,0.2535230769230769,0.09897692307692307,0.061930769230769234,0.06756153846153846,0.02396153846153846,0.06379230769230769,0
3756,120000,0,1,1,48,-1,-1,-1,-1,-1,-1,360,360,360,150,870,510,360,360,150,870,510,870,1,0,0,210,-720,360,-360,0.0,0.0,0.00175,-0.006,0.003,-0.003,-6
3757,140000,0,4,2,30,-2,-2,-2,-1,-1,0,2663,1823,1823,1769,84042,89381,1823,1823,1769,85096,9000,4000,0,840,0,54,-83327,75042,85381,0.006,0.0,0.0003857142857142857,-0.5951928571428572,0.5360142857142857,0.6098642857142857,-8
3758,130000,1,2,2,35,0,0,0,0,0,2,42950,44293,45004,46257,49312,50252,2036,1747,2000,3800,1900,1900,0,40914,42546,43004,42457,47412,48352,0.31472307692307694,0.3272769230769231,0.3308,0.3265923076923077,0.3647076923076923,0.37193846153846155,2
3759,240000,0,3,1,40,0,-1,-1,-1,-1,0,8936,1649,2999,2840,4114,5923,1658,3010,2840,4114,3923,3673,1,7278,-1361,159,-1274,191,2250,0.030325,-0.005670833333333333,0.0006625,-0.005308333333333333,0.0007958333333333333,0.009375,-4
3760,360000,0,1,2,26,1,-2,-2,-2,-1,-1,-8,-8,-8,-8,1677,2600,0,0,0,1685,2613,0,0,-8,-8,-8,-1693,-936,2600,-2.2222222222222223e-05,-2.2222222222222223e-05,-2.2222222222222223e-05,-0.004702777777777778,-0.0026,0.007222222222222222,-7
3761,100000,1,1,2,26,0,0,0,-1,-1,2,24459,26726,25669,881,57540,55038,3000,1016,2007,57500,2000,0,0,21459,25710,23662,-56619,55540,55038,0.21459,0.2571,0.23662,-0.56619,0.5554,0.55038,0
3762,100000,1,1,2,24,3,2,2,2,0,0,100016,97562,104365,101783,101603,103457,0,8440,0,3873,7733,0,0,100016,89122,104365,97910,93870,103457,1.00016,0.89122,1.04365,0.9791,0.9387,1.03457,9
3763,70000,0,2,2,31,0,0,2,2,3,2,5942,8176,8891,9522,9084,8792,2500,1000,923,0,0,400,0,3442,7176,7968,9522,9084,8392,0.049171428571428574,0.10251428571428571,0.11382857142857143,0.13602857142857142,0.12977142857142857,0.11988571428571429,9
3764,80000,0,2,1,28,2,2,2,2,2,0,65499,63882,67741,69355,65139,60345,0,5000,3200,7,2309,3862,1,65499,58882,64541,69348,62830,56483,0.8187375,0.736025,0.8067625,0.86685,0.785375,0.7060375,10
3765,20000,1,2,1,46,1,2,0,0,-2,-2,3098,2901,3800,0,0,0,0,1000,0,0,0,0,1,3098,1901,3800,0,0,0,0.1549,0.09505,0.19,0.0,0.0,0.0,-1
3766,340000,0,3,1,48,0,0,0,0,0,0,4726,5178,65826,63877,53845,51983,1379,61883,2147,1855,1774,1541,1,3347,-56705,63679,62022,52071,50442,0.009844117647058824,-0.16677941176470587,0.18729117647058824,0.18241764705882352,0.15315,0.14835882352941177,0
3767,100000,0,1,2,30,1,2,0,0,0,0,94432,92080,93046,94898,97763,99102,0,3400,3383,4380,4300,2497,0,94432,88680,89663,90518,93463,96605,0.94432,0.8868,0.89663,0.90518,0.93463,0.96605,3
3768,50000,0,1,2,31,0,0,0,0,0,0,50758,49517,49528,44768,40295,33088,2501,2005,1312,1614,1706,0,0,48257,47512,48216,43154,38589,33088,0.96514,0.95024,0.96432,0.86308,0.77178,0.66176,0
3769,50000,0,3,2,23,2,0,0,0,0,0,11744,10935,11664,10872,9392,9456,1507,1500,300,500,500,118,0,10237,9435,11364,10372,8892,9338,0.20474,0.1887,0.22728,0.20744,0.17784,0.18676,2
3770,350000,1,1,1,41,0,0,0,0,0,0,15407,17826,23489,29037,36213,38163,3000,6000,6000,8027,8000,8000,1,12407,11826,17489,21010,28213,30163,0.035448571428571427,0.03378857142857143,0.04996857142857143,0.06002857142857143,0.08060857142857143,0.08618,0
3771,300000,1,3,2,30,2,2,2,2,2,2,131957,134790,137637,138886,140116,147715,6500,6500,5000,5000,10000,7000,0,125457,128290,132637,133886,130116,140715,0.41819,0.4276333333333333,0.4421233333333333,0.44628666666666666,0.43372,0.46905,12
3772,50000,1,2,2,23,0,0,0,0,0,0,42790,39480,36360,29123,28809,29263,1635,1423,1020,1050,1503,1016,0,41155,38057,35340,28073,27306,28247,0.8231,0.76114,0.7068,0.56146,0.54612,0.56494,0
3773,330000,1,2,2,31,0,0,0,0,0,0,30532,33814,38243,39603,40542,41239,3814,5000,2000,1598,1500,2000,0,26718,28814,36243,38005,39042,39239,0.08096363636363636,0.08731515151515151,0.10982727272727273,0.11516666666666667,0.1183090909090909,0.11890606060606061,0
3774,200000,0,2,2,28,0,0,0,-1,-1,-1,99216,100142,34162,712,712,862,5300,3000,8712,712,862,704,0,93916,97142,25450,0,-150,158,0.46958,0.48571,0.12725,0.0,-0.00075,0.00079,-3
3775,280000,0,1,1,49,-2,-2,-2,-2,-2,-2,11797,6163,-54,-54,-54,-54,6231,0,0,0,0,0,1,5566,6163,-54,-54,-54,-54,0.01987857142857143,0.022010714285714286,-0.00019285714285714286,-0.00019285714285714286,-0.00019285714285714286,-0.00019285714285714286,-12
3776,410000,0,1,1,34,-1,0,0,0,0,-1,109256,15134,5063,1019,14585,5370,15000,4867,803,14436,5396,875,1,94256,10267,4260,-13417,9189,4495,0.22989268292682927,0.025041463414634146,0.010390243902439025,-0.03272439024390244,0.02241219512195122,0.01096341463414634,-2
3777,50000,0,1,2,24,0,0,0,0,0,0,50716,50606,33265,29300,20703,30101,3029,2000,1021,1004,10000,2500,0,47687,48606,32244,28296,10703,27601,0.95374,0.97212,0.64488,0.56592,0.21406,0.55202,0
3778,180000,1,2,1,32,0,0,0,0,0,-2,5244,8135,12621,17987,-99,-99,3000,5000,15000,0,0,0,1,2244,3135,-2379,17987,-99,-99,0.012466666666666666,0.017416666666666667,-0.013216666666666666,0.09992777777777778,-0.00055,-0.00055,-2
3779,490000,0,1,1,43,-1,-1,-1,-1,-1,-1,25916,14187,56573,81414,62063,14122,14187,56717,81414,62063,14122,25417,1,11729,-42530,-24841,19351,47941,-11295,0.02393673469387755,-0.08679591836734694,-0.05069591836734694,0.03949183673469388,0.09783877551020408,-0.023051020408163266,-6
3780,200000,0,1,2,38,-2,-2,-2,-2,-2,-2,0,0,0,0,0,0,0,0,0,0,0,0,0,0,0,0,0,0,0,0.0,0.0,0.0,0.0,0.0,0.0,-12
3781,80000,1,2,2,44,0,-1,-1,-2,-2,-2,7491,2900,0,0,0,0,2900,0,0,0,0,0,0,4591,2900,0,0,0,0,0.0573875,0.03625,0.0,0.0,0.0,0.0,-8
3782,130000,1,2,2,30,0,0,0,0,0,0,114838,111226,104301,84132,79043,78205,4224,4415,3600,5800,2000,2005,0,110614,106811,100701,78332,77043,76200,0.8508769230769231,0.8216230769230769,0.774623076923077,0.6025538461538461,0.5926384615384616,0.5861538461538461,0
3783,180000,1,2,1,32,2,2,2,2,2,0,13286,15548,15009,17752,17172,18732,2800,0,3000,0,2000,5000,1,10486,15548,12009,17752,15172,13732,0.058255555555555553,0.08637777777777778,0.06671666666666666,0.09862222222222222,0.08428888888888889,0.07628888888888889,10
3784,250000,1,1,2,43,0,0,0,0,0,0,93163,96024,90901,69927,71403,69948,4409,3023,2600,2700,2801,2500,0,88754,93001,88301,67227,68602,67448,0.355016,0.372004,0.353204,0.268908,0.274408,0.269792,0
3785,500000,0,1,2,36,0,0,0,0,0,0,151630,150824,117130,146443,122439,83535,12074,10000,40561,12550,20803,65678,0,139556,140824,76569,133893,101636,17857,0.279112,0.281648,0.153138,0.267786,0.203272,0.035714,0
3786,110000,1,2,2,42,1,2,0,0,0,0,57046,51005,48572,49299,47126,48215,0,2100,2500,2000,2250,1200,0,57046,48905,46072,47299,44876,47015,0.5186,0.4445909090909091,0.4188363636363636,0.4299909090909091,0.40796363636363636,0.4274090909090909,3
3787,150000,1,3,2,28,-2,-2,-2,-2,-2,-2,1666,802,1793,0,0,0,806,1801,0,0,0,0,0,860,-999,1793,0,0,0,0.005733333333333333,-0.00666,0.011953333333333333,0.0,0.0,0.0,-12
3788,30000,1,1,2,24,1,2,2,2,0,0,29492,29697,30737,27808,28204,28792,1000,3513,0,1155,1190,1502,0,28492,26184,30737,26653,27014,27290,0.9497333333333333,0.8728,1.0245666666666666,0.8884333333333333,0.9004666666666666,0.9096666666666666,7
3789,500000,1,1,1,44,-2,-2,-2,-2,-2,-2,2128,635,13258,4562,893,2030,635,13337,4562,893,2030,0,1,1493,-12702,8696,3669,-1137,2030,0.002986,-0.025404,0.017392,0.007338,-0.002274,0.00406,-12
3790,60000,1,2,2,23,2,2,-2,-2,-1,-1,2516,0,0,0,1524,25421,0,0,0,1524,25421,1000,0,2516,0,0,-1524,-23897,24421,0.041933333333333336,0.0,0.0,-0.0254,-0.3982833333333333,0.4070166666666667,-2
3791,220000,1,1,1,43,0,0,0,0,0,0,64792,65463,66834,68221,69576,71035,2344,2427,2500,2490,2580,2593,1,62448,63036,64334,65731,66996,68442,0.28385454545454547,0.28652727272727274,0.2924272727272727,0.2987772727272727,0.3045272727272727,0.3111,0
3792,90000,1,3,3,24,-2,-2,-2,-1,0,0,3700,20833,23968,13574,6800,1830,20108,4000,13574,14,5,13162,0,-16408,16833,10394,13560,6795,-11332,-0.18231111111111112,0.18703333333333333,0.11548888888888889,0.15066666666666667,0.0755,-0.1259111111111111,-7
3793,200000,0,1,1,40,-1,-1,-1,-1,-1,-1,4394,3366,9379,4253,4403,4326,3405,9436,4274,4424,4347,10741,1,989,-6070,5105,-171,56,-6415,0.004945,-0.03035,0.025525,-0.000855,0.00028,-0.032075,-6
3794,50000,1,2,2,35,0,0,0,0,0,-1,41657,47969,49131,38884,8144,8643,10000,11000,5000,1005,15000,7000,0,31657,36969,44131,37879,-6856,1643,0.63314,0.73938,0.88262,0.75758,-0.13712,0.03286,-1
3795,70000,0,2,2,48,-1,-1,-1,-1,-1,-1,193,188,299,829,338,865,188,299,829,338,865,833,0,5,-111,-530,491,-527,32,7.142857142857143e-05,-0.0015857142857142858,-0.007571428571428572,0.007014285714285714,-0.007528571428571429,0.00045714285714285713,-6
3796,160000,0,1,2,27,-1,-1,2,-1,0,0,701,3442,2551,4217,1255,1554,3442,18,4217,0,1000,888,0,-2741,3424,-1666,4217,255,666,-0.01713125,0.0214,-0.0104125,0.02635625,0.00159375,0.0041625,-1
3797,210000,1,1,1,35,-2,-2,-2,-2,-2,-2,2020,4055,0,0,0,0,4055,0,0,0,0,150,1,-2035,4055,0,0,0,-150,-0.00969047619047619,0.01930952380952381,0.0,0.0,0.0,-0.0007142857142857143,-12
3798,300000,1,1,1,37,0,-1,-1,-1,-2,-1,4476,2521,3529,-5364,-8943,4057,3017,4506,0,0,14000,12000,1,1459,-1985,3529,-5364,-22943,-7943,0.004863333333333333,-0.0066166666666666665,0.011763333333333334,-0.01788,-0.07647666666666667,-0.026476666666666666,-6
3799,620000,0,2,2,31,-2,-2,-2,-2,-2,-2,5712,11598,21049,13846,3565,7076,11881,21171,13915,3583,7111,1971,0,-6169,-9573,7134,10263,-3546,5105,-0.00995,-0.015440322580645162,0.011506451612903226,0.01655322580645161,-0.0057193548387096775,0.008233870967741936,-12
3800,180000,0,2,2,43,-1,-1,-2,-2,-2,-2,5904,5715,2378,10396,2527,2173,5739,2385,10427,2534,2179,13903,0,165,3330,-8049,7862,348,-11730,0.0009166666666666666,0.0185,-0.04471666666666667,0.04367777777777778,0.0019333333333333333,-0.06516666666666666,-10
3801,330000,1,1,1,31,0,0,0,0,0,0,132514,137347,391478,142842,143257,144783,10000,65042,12000,5000,6000,6000,1,122514,72305,379478,137842,137257,138783,0.37125454545454545,0.2191060606060606,1.1499333333333333,0.4177030303030303,0.41593030303030304,0.42055454545454546,0
3802,50000,1,2,2,31,2,2,2,2,-2,-1,50539,50017,48310,420,560,29793,1000,0,420,560,29793,0,0,49539,50017,47890,-140,-29233,29793,0.99078,1.00034,0.9578,-0.0028,-0.58466,0.59586,5
3803,200000,0,2,1,31,-2,-2,-2,-2,-2,-2,6926,1747,642,0,0,0,1747,642,0,0,0,500,1,5179,1105,642,0,0,-500,0.025895,0.005525,0.00321,0.0,0.0,-0.0025,-12
3804,150000,1,1,2,36,0,0,-2,-2,-2,-2,15447,0,0,0,0,0,0,0,0,0,0,0,0,15447,0,0,0,0,0,0.10298,0.0,0.0,0.0,0.0,0.0,-8
3805,110000,0,2,1,42,1,2,0,0,2,2,45461,44434,45395,50402,50217,48199,0,1980,5987,2000,1,3027,1,45461,42454,39408,48402,50216,45172,0.4132818181818182,0.38594545454545454,0.35825454545454544,0.4400181818181818,0.4565090909090909,0.41065454545454544,7
3806,500000,0,2,1,49,1,2,0,0,0,-2,9502,9206,11000,13000,0,0,0,2000,2000,0,0,0,1,9502,7206,9000,13000,0,0,0.019004,0.014412,0.018,0.026,0.0,0.0,1
3807,450000,1,1,2,40,-1,-1,-1,-1,-2,-2,9612,19253,6665,0,0,0,19293,6665,0,0,0,8768,0,-9681,12588,6665,0,0,-8768,-0.021513333333333332,0.027973333333333333,0.014811111111111112,0.0,0.0,-0.019484444444444443,-8
3808,20000,0,2,2,33,0,0,0,0,0,0,18330,17797,18731,19610,18980,38766,1291,1324,1302,672,701,788,0,17039,16473,17429,18938,18279,37978,0.85195,0.82365,0.87145,0.9469,0.91395,1.8989,0
3809,190000,1,1,1,43,-2,-2,-2,-2,-2,-2,1675,4873,3468,27395,0,148120,4873,3472,27403,0,148120,6546,1,-3198,1401,-23935,27395,-148120,141574,-0.01683157894736842,0.007373684210526316,-0.12597368421052632,0.14418421052631578,-0.779578947368421,0.7451263157894736,-12
3810,150000,0,2,1,41,0,0,0,0,0,0,140172,141528,141411,143748,147159,151185,5507,4007,5001,5003,6001,5000,1,134665,137521,136410,138745,141158,146185,0.8977666666666667,0.9168066666666667,0.9094,0.9249666666666667,0.9410533333333333,0.9745666666666667,0
3811,200000,1,4,2,32,0,0,0,0,0,0,64059,66113,15421,15728,16057,16398,3372,1246,553,572,597,2000,0,60687,64867,14868,15156,15460,14398,0.303435,0.324335,0.07434,0.07578,0.0773,0.07199,0
3812,40000,0,1,2,45,-1,-1,-1,-1,-1,0,10567,264,3430,-147,672,5408,264,3430,0,24672,5000,3020,0,10303,-3166,3430,-24819,-4328,2388,0.257575,-0.07915,0.08575,-0.620475,-0.1082,0.0597,-5
3813,120000,1,2,1,42,-1,-1,-1,-1,-1,-1,499,499,499,499,499,1148,499,499,499,499,1148,0,1,0,0,0,0,-649,1148,0.0,0.0,0.0,0.0,-0.005408333333333334,0.009566666666666666,-6
3814,120000,1,3,2,26,-1,-1,-1,-1,-1,-1,1467,975,246,246,246,884,975,246,246,246,884,1000,0,492,729,0,0,-638,-116,0.0041,0.006075,0.0,0.0,-0.005316666666666667,-0.0009666666666666667,-6
3815,120000,1,2,1,29,-1,-1,-1,-1,-1,-1,7778,3157,5456,0,2777,0,3179,5463,0,2777,0,0,1,4599,-2306,5456,-2777,2777,0,0.038325,-0.019216666666666667,0.04546666666666667,-0.023141666666666668,0.023141666666666668,0.0,-6
3816,20000,0,3,2,40,1,3,2,0,0,0,9080,8790,8505,9557,10395,11227,0,0,1200,1000,1000,1000,0,9080,8790,7305,8557,9395,10227,0.454,0.4395,0.36525,0.42785,0.46975,0.51135,6
3817,270000,0,1,2,36,-2,-2,-2,-2,-2,-2,11464,1879,6896,8583,880,4861,1879,6909,8587,880,4861,3212,0,9585,-5030,-1691,7703,-3981,1649,0.0355,-0.018629629629629628,-0.006262962962962963,0.02852962962962963,-0.014744444444444444,0.006107407407407408,-12
3818,280000,0,1,1,42,-2,-1,-1,0,0,-2,1751,22046,63729,55664,31014,28903,22909,64167,1113,32000,578,1768,1,-21158,-42121,62616,23664,30436,27135,-0.07556428571428571,-0.15043214285714285,0.22362857142857143,0.08451428571428571,0.1087,0.09691071428571428,-6
3819,290000,1,2,1,45,0,0,0,0,0,0,36335,36085,35225,35711,35381,34468,1564,1594,1840,1378,1245,1388,1,34771,34491,33385,34333,34136,33080,0.1199,0.11893448275862069,0.11512068965517241,0.11838965517241379,0.1177103448275862,0.11406896551724138,0
3820,300000,0,2,2,35,0,0,0,0,0,0,276536,206885,169901,170540,152188,101485,26531,10017,9123,10259,5079,3816,0,250005,196868,160778,160281,147109,97669,0.83335,0.6562266666666666,0.5359266666666667,0.53427,0.4903633333333333,0.3255633333333333,0
3821,200000,0,3,1,43,0,-1,-1,-1,0,0,1243,1435,1270,3783,2522,1261,1453,1270,4000,0,0,1436,1,-210,165,-2730,3783,2522,-175,-0.00105,0.000825,-0.01365,0.018915,0.01261,-0.000875,-3
3822,140000,1,2,1,40,0,0,0,0,0,0,138389,110701,83468,41202,41687,36335,5148,3216,2003,3000,3041,5056,1,133241,107485,81465,38202,38646,31279,0.9517214285714286,0.76775,0.5818928571428571,0.2728714285714286,0.27604285714285715,0.22342142857142858,0
3823,40000,0,2,2,47,2,2,3,2,2,2,52358,54892,53415,51259,47151,46934,4000,0,2000,0,3520,0,0,48358,54892,51415,51259,43631,46934,1.20895,1.3723,1.285375,1.281475,1.090775,1.17335,13
3824,30000,0,2,2,34,0,0,0,0,0,0,24380,17858,19563,20929,21280,21724,2000,2000,2000,1000,787,1133,0,22380,15858,17563,19929,20493,20591,0.746,0.5286,0.5854333333333334,0.6643,0.6831,0.6863666666666667,0
3825,50000,0,1,2,26,0,0,0,0,0,0,14577,15329,16575,17496,17907,18375,1300,1500,1500,1000,1000,1600,0,13277,13829,15075,16496,16907,16775,0.26554,0.27658,0.3015,0.32992,0.33814,0.3355,0
3826,30000,1,2,2,23,0,0,0,0,2,0,19769,24285,26143,26929,19610,20591,5896,3002,2130,2,3004,8013,0,13873,21283,24013,26927,16606,12578,0.4624333333333333,0.7094333333333334,0.8004333333333333,0.8975666666666666,0.5535333333333333,0.4192666666666667,2
3827,60000,0,2,2,25,0,0,0,0,0,0,56598,47311,25227,26039,27493,26416,3000,2000,1500,2000,1500,1500,0,53598,45311,23727,24039,25993,24916,0.8933,0.7551833333333333,0.39545,0.40065,0.4332166666666667,0.4152666666666667,0
3828,200000,0,1,1,38,1,-2,-1,0,0,0,-57,-382,1293,968,643,318,0,2000,0,0,0,1370,1,-57,-2382,1293,968,643,-1052,-0.000285,-0.01191,0.006465,0.00484,0.003215,-0.00526,-2
3829,260000,1,1,2,58,1,-2,-2,-2,-2,-2,0,0,0,0,0,0,0,0,0,0,0,0,0,0,0,0,0,0,0,0.0,0.0,0.0,0.0,0.0,0.0,-9
3830,100000,1,3,2,48,-1,-1,-1,0,0,0,16584,16009,64886,66202,72526,74323,16137,64886,2353,10000,3000,2670,0,447,-48877,62533,56202,69526,71653,0.00447,-0.48877,0.62533,0.56202,0.69526,0.71653,-3
3831,70000,0,1,2,29,0,0,0,2,0,0,32938,33635,35287,36002,37096,37999,1548,2200,1600,2000,1500,3000,0,31390,31435,33687,34002,35596,34999,0.44842857142857145,0.44907142857142857,0.48124285714285714,0.48574285714285714,0.5085142857142857,0.4999857142857143,2
3832,80000,1,2,3,59,0,0,0,0,0,0,80893,79175,78713,80684,50400,50058,2799,3300,3600,1568,1625,1649,0,78094,75875,75113,79116,48775,48409,0.976175,0.9484375,0.9389125,0.98895,0.6096875,0.6051125,0
3833,50000,0,2,2,23,2,2,-1,0,0,0,49365,48927,49543,19649,20064,19691,1200,50189,682,710,690,693,0,48165,-1262,48861,18939,19374,18998,0.9633,-0.02524,0.97722,0.37878,0.38748,0.37996,3
3834,230000,1,3,2,48,-1,-1,-1,-1,-1,-1,3096,518,4988,3528,3642,14073,518,5003,3528,3642,14073,1485,0,2578,-4485,1460,-114,-10431,12588,0.011208695652173913,-0.0195,0.006347826086956522,-0.0004956521739130434,-0.04535217391304348,0.054730434782608695,-6
3835,20000,0,2,2,25,2,2,2,2,2,2,150,150,150,1150,1000,0,0,0,1000,0,0,0,0,150,150,-850,1150,1000,0,0.0075,0.0075,-0.0425,0.0575,0.05,0.0,12
3836,20000,1,3,2,22,2,2,0,0,0,2,16381,13837,14907,15853,17776,17352,0,1600,1500,2500,0,1000,0,16381,12237,13407,13353,17776,16352,0.81905,0.61185,0.67035,0.66765,0.8888,0.8176,6
3837,300000,1,2,2,28,0,0,0,0,0,0,327724,325970,325020,319750,265136,262378,11250,11877,10487,7831,8092,7634,0,316474,314093,314533,311919,257044,254744,1.0549133333333334,1.0469766666666667,1.0484433333333334,1.03973,0.8568133333333333,0.8491466666666667,0
3838,210000,1,3,1,36,-1,-1,-1,-1,-1,-1,1168,1511,0,1783,1000,150,1511,0,1783,1000,150,14780,1,-343,1511,-1783,783,850,-14630,-0.0016333333333333334,0.007195238095238095,-0.00849047619047619,0.0037285714285714287,0.004047619047619047,-0.06966666666666667,-6
3839,510000,0,1,1,41,-1,-1,-1,-1,-1,-1,3196,16447,3317,10771,5552,2253,16447,3317,10771,5552,2253,96,1,-13251,13130,-7454,5219,3299,2157,-0.02598235294117647,0.025745098039215687,-0.014615686274509805,0.010233333333333334,0.006468627450980392,0.004229411764705883,-6
3840,20000,0,2,1,24,0,0,0,0,0,0,10085,11416,12520,12714,13059,13193,1500,1600,700,700,500,1000,1,8585,9816,11820,12014,12559,12193,0.42925,0.4908,0.591,0.6007,0.62795,0.60965,0
3841,50000,0,1,1,41,1,2,0,0,0,0,48063,46565,38617,8999,8870,5876,0,1906,500,500,300,1000,1,48063,44659,38117,8499,8570,4876,0.96126,0.89318,0.76234,0.16998,0.1714,0.09752,3
3842,140000,0,1,2,29,1,-2,-2,-2,-2,-2,0,0,0,0,0,0,0,0,0,0,0,0,0,0,0,0,0,0,0,0.0,0.0,0.0,0.0,0.0,0.0,-9
3843,230000,0,1,1,46,-1,-1,-1,0,0,0,519,518,2784,2360,1908,97,518,2784,32,0,0,0,1,1,-2266,2752,2360,1908,97,4.347826086956521e-06,-0.009852173913043478,0.011965217391304349,0.01026086956521739,0.008295652173913044,0.0004217391304347826,-3
3844,80000,1,2,1,24,2,2,-1,0,0,0,3177,-13,4229,4161,4042,6807,0,4242,1032,1000,2812,2248,1,3177,-4255,3197,3161,1230,4559,0.0397125,-0.0531875,0.0399625,0.0395125,0.015375,0.0569875,3
3845,250000,0,2,1,47,-1,-1,-1,-1,-1,-1,10735,19147,4192,5947,5453,0,19269,4192,5966,5453,0,0,1,-8534,14955,-1774,494,5453,0,-0.034136,0.05982,-0.007096,0.001976,0.021812,0.0,-6
3846,180000,1,1,1,33,-1,-1,-1,-1,-1,-1,3060,2337,766,316,4356,316,2337,766,316,4356,316,716,1,723,1571,450,-4040,4040,-400,0.004016666666666667,0.008727777777777777,0.0025,-0.022444444444444444,0.022444444444444444,-0.0022222222222222222,-6
3847,250000,0,1,1,49,0,0,0,0,0,0,236430,243445,246357,250942,205081,209309,11000,11500,11000,7500,7500,8000,1,225430,231945,235357,243442,197581,201309,0.90172,0.92778,0.941428,0.973768,0.790324,0.805236,0
3848,90000,1,2,2,28,-1,-1,-1,-1,-1,-1,2943,906,669,0,400,182,906,669,0,400,182,5634,0,2037,237,669,-400,218,-5452,0.02263333333333333,0.0026333333333333334,0.0074333333333333335,-0.0044444444444444444,0.0024222222222222223,-0.06057777777777778,-6
3849,50000,1,2,1,34,1,2,0,0,0,0,49378,48052,48573,28902,28205,30388,0,2033,1119,985,2000,4000,1,49378,46019,47454,27917,26205,26388,0.98756,0.92038,0.94908,0.55834,0.5241,0.52776,3
3850,110000,0,2,1,39,2,3,2,2,2,2,39733,38862,40995,40106,42492,43197,0,3000,0,3300,1463,0,1,39733,35862,40995,36806,41029,43197,0.3612090909090909,0.3260181818181818,0.37268181818181817,0.3346,0.3729909090909091,0.3927,13
3851,180000,1,1,2,28,0,0,0,0,0,0,161694,166198,168711,172263,174127,176335,7500,7000,7189,6000,5100,10000,0,154194,159198,161522,166263,169027,166335,0.8566333333333334,0.8844333333333333,0.8973444444444444,0.9236833333333333,0.9390388888888889,0.9240833333333334,0
3852,260000,1,2,1,46,0,0,2,2,2,0,18256,19556,18136,24018,21490,18196,2934,0,8000,0,2000,8000,1,15322,19556,10136,24018,19490,10196,0.05893076923076923,0.07521538461538461,0.03898461538461538,0.09237692307692308,0.07496153846153847,0.03921538461538462,6
3853,260000,0,1,2,34,0,0,0,0,0,-2,251267,254332,257628,161545,0,0,12021,11710,7503,0,0,0,0,239246,242622,250125,161545,0,0,0.9201769230769231,0.9331615384615385,0.9620192307692308,0.621326923076923,0.0,0.0,-2
3854,360000,0,2,1,30,-1,-1,-1,0,0,0,6323,6934,17170,11152,6000,0,7001,17173,1000,1000,0,200000,1,-678,-10239,16170,10152,6000,-200000,-0.0018833333333333334,-0.028441666666666667,0.04491666666666667,0.0282,0.016666666666666666,-0.5555555555555556,-3
3855,30000,0,3,1,53,0,0,-2,-2,-2,-2,1596,0,0,0,0,0,0,0,0,0,0,0,1,1596,0,0,0,0,0,0.0532,0.0,0.0,0.0,0.0,0.0,-8
3856,80000,1,3,2,55,2,0,0,0,0,0,76414,78009,78616,49662,48867,48278,3100,2420,2000,1656,1693,1767,0,73314,75589,76616,48006,47174,46511,0.916425,0.9448625,0.9577,0.600075,0.589675,0.5813875,2
3857,140000,1,1,2,27,-1,-1,-1,0,-1,-1,2116,11028,9778,6417,1831,7126,11033,9803,1004,1831,7126,2121,0,-8917,1225,8774,4586,-5295,5005,-0.06369285714285715,0.00875,0.06267142857142857,0.03275714285714286,-0.03782142857142857,0.03575,-5
3858,150000,0,1,2,30,0,0,0,0,0,0,201864,121338,146685,137993,90715,92759,13230,31280,5979,7760,6000,260000,0,188634,90058,140706,130233,84715,-167241,1.25756,0.6003866666666666,0.93804,0.86822,0.5647666666666666,-1.11494,0
3859,80000,1,2,2,31,-1,-1,0,0,0,0,1019,8479,9947,10671,11923,12050,8479,2000,2000,2000,2000,1000,0,-7460,6479,7947,8671,9923,11050,-0.09325,0.0809875,0.0993375,0.1083875,0.1240375,0.138125,-2
3860,240000,1,2,2,31,0,0,0,0,0,0,245553,244958,245148,240343,211449,215874,10178,10577,8302,7300,7505,7700,0,235375,234381,236846,233043,203944,208174,0.9807291666666667,0.9765875,0.9868583333333333,0.9710125,0.8497666666666667,0.8673916666666667,0
3861,200000,1,1,2,59,0,0,0,0,0,0,180887,166921,155945,109271,36753,78079,10000,30000,7,7000,73000,700,0,170887,136921,155938,102271,-36247,77379,0.854435,0.684605,0.77969,0.511355,-0.181235,0.386895,0
3862,360000,1,1,2,27,-2,-2,-2,-2,-2,-2,0,0,12063,6080,0,0,0,12063,6080,0,0,0,0,0,-12063,5983,6080,0,0,0.0,-0.033508333333333334,0.016619444444444444,0.016888888888888887,0.0,0.0,-12
3863,240000,0,2,1,34,0,0,0,0,0,0,133272,133373,138006,136195,140860,138787,6000,9583,6000,10000,4974,4820,1,127272,123790,132006,126195,135886,133967,0.5303,0.5157916666666666,0.550025,0.5258125,0.5661916666666666,0.5581958333333333,0
3864,50000,0,3,1,41,5,4,3,2,0,0,54090,52955,51847,50307,27707,28479,0,0,0,0,974,31100,1,54090,52955,51847,50307,26733,-2621,1.0818,1.0591,1.03694,1.00614,0.53466,-0.05242,14
3865,220000,1,1,1,47,0,0,0,0,0,0,210753,188270,177515,166282,100244,-607,6426,7160,6495,3993,0,176566,1,204327,181110,171020,162289,100244,-177173,0.9287590909090909,0.8232272727272727,0.7773636363636364,0.7376772727272727,0.4556545454545455,-0.8053318181818182,0
3866,400000,1,1,1,31,-1,-1,-1,-1,-1,-1,325,5581,2833,1162,325,325,5581,2833,1162,325,325,325,1,-5256,2748,1671,837,0,0,-0.01314,0.00687,0.0041775,0.0020925,0.0,0.0,-6
3867,240000,1,2,1,56,2,0,0,0,0,0,133954,138785,141894,143270,201082,215709,8500,6500,5000,60000,17464,6516,1,125454,132285,136894,83270,183618,209193,0.522725,0.5511875,0.5703916666666666,0.3469583333333333,0.765075,0.8716375,2
3868,500000,0,1,3,38,-2,-2,-2,-2,-2,-2,1523,0,0,0,0,0,0,0,0,0,0,0,0,1523,0,0,0,0,0,0.003046,0.0,0.0,0.0,0.0,0.0,-12
3869,70000,1,2,1,62,2,2,2,0,0,0,70457,73562,71818,70579,33946,34701,6454,0,3075,1214,1301,1626,1,64003,73562,68743,69365,32645,33075,0.9143285714285714,1.0508857142857142,0.9820428571428571,0.9909285714285714,0.46635714285714286,0.4725,6
3870,170000,0,1,2,36,-1,-1,-1,-1,-1,-1,37830,11160,4336,947,316,3797,11376,4346,947,316,3797,316,0,26454,6814,3389,631,-3481,3481,0.15561176470588237,0.04008235294117647,0.019935294117647058,0.0037117647058823528,-0.020476470588235294,0.020476470588235294,-6
3871,240000,1,2,1,44,-2,-1,-1,2,2,3,16925,1411,1696,1437,2714,2202,1411,1200,0,1479,0,0,1,15514,211,1696,-42,2714,2202,0.06464166666666667,0.0008791666666666667,0.007066666666666666,-0.000175,0.011308333333333333,0.009175,3
3872,140000,0,1,2,26,0,0,0,0,0,-2,66526,65667,67571,26968,-4082,-4082,3990,4000,2000,0,0,0,0,62536,61667,65571,26968,-4082,-4082,0.4466857142857143,0.44047857142857144,0.46836428571428573,0.19262857142857143,-0.029157142857142857,-0.029157142857142857,-2
3873,240000,0,1,2,57,0,0,0,0,0,0,224041,238077,245387,248945,224776,11567,18800,12000,10000,20019,3000,9000,0,205241,226077,235387,228926,221776,2567,0.8551708333333333,0.9419875,0.9807791666666666,0.9538583333333334,0.9240666666666667,0.010695833333333333,0
3874,210000,0,1,2,30,-1,-1,-1,-1,0,0,4830,0,1000,15385,20302,25112,0,1000,15385,5302,5112,4213,0,4830,-1000,-14385,10083,15190,20899,0.023,-0.004761904761904762,-0.0685,0.04801428571428572,0.07233333333333333,0.09951904761904762,-4
3875,30000,0,3,1,45,0,0,2,0,0,0,17187,24045,23180,22000,22000,0,7900,0,0,0,0,0,1,9287,24045,23180,22000,22000,0,0.30956666666666666,0.8015,0.7726666666666666,0.7333333333333333,0.7333333333333333,0.0,2
3876,30000,0,3,2,33,0,0,0,0,0,0,30384,30134,30646,29657,30232,28415,3010,3000,3000,3000,1083,0,0,27374,27134,27646,26657,29149,28415,0.9124666666666666,0.9044666666666666,0.9215333333333333,0.8885666666666666,0.9716333333333333,0.9471666666666667,0
3877,230000,1,2,1,36,-2,-2,-2,-2,-2,-1,198,29430,22925,6120,6519,12051,29439,22993,6167,6519,12086,5948,1,-29241,6437,16758,-399,-5567,6103,-0.12713478260869565,0.02798695652173913,0.0728608695652174,-0.001734782608695652,-0.024204347826086957,0.026534782608695653,-11
3878,270000,0,1,1,44,3,3,4,4,4,4,256402,264267,271951,278509,283545,278436,17944,18112,15405,10000,0,0,1,238458,246155,256546,268509,283545,278436,0.8831777777777777,0.9116851851851852,0.9501703703703703,0.9944777777777778,1.0501666666666667,1.0312444444444444,22
3879,100000,1,2,1,40,2,2,2,2,2,2,47243,48294,49213,49827,51005,53142,2000,1900,1600,2000,3000,0,1,45243,46394,47613,47827,48005,53142,0.45243,0.46394,0.47613,0.47827,0.48005,0.53142,12
3880,100000,1,2,1,47,0,0,0,0,0,0,24735,27555,29798,31028,33544,35328,3555,3000,2028,3354,2328,7300,1,21180,24555,27770,27674,31216,28028,0.2118,0.24555,0.2777,0.27674,0.31216,0.28028,0
3881,10000,0,2,2,30,0,0,0,0,0,2,8107,8724,9191,9800,10072,9766,1298,1155,1154,1206,0,399,0,6809,7569,8037,8594,10072,9367,0.6809,0.7569,0.8037,0.8594,1.0072,0.9367,2
3882,140000,1,2,1,26,0,0,0,0,0,-1,37283,24748,21854,21711,25999,902,7023,5080,10000,6000,902,18542,1,30260,19668,11854,15711,25097,-17640,0.21614285714285714,0.1404857142857143,0.08467142857142858,0.11222142857142857,0.1792642857142857,-0.126,-1
3883,180000,0,3,2,27,0,0,0,0,0,0,172511,177587,175867,159053,126688,122947,8008,6528,6500,5000,5000,5000,0,164503,171059,169367,154053,121688,117947,0.9139055555555555,0.9503277777777778,0.9409277777777778,0.85585,0.6760444444444444,0.6552611111111111,0
3884,70000,0,1,2,25,0,0,0,0,0,0,31011,28034,26363,22587,21770,19525,2002,1435,1294,1000,1000,1001,0,29009,26599,25069,21587,20770,18524,0.41441428571428574,0.37998571428571426,0.3581285714285714,0.30838571428571426,0.2967142857142857,0.26462857142857144,0
3885,320000,1,2,1,31,0,0,0,0,0,0,2437,3490,4529,5548,6450,7342,1100,1100,1100,1000,1000,8000,1,1337,2390,3429,4548,5450,-658,0.004178125,0.00746875,0.010715625,0.0142125,0.01703125,-0.00205625,0
3886,250000,1,1,2,26,-1,-1,-2,-2,-1,-1,7374,0,0,0,2546,0,0,0,0,2546,0,0,0,7374,0,0,-2546,2546,0,0.029496,0.0,0.0,-0.010184,0.010184,0.0,-8
3887,40000,0,2,1,47,0,0,2,2,3,2,34664,37611,36726,40985,40085,39354,3524,0,4898,0,0,1800,1,31140,37611,31828,40985,40085,37554,0.7785,0.940275,0.7957,1.024625,1.002125,0.93885,9
3888,300000,0,1,1,55,0,0,0,0,0,0,127480,130168,134080,126996,127820,130325,4810,6164,6069,4425,4412,4123,1,122670,124004,128011,122571,123408,126202,0.4089,0.41334666666666664,0.4267033333333333,0.40857,0.41136,0.42067333333333334,0
3889,200000,1,2,1,46,1,-2,-2,-2,-2,-2,0,0,0,0,0,0,0,0,0,0,0,0,1,0,0,0,0,0,0,0.0,0.0,0.0,0.0,0.0,0.0,-9
3890,50000,1,1,2,27,0,0,0,0,0,0,30951,28622,11656,5435,6337,7227,1600,1542,1100,1000,1000,284,0,29351,27080,10556,4435,5337,6943,0.58702,0.5416,0.21112,0.0887,0.10674,0.13886,0
3891,500000,1,1,1,45,0,0,0,0,0,0,93669,101892,76452,20965,50466,61566,10147,5331,10000,30000,12000,10000,1,83522,96561,66452,-9035,38466,51566,0.167044,0.193122,0.132904,-0.01807,0.076932,0.103132,0
3892,70000,1,3,3,51,0,0,0,0,0,0,32485,30527,13407,13643,12722,13515,1267,1191,427,957,1000,14001,0,31218,29336,12980,12686,11722,-486,0.4459714285714286,0.4190857142857143,0.18542857142857141,0.18122857142857143,0.16745714285714286,-0.006942857142857143,0
3893,260000,1,2,2,26,0,0,0,0,-1,-1,164351,164244,158124,62373,746,-45734,7000,5115,2000,746,5025,54836,0,157351,159129,156124,61627,-4279,-100570,0.6051961538461539,0.6120346153846153,0.6004769230769231,0.23702692307692308,-0.01645769230769231,-0.3868076923076923,-2
3894,110000,1,1,1,31,2,2,2,0,0,0,107507,108067,83164,79428,80235,79412,7960,0,3000,3000,3100,3000,1,99547,108067,80164,76428,77135,76412,0.9049727272727273,0.9824272727272727,0.7287636363636364,0.6948,0.7012272727272727,0.6946545454545454,6
3895,390000,1,3,1,58,-2,-2,-2,-2,-2,-2,1186,15523,0,609,0,0,15657,0,609,0,0,0,1,-14471,15523,-609,609,0,0,-0.03710512820512821,0.0398025641025641,-0.0015615384615384614,0.0015615384615384614,0.0,0.0,-12
3896,200000,1,2,2,33,0,0,0,0,0,0,198878,195883,190282,164492,165076,166008,7700,7527,4900,5100,5300,4610,0,191178,188356,185382,159392,159776,161398,0.95589,0.94178,0.92691,0.79696,0.79888,0.80699,0
3897,30000,1,3,1,37,1,2,2,2,0,0,28361,27227,29346,23548,11790,7276,0,3313,108,299,325,0,1,28361,23914,29238,23249,11465,7276,0.9453666666666667,0.7971333333333334,0.9746,0.7749666666666667,0.38216666666666665,0.24253333333333332,7
3898,210000,1,1,2,32,-2,-2,-2,-2,-1,0,1400,2800,1400,1400,27100,25644,2800,1400,0,27100,1543,75000,0,-1400,1400,1400,-25700,25557,-49356,-0.006666666666666667,0.006666666666666667,0.006666666666666667,-0.12238095238095238,0.1217,-0.23502857142857142,-9
3899,100000,1,1,2,28,0,0,0,0,0,0,53494,52656,52600,52336,55831,56265,4173,3000,2025,5000,3000,3000,0,49321,49656,50575,47336,52831,53265,0.49321,0.49656,0.50575,0.47336,0.52831,0.53265,0
3900,210000,1,2,2,31,0,0,0,0,0,0,168161,133113,130769,95962,49839,46824,5000,5032,3783,2021,3000,0,0,163161,128081,126986,93941,46839,46824,0.7769571428571429,0.6099095238095238,0.6046952380952381,0.44733809523809526,0.22304285714285715,0.22297142857142857,0
3901,190000,1,2,1,33,-2,-2,-2,-2,-2,-2,2125,3405,2131,2131,2131,0,3411,2131,2131,2131,0,5354,1,-1286,1274,0,0,2131,-5354,-0.006768421052631579,0.006705263157894737,0.0,0.0,0.01121578947368421,-0.028178947368421053,-12
3902,290000,1,1,2,27,0,0,0,0,0,0,110359,108371,102628,100000,92238,90447,5000,6039,4000,4000,4000,3000,0,105359,102332,98628,96000,88238,87447,0.36330689655172416,0.3528689655172414,0.34009655172413794,0.3310344827586207,0.30426896551724136,0.3015413793103448,0
3903,230000,1,4,2,52,0,0,0,0,0,0,155131,156687,153635,74503,46254,141916,6641,6015,2663,5015,100095,5027,0,148490,150672,150972,69488,-53841,136889,0.6456086956521739,0.6550956521739131,0.6564,0.3021217391304348,-0.23409130434782607,0.5951695652173913,0
3904,290000,1,3,1,46,-1,-1,-1,-1,-1,-1,30365,32571,36918,37063,11566,32057,32575,36982,37063,11566,32057,1501,1,-2210,-4411,-145,25497,-20491,30556,-0.007620689655172414,-0.015210344827586207,-0.0005,0.08792068965517241,-0.07065862068965517,0.10536551724137931,-6
3905,230000,1,1,2,35,-1,-1,-1,-1,-2,-2,1890,533,267,0,0,0,533,267,0,0,0,0,0,1357,266,267,0,0,0,0.0059,0.0011565217391304348,0.0011608695652173913,0.0,0.0,0.0,-8
3906,200000,0,2,2,27,0,0,0,0,0,0,137266,137888,136545,116549,109622,111113,5212,5065,4005,3900,4003,4306,0,132054,132823,132540,112649,105619,106807,0.66027,0.664115,0.6627,0.563245,0.528095,0.534035,0
3907,180000,0,1,1,42,0,0,0,0,0,0,124064,121847,82809,81755,81316,81206,5087,2891,3755,2941,3206,2837,1,118977,118956,79054,78814,78110,78369,0.6609833333333334,0.6608666666666667,0.4391888888888889,0.43785555555555555,0.43394444444444447,0.43538333333333334,0
3908,20000,0,3,2,26,3,2,2,2,2,-1,150,150,150,150,150,1150,0,0,0,0,1150,0,0,150,150,150,150,-1000,1150,0.0075,0.0075,0.0075,0.0075,-0.05,0.0575,10
3909,250000,1,2,2,40,-1,-1,-1,-1,0,0,2348,329,-1404,3596,8596,8941,329,5000,5000,5000,4000,3000,0,2019,-4671,-6404,-1404,4596,5941,0.008076,-0.018684,-0.025616,-0.005616,0.018384,0.023764,-4
3910,120000,0,2,1,26,0,0,0,0,0,0,101215,100685,15452,12491,3550,2729,5006,2000,3010,1000,2000,1391,1,96209,98685,12442,11491,1550,1338,0.8017416666666667,0.822375,0.10368333333333334,0.09575833333333333,0.012916666666666667,0.01115,0
3911,70000,0,1,2,26,0,0,0,0,0,2,51897,51961,51435,51512,54709,52462,2230,2009,2397,5912,0,2448,0,49667,49952,49038,45600,54709,50014,0.7095285714285714,0.7136,0.7005428571428571,0.6514285714285715,0.7815571428571428,0.7144857142857143,2
3912,170000,1,1,1,44,-2,-2,-2,-2,-2,-1,10309,4944,28144,1883,27938,14832,4944,28144,1883,27938,14832,0,1,5365,-23200,26261,-26055,13106,14832,0.031558823529411764,-0.13647058823529412,0.1544764705882353,-0.15326470588235294,0.07709411764705883,0.08724705882352941,-11
3913,300000,1,4,2,26,0,0,0,0,-2,-2,293880,242669,76777,34072,11632,15429,11128,47009,34044,11677,15483,6098,0,282752,195660,42733,22395,-3851,9331,0.9425066666666667,0.6522,0.14244333333333334,0.07465,-0.012836666666666666,0.031103333333333334,-4
3914,50000,1,1,2,23,0,0,0,0,0,-1,40756,48482,47226,11151,-2897,48211,10000,2500,3002,1500,52000,1900,0,30756,45982,44224,9651,-54897,46311,0.61512,0.91964,0.88448,0.19302,-1.09794,0.92622,-1
3915,50000,0,3,3,50,0,0,0,-1,-1,-1,45771,23343,0,3400,2769,0,2266,0,3400,2769,1700,0,0,43505,23343,-3400,631,1069,0,0.8701,0.46686,-0.068,0.01262,0.02138,0.0,-3
3916,230000,0,1,1,35,-2,-2,-2,-2,-2,-2,392,4106,2562,6245,394,987,4114,2566,6286,394,989,3129,1,-3722,1540,-3724,5851,-595,-2142,-0.016182608695652172,0.0066956521739130435,-0.016191304347826087,0.02543913043478261,-0.0025869565217391303,-0.00931304347826087,-12
3917,120000,0,2,2,34,1,2,2,3,2,0,45755,46725,49653,48571,47664,48720,2000,4000,0,0,2000,2000,0,43755,42725,49653,48571,45664,46720,0.364625,0.35604166666666665,0.413775,0.40475833333333333,0.38053333333333333,0.3893333333333333,10
3918,20000,1,2,2,28,0,0,0,0,0,0,10818,11938,12949,13332,13618,14619,1300,1217,600,500,1230,0,0,9518,10721,12349,12832,12388,14619,0.4759,0.53605,0.61745,0.6416,0.6194,0.73095,0
3919,150000,1,2,1,36,0,0,0,0,0,0,137664,140869,144954,101342,80819,81022,5500,6704,3712,3000,3890,3500,1,132164,134165,141242,98342,76929,77522,0.8810933333333333,0.8944333333333333,0.9416133333333333,0.6556133333333334,0.51286,0.5168133333333333,0
3920,170000,1,3,2,30,0,0,2,0,0,0,38903,37979,37069,37960,38796,39267,5144,0,1508,1600,1264,1391,0,33759,37979,35561,36360,37532,37876,0.19858235294117646,0.22340588235294118,0.20918235294117646,0.21388235294117647,0.2207764705882353,0.2228,2
3921,150000,0,1,1,49,-2,-2,-2,-2,-2,-2,111348,109115,102598,3039,-309,-309,6000,4044,309,0,0,0,1,105348,105071,102289,3039,-309,-309,0.70232,0.7004733333333333,0.6819266666666667,0.02026,-0.00206,-0.00206,-12
3922,30000,1,1,2,25,0,0,0,0,0,0,22399,25859,26540,13842,16299,18547,5000,1500,499,3000,3000,3000,0,17399,24359,26041,10842,13299,15547,0.5799666666666666,0.8119666666666666,0.8680333333333333,0.3614,0.4433,0.5182333333333333,0
3923,10000,1,3,1,55,2,2,4,4,4,4,420,420,420,420,420,420,0,0,0,0,0,780,1,420,420,420,420,420,-360,0.042,0.042,0.042,0.042,0.042,-0.036,20
3924,110000,0,2,1,27,1,2,2,2,2,2,46657,48615,49519,48421,50644,51662,3000,2000,0,3000,2000,3000,1,43657,46615,49519,45421,48644,48662,0.39688181818181817,0.42377272727272725,0.4501727272727273,0.4129181818181818,0.44221818181818184,0.4423818181818182,11
3925,100000,1,1,1,36,-1,-1,-1,-1,-1,-1,905,3450,1195,2775,890,2117,3450,1195,2775,890,2117,1072,1,-2545,2255,-1580,1885,-1227,1045,-0.02545,0.02255,-0.0158,0.01885,-0.01227,0.01045,-6
3926,50000,0,1,2,25,-1,-1,-1,-1,-1,-2,2543,14335,566,5243,0,0,14439,566,5243,0,0,1380,0,-11896,13769,-4677,5243,0,-1380,-0.23792,0.27538,-0.09354,0.10486,0.0,-0.0276,-7
3927,100000,0,3,2,47,0,0,0,0,0,0,94925,95130,60003,38500,4681,76728,3889,2412,1698,679,72809,2748,0,91036,92718,58305,37821,-68128,73980,0.91036,0.92718,0.58305,0.37821,-0.68128,0.7398,0
3928,20000,0,1,2,24,1,2,2,4,3,2,17375,16799,21408,20779,20170,19721,0,4893,0,0,0,1000,0,17375,11906,21408,20779,20170,18721,0.86875,0.5953,1.0704,1.03895,1.0085,0.93605,14
3929,140000,1,3,1,33,0,0,0,0,0,0,136302,127178,78950,80457,41150,-10193,6000,5000,4000,2000,0,71000,1,130302,122178,74950,78457,41150,-81193,0.9307285714285715,0.8727,0.5353571428571429,0.5604071428571429,0.29392857142857143,-0.57995,0
3930,30000,1,3,2,50,0,0,2,0,0,0,17891,19087,20078,20935,17228,17606,1800,1600,1600,1000,734,481,0,16091,17487,18478,19935,16494,17125,0.5363666666666667,0.5829,0.6159333333333333,0.6645,0.5498,0.5708333333333333,2
3931,290000,0,2,1,33,0,0,0,0,0,0,190547,173438,154966,131245,130861,120312,7158,5816,5000,5000,5000,4000,1,183389,167622,149966,126245,125861,116312,0.6323758620689656,0.5780068965517241,0.5171241379310345,0.43532758620689654,0.43400344827586207,0.4010758620689655,0
3932,50000,1,3,2,23,0,0,0,0,0,-1,32789,7006,8880,15088,-574,27529,1500,2000,6700,5000,28103,1032,0,31289,5006,2180,10088,-28677,26497,0.62578,0.10012,0.0436,0.20176,-0.57354,0.52994,-1
3933,260000,1,2,2,27,0,0,0,0,0,-1,19713,22378,24836,32816,42816,8938,3000,3000,10000,10000,8938,2000,0,16713,19378,14836,22816,33878,6938,0.06428076923076922,0.07453076923076923,0.05706153846153846,0.08775384615384615,0.1303,0.026684615384615383,-1
3934,290000,1,1,1,33,1,2,-1,-1,-1,-1,7064,1875,1814,8537,25576,13475,0,1814,8537,25576,13475,6000,1,7064,61,-6723,-17039,12101,7475,0.02435862068965517,0.0002103448275862069,-0.023182758620689654,-0.058755172413793105,0.04172758620689655,0.025775862068965517,-1
3935,50000,0,2,1,57,-1,0,-1,0,0,0,8617,5670,35835,20940,19146,19131,2000,36681,10000,9000,689,679,1,6617,-31011,25835,11940,18457,18452,0.13234,-0.62022,0.5167,0.2388,0.36914,0.36904,-2
3936,200000,1,3,2,25,0,0,0,0,-1,-1,7930,5790,9853,5334,5481,11344,1343,5033,3516,5497,11378,12774,0,6587,757,6337,-163,-5897,-1430,0.032935,0.003785,0.031685,-0.000815,-0.029485,-0.00715,-2
3937,200000,0,2,1,47,-2,-2,-2,-2,-2,-2,389,389,389,389,389,389,390,390,390,390,390,385,1,-1,-1,-1,-1,-1,4,-5e-06,-5e-06,-5e-06,-5e-06,-5e-06,2e-05,-12
3938,180000,0,3,1,36,-1,-1,-1,-1,-1,-1,1321,590,584,1196,3040,8009,590,584,1202,3049,8009,7820,1,731,6,-618,-1853,-4969,189,0.004061111111111111,3.3333333333333335e-05,-0.0034333333333333334,-0.010294444444444445,-0.027605555555555557,0.00105,-6
3939,230000,1,2,1,54,-2,-2,-2,-2,-2,-2,0,880,0,0,0,0,880,0,0,0,0,1740,1,-880,880,0,0,0,-1740,-0.0038260869565217392,0.0038260869565217392,0.0,0.0,0.0,-0.007565217391304348,-12
3940,20000,0,2,1,38,-1,-1,-1,-1,-1,-1,2638,3016,3274,7028,1839,2985,3016,3282,7055,1839,2985,4988,1,-378,-266,-3781,5189,-1146,-2003,-0.0189,-0.0133,-0.18905,0.25945,-0.0573,-0.10015,-6
3941,150000,0,2,1,35,0,0,0,0,0,0,129564,125063,118843,137751,141330,146389,10076,10050,30000,5000,6088,5150,1,119488,115013,88843,132751,135242,141239,0.7965866666666667,0.7667533333333333,0.5922866666666666,0.8850066666666667,0.9016133333333334,0.9415933333333333,0
3942,50000,0,2,1,36,0,0,0,0,0,0,47599,48542,49691,49172,9957,10044,2000,2200,1148,500,500,376,1,45599,46342,48543,48672,9457,9668,0.91198,0.92684,0.97086,0.97344,0.18914,0.19336,0
3943,140000,0,2,2,43,0,0,0,0,0,0,128947,106671,101362,87420,88774,81869,4039,7010,2359,7617,2760,2366,0,124908,99661,99003,79803,86014,79503,0.8922,0.7118642857142857,0.7071642857142857,0.5700214285714286,0.6143857142857143,0.5678785714285715,0
3944,80000,1,2,1,27,-2,-2,-2,-2,-2,-2,390,390,390,390,390,930,390,390,390,390,930,0,1,0,0,0,0,-540,930,0.0,0.0,0.0,0.0,-0.00675,0.011625,-12
3945,450000,0,1,1,34,0,0,0,0,0,0,451113,460261,455701,451559,429235,391559,18500,20000,17000,16300,14108,16000,1,432613,440261,438701,435259,415127,375559,0.9613622222222222,0.9783577777777778,0.9748911111111112,0.9672422222222222,0.9225044444444445,0.8345755555555555,0
3946,30000,1,4,1,45,0,0,0,0,0,0,26958,26716,26679,22972,20152,11688,4000,5022,1232,820,286,237,1,22958,21694,25447,22152,19866,11451,0.7652666666666667,0.7231333333333333,0.8482333333333333,0.7384,0.6622,0.3817,0
3947,130000,0,1,2,30,0,0,0,0,0,0,80528,77939,78524,63421,60269,59984,3700,3916,3000,3000,3000,1000,0,76828,74023,75524,60421,57269,58984,0.5909846153846153,0.5694076923076923,0.5809538461538462,0.4647769230769231,0.4405307692307692,0.4537230769230769,0
3948,300000,1,3,2,38,0,0,0,0,-1,-1,35103,43782,44508,67484,500,7391,10000,6000,30000,500,7391,7000,0,25103,37782,14508,66984,-6891,391,0.08367666666666666,0.12594,0.04836,0.22328,-0.02297,0.0013033333333333334,-2
3949,180000,1,2,2,28,-1,-1,-1,-1,-1,-1,340,-120,420,460,460,610,0,1000,500,460,610,460,0,340,-1120,-80,0,-150,150,0.001888888888888889,-0.006222222222222222,-0.00044444444444444447,0.0,-0.0008333333333333334,0.0008333333333333334,-6
3950,160000,1,1,2,28,0,0,0,0,0,0,118695,125186,131648,137902,145046,152551,10000,10000,10000,10000,10000,6000,0,108695,115186,121648,127902,135046,146551,0.67934375,0.7199125,0.7603,0.7993875,0.8440375,0.91594375,0
3951,360000,1,2,1,46,-1,-1,-1,-1,-1,-1,6402,13301,3762,7483,6399,9145,13389,3785,7527,6418,9187,15762,1,-6987,9516,-3765,1065,-2788,-6617,-0.019408333333333333,0.026433333333333333,-0.010458333333333333,0.002958333333333333,-0.007744444444444444,-0.018380555555555556,-6
3952,100000,0,3,3,48,2,-1,0,0,0,0,10514,8408,5250,9360,4098,800,13008,1119,7110,110,102,0,0,-2494,7289,-1860,9250,3996,800,-0.02494,0.07289,-0.0186,0.0925,0.03996,0.008,1
3953,300000,1,1,2,28,0,0,0,-1,-1,-2,9582,6803,7198,6975,9356,3697,1818,7217,7023,9383,3714,6546,0,7764,-414,175,-2408,5642,-2849,0.02588,-0.00138,0.0005833333333333334,-0.008026666666666666,0.018806666666666666,-0.009496666666666667,-4
3954,270000,1,1,2,29,-2,-2,-2,-2,-2,-2,990,5850,0,0,0,0,5850,0,0,0,0,0,0,-4860,5850,0,0,0,0,-0.018,0.021666666666666667,0.0,0.0,0.0,0.0,-12
3955,500000,1,1,2,35,-1,-1,-1,-1,0,-1,22369,14100,24754,21443,13892,11241,14128,24902,21479,11465,11356,66710,0,8241,-10802,3275,9978,2536,-55469,0.016482,-0.021604,0.00655,0.019956,0.005072,-0.110938,-5
3956,50000,0,2,1,24,0,0,0,0,0,0,17961,18689,19284,19517,19193,18848,1700,1600,1200,1000,1000,1200,1,16261,17089,18084,18517,18193,17648,0.32522,0.34178,0.36168,0.37034,0.36386,0.35296,0
3957,230000,1,1,2,37,1,-2,-2,-2,-1,2,-152,-152,-152,-152,42668,130,0,0,0,42820,0,1000,0,-152,-152,-152,-42972,42668,-870,-0.0006608695652173914,-0.0006608695652173914,-0.0006608695652173914,-0.18683478260869565,0.18551304347826086,-0.003782608695652174,-4
3958,280000,0,2,2,38,2,2,2,2,0,0,163675,168581,170775,166749,168739,166757,9000,6000,5,5858,5741,5608,0,154675,162581,170770,160891,162998,161149,0.5524107142857143,0.5806464285714286,0.6098928571428571,0.5746107142857143,0.5821357142857143,0.5755321428571428,8
3959,440000,1,1,1,53,0,0,0,0,0,0,295180,284145,255143,234395,216318,202530,13007,9102,10003,5000,5000,6000,1,282173,275043,245140,229395,211318,196530,0.6413022727272727,0.6250977272727273,0.5571363636363637,0.5213522727272727,0.4802681818181818,0.4466590909090909,0
3960,150000,1,2,1,53,-1,-1,-1,-1,-1,0,11589,28910,34731,18845,25745,13396,29190,34733,18857,25752,3396,8000,1,-17601,-5823,15874,-6907,22349,5396,-0.11734,-0.03882,0.10582666666666667,-0.046046666666666666,0.14899333333333334,0.035973333333333336,-5
3961,130000,0,1,2,26,-1,-1,0,0,0,0,2343,32278,24175,15182,12805,14415,32322,1217,1000,3000,2000,390,0,-29979,31061,23175,12182,10805,14025,-0.23060769230769232,0.23893076923076922,0.17826923076923076,0.09370769230769231,0.08311538461538462,0.10788461538461538,-2
3962,20000,1,2,1,43,4,4,3,2,2,2,28447,27721,27009,27170,26295,34171,0,0,924,0,9648,2000,1,28447,27721,26085,27170,16647,32171,1.42235,1.38605,1.30425,1.3585,0.83235,1.60855,17
3963,280000,1,3,2,38,-1,-1,-1,-1,0,0,6491,-1277,8413,19825,22085,12316,4041,16830,19862,12098,19,7428,0,2450,-18107,-11449,7727,22066,4888,0.00875,-0.06466785714285714,-0.04088928571428571,0.02759642857142857,0.07880714285714285,0.01745714285714286,-4
3964,50000,0,1,1,41,2,0,0,0,0,0,39159,40194,41209,42125,43443,44476,1669,1684,1600,2000,1753,1696,1,37490,38510,39609,40125,41690,42780,0.7498,0.7702,0.79218,0.8025,0.8338,0.8556,2
3965,180000,1,1,2,33,-2,-2,-2,-2,-2,-2,8492,5199,9973,10069,13190,20127,5199,9973,10083,13279,20127,9422,0,3293,-4774,-110,-3210,-6937,10705,0.018294444444444443,-0.02652222222222222,-0.0006111111111111111,-0.017833333333333333,-0.038538888888888886,0.059472222222222225,-12
3966,50000,0,3,1,44,0,0,0,0,0,0,49996,50386,24565,21098,18965,18063,1596,1291,695,668,654,637,1,48400,49095,23870,20430,18311,17426,0.968,0.9819,0.4774,0.4086,0.36622,0.34852,0
3967,50000,0,2,2,33,0,0,0,0,0,0,47364,48355,49715,49736,17599,16753,1780,2140,1161,510,503,500,0,45584,46215,48554,49226,17096,16253,0.91168,0.9243,0.97108,0.98452,0.34192,0.32506,0
3968,80000,0,2,1,36,0,0,0,0,0,0,77870,79472,81757,77200,77669,79667,2900,3900,2750,2800,3200,2964,1,74970,75572,79007,74400,74469,76703,0.937125,0.94465,0.9875875,0.93,0.9308625,0.9587875,0
3969,160000,0,1,2,34,-2,-2,-2,-1,-1,-2,0,150,1397,690,0,0,150,1397,690,0,0,0,0,-150,-1247,707,690,0,0,-0.0009375,-0.00779375,0.00441875,0.0043125,0.0,0.0,-10
3970,120000,1,2,1,25,2,0,0,2,0,0,17488,19002,20805,18271,18128,16405,3000,3000,0,961,2000,2056,1,14488,16002,20805,17310,16128,14349,0.12073333333333333,0.13335,0.173375,0.14425,0.1344,0.119575,4
3971,130000,1,2,1,37,0,0,0,0,0,0,110434,108740,122873,122870,120373,134146,4100,20000,6000,5000,20000,6000,1,106334,88740,116873,117870,100373,128146,0.8179538461538461,0.6826153846153846,0.8990230769230769,0.9066923076923077,0.7721,0.9857384615384616,0
3972,90000,1,2,2,48,-2,-2,-2,-2,-2,-2,6224,8150,0,0,9167,0,8150,0,0,9167,0,526,0,-1926,8150,0,-9167,9167,-526,-0.0214,0.09055555555555556,0.0,-0.10185555555555556,0.10185555555555556,-0.005844444444444445,-12
3973,180000,1,1,2,24,0,0,0,0,0,0,130780,121531,112378,93411,95559,94356,4700,4500,3300,3600,3900,3500,0,126080,117031,109078,89811,91659,90856,0.7004444444444444,0.6501722222222223,0.6059888888888889,0.49895,0.5092166666666667,0.5047555555555555,0
3974,350000,1,2,1,36,1,-2,-2,-2,-1,0,0,0,0,0,11525,11760,0,0,0,11525,235,2270,1,0,0,0,-11525,11290,9490,0.0,0.0,0.0,-0.032928571428571425,0.03225714285714286,0.027114285714285716,-6
3975,50000,1,2,2,25,3,2,0,0,0,0,66881,65115,51010,50342,36025,36778,0,2092,1460,1167,1209,1645,0,66881,63023,49550,49175,34816,35133,1.33762,1.26046,0.991,0.9835,0.69632,0.70266,5
3976,130000,0,2,2,29,0,0,0,0,0,0,131041,133698,131990,127512,128683,129669,7000,5151,4464,5000,4702,8000,0,124041,128547,127526,122512,123981,121669,0.9541615384615385,0.9888230769230769,0.9809692307692308,0.9424,0.9537,0.9359153846153846,0
3977,210000,1,2,2,41,0,0,0,0,0,0,165425,169174,171459,177590,180147,184084,8000,6500,9000,7000,7000,7000,0,157425,162674,162459,170590,173147,177084,0.7496428571428572,0.7746380952380952,0.7736142857142857,0.8123333333333334,0.8245095238095238,0.8432571428571428,0
3978,90000,0,2,1,29,-1,-1,-1,0,0,-1,500,715,26854,28146,0,2000,715,26854,3000,0,2000,0,1,-215,-26139,23854,28146,-2000,2000,-0.0023888888888888887,-0.2904333333333333,0.26504444444444447,0.3127333333333333,-0.022222222222222223,0.022222222222222223,-4
3979,90000,0,2,1,44,0,0,0,0,0,0,16420,17441,18467,19554,20028,20704,1300,1313,1400,800,1000,800,1,15120,16128,17067,18754,19028,19904,0.168,0.1792,0.18963333333333332,0.20837777777777777,0.21142222222222223,0.22115555555555555,0
3980,50000,1,3,2,58,1,-1,2,0,0,0,0,9587,8845,8867,9074,9254,10587,331,317,350,331,500,0,-10587,9256,8528,8517,8743,8754,-0.21174,0.18512,0.17056,0.17034,0.17486,0.17508,2
3981,50000,1,3,2,22,0,0,0,0,0,0,18108,18512,19468,16989,17326,17748,1400,1300,2800,619,700,1000,0,16708,17212,16668,16370,16626,16748,0.33416,0.34424,0.33336,0.3274,0.33252,0.33496,0
3982,30000,1,2,2,33,0,0,0,0,0,0,30336,29965,28048,29775,27736,26956,3005,2000,3000,3000,2000,2000,0,27331,27965,25048,26775,25736,24956,0.9110333333333334,0.9321666666666667,0.8349333333333333,0.8925,0.8578666666666667,0.8318666666666666,0
3983,60000,1,2,2,24,-1,0,0,0,0,0,57147,58104,58311,58828,58945,57918,3000,3000,2500,2100,4000,2100,0,54147,55104,55811,56728,54945,55818,0.90245,0.9184,0.9301833333333334,0.9454666666666667,0.91575,0.9303,-1
3984,500000,1,1,1,38,-1,0,-1,0,0,0,5410,2760,36861,23200,34255,18554,2700,36861,10000,20055,1000,5622,1,2710,-34101,26861,3145,33255,12932,0.00542,-0.068202,0.053722,0.00629,0.06651,0.025864,-2
3985,110000,1,2,2,39,0,0,0,0,0,0,109221,111674,111867,111535,111870,110979,4230,4230,4200,4300,4150,4220,0,104991,107444,107667,107235,107720,106759,0.9544636363636364,0.9767636363636364,0.978790909090909,0.9748636363636364,0.9792727272727273,0.9705363636363636,0
3986,20000,0,2,2,31,-1,-1,-1,2,0,0,5380,0,184,184,5932,7725,0,184,0,5924,2000,2451,0,5380,-184,184,-5740,3932,5274,0.269,-0.0092,0.0092,-0.287,0.1966,0.2637,-1
3987,90000,0,1,2,26,1,-2,-1,-1,0,0,0,0,403,33982,30738,29018,0,403,33982,1000,1000,1000,0,0,-403,-33579,32982,29738,28018,0.0,-0.004477777777777778,-0.3731,0.36646666666666666,0.33042222222222223,0.3113111111111111,-3
3988,30000,0,3,1,47,0,0,2,0,0,-2,27609,30791,29913,30461,0,0,3630,0,1300,0,0,0,1,23979,30791,28613,30461,0,0,0.7993,1.0263666666666666,0.9537666666666667,1.0153666666666668,0.0,0.0,0
3989,500000,1,2,1,37,0,0,0,0,0,-1,156951,115610,81334,78637,36993,22089,20167,2114,1751,5132,22197,156937,1,136784,113496,79583,73505,14796,-134848,0.273568,0.226992,0.159166,0.14701,0.029592,-0.269696,-1
3990,80000,1,1,2,27,-1,-1,-1,-2,-2,-1,825,825,-6042,-6867,-8692,54375,825,0,0,0,150000,10000,0,0,825,-6042,-6867,-158692,44375,0.0,0.0103125,-0.075525,-0.0858375,-1.98365,0.5546875,-8
3991,70000,0,3,1,40,0,0,0,0,0,-1,41986,31059,23283,11523,23516,1600,1455,1278,1000,235,1600,4316,1,40531,29781,22283,11288,21916,-2716,0.5790142857142857,0.4254428571428571,0.3183285714285714,0.16125714285714285,0.3130857142857143,-0.0388,-1
3992,340000,1,1,2,45,0,0,0,0,0,0,68288,70573,69808,66670,63277,62027,15000,13500,13000,13000,13000,13000,0,53288,57073,56808,53670,50277,49027,0.1567294117647059,0.16786176470588235,0.16708235294117646,0.15785294117647058,0.1478735294117647,0.1441970588235294,0
3993,40000,1,2,2,24,2,0,0,0,0,0,19012,20018,21047,22360,22499,22969,1326,1355,1668,807,834,837,0,17686,18663,19379,21553,21665,22132,0.44215,0.466575,0.484475,0.538825,0.541625,0.5533,2
3994,70000,1,3,2,43,0,0,0,0,0,0,72770,69438,69776,51450,26516,27044,4108,2500,928,2000,969,1002,0,68662,66938,68848,49450,25547,26042,0.9808857142857142,0.9562571428571428,0.9835428571428572,0.7064285714285714,0.36495714285714287,0.37202857142857143,0
3995,150000,1,1,2,31,0,0,0,0,0,0,126419,128887,134208,139551,134321,104513,7000,12440,10000,5000,5000,10000,0,119419,116447,124208,134551,129321,94513,0.7961266666666666,0.7763133333333333,0.8280533333333333,0.8970066666666666,0.86214,0.6300866666666667,0
3996,160000,1,1,2,34,0,0,0,0,0,0,43729,43535,40799,41255,31766,32570,2045,1809,1265,1154,1333,1313,0,41684,41726,39534,40101,30433,31257,0.260525,0.2607875,0.2470875,0.25063125,0.19020625,0.19535625,0
3997,110000,1,1,2,32,0,0,0,-2,-2,-2,60558,30900,0,0,0,0,1900,0,0,0,0,0,0,58658,30900,0,0,0,0,0.5332545454545454,0.2809090909090909,0.0,0.0,0.0,0.0,-6
3998,260000,1,1,2,31,-1,-1,-1,-1,-1,0,1629,933,2218,4068,9829,21270,933,2220,4068,9829,11680,553,0,696,-1287,-1850,-5761,-1851,20717,0.0026769230769230767,-0.00495,-0.007115384615384615,-0.02215769230769231,-0.007119230769230769,0.07968076923076924,-5
3999,130000,0,2,2,32,0,0,-2,-2,-2,-2,27495,0,0,0,0,0,0,0,0,0,0,0,0,27495,0,0,0,0,0,0.2115,0.0,0.0,0.0,0.0,0.0,-8
4000,90000,1,2,1,32,0,0,0,0,0,0,39664,24589,22677,20842,20545,20989,1657,1676,1554,805,846,651,1,38007,22913,21123,20037,19699,20338,0.4223,0.25458888888888886,0.2347,0.22263333333333332,0.21887777777777778,0.22597777777777778,0
4001,240000,1,1,2,38,-1,-1,-1,-1,-1,-1,6916,2098,9927,3633,3603,926,2106,9951,3633,3603,926,7199,0,4810,-7853,6294,30,2677,-6273,0.020041666666666666,-0.03272083333333333,0.026225,0.000125,0.011154166666666666,-0.0261375,-6
4002,360000,1,2,2,25,0,0,0,0,0,0,336179,173781,161223,145172,131346,134135,6781,7226,5032,5346,15003,15011,0,329398,166555,156191,139826,116343,119124,0.9149944444444444,0.4626527777777778,0.4338638888888889,0.38840555555555556,0.323175,0.3309,0
4003,230000,1,3,1,44,-1,-1,-1,-1,-1,-1,54798,11632,4987,6222,15121,17425,11632,4987,6222,15121,17425,17007,1,43166,6645,-1235,-8899,-2304,418,0.1876782608695652,0.028891304347826087,-0.005369565217391304,-0.03869130434782609,-0.010017391304347827,0.001817391304347826,-6
4004,180000,1,1,2,24,0,0,0,0,0,0,169263,174532,176686,165491,169222,173246,8000,6700,6000,6400,7000,7000,0,161263,167832,170686,159091,162222,166246,0.8959055555555555,0.9324,0.9482555555555555,0.8838388888888888,0.9012333333333333,0.9235888888888889,0
4005,70000,1,2,2,46,0,0,0,0,0,0,86919,83200,80389,75854,33563,34563,3000,3815,3064,1000,1000,34000,0,83919,79385,77325,74854,32563,563,1.198842857142857,1.1340714285714286,1.104642857142857,1.0693428571428572,0.46518571428571426,0.008042857142857143,0
4006,240000,0,2,1,38,0,0,0,0,0,0,132090,143966,155632,162379,156655,157536,20030,20000,10070,10037,13137,10052,1,112060,123966,145562,152342,143518,147484,0.46691666666666665,0.516525,0.6065083333333333,0.6347583333333333,0.5979916666666667,0.6145166666666667,0
4007,360000,1,2,1,26,0,0,0,0,0,0,358897,357100,362900,293597,249345,228470,14245,14061,11028,8813,7900,8100,1,344652,343039,351872,284784,241445,220370,0.9573666666666667,0.9528861111111111,0.9774222222222222,0.7910666666666667,0.6706805555555555,0.6121388888888889,0
4008,470000,0,1,1,38,0,0,0,0,0,0,33277,34292,38423,197773,202722,46980,1869,5000,162546,5783,1689,1977,1,31408,29292,-124123,191990,201033,45003,0.06682553191489361,0.06232340425531915,-0.2640914893617021,0.4084893617021277,0.42772978723404254,0.09575106382978724,0
4009,150000,1,1,1,30,0,0,0,0,0,2,114797,117393,120002,122013,131426,134676,4500,4500,4000,11000,5000,3500,1,110297,112893,116002,111013,126426,131176,0.7353133333333334,0.75262,0.7733466666666666,0.7400866666666667,0.84284,0.8745066666666667,2
4010,30000,1,2,1,47,0,0,2,2,2,2,27119,29243,31037,30908,29969,29488,2894,2559,800,600,1000,0,1,24225,26684,30237,30308,28969,29488,0.8075,0.8894666666666666,1.0079,1.0102666666666666,0.9656333333333333,0.9829333333333333,8
4011,50000,1,2,2,28,1,3,3,2,2,2,45472,47923,46898,45849,48258,48341,3500,0,0,3500,1000,3500,0,41972,47923,46898,42349,47258,44841,0.83944,0.95846,0.93796,0.84698,0.94516,0.89682,13
4012,280000,1,1,1,30,0,0,0,0,0,0,217773,215017,209089,167458,137312,109980,8155,10048,6011,6010,6514,10011,1,209618,204969,203078,161448,130798,99969,0.7486357142857143,0.7320321428571429,0.7252785714285714,0.5766,0.46713571428571427,0.35703214285714285,0
4013,80000,1,2,1,42,0,0,0,-1,-1,0,43045,43024,9821,600,53900,55000,1301,5098,600,53900,1100,10000,1,41744,37926,9221,-53300,52800,45000,0.5218,0.474075,0.1152625,-0.66625,0.66,0.5625,-2
4014,20000,1,3,1,56,1,3,2,2,0,0,9061,8769,9680,9376,9720,10962,0,1200,0,500,1400,0,1,9061,7569,9680,8876,8320,10962,0.45305,0.37845,0.484,0.4438,0.416,0.5481,8
4015,110000,1,1,1,55,-1,2,2,-1,0,-1,632,316,0,632,316,632,0,0,948,0,632,0,1,632,316,-948,632,-316,632,0.005745454545454546,0.002872727272727273,-0.008618181818181818,0.005745454545454546,-0.002872727272727273,0.005745454545454546,1
4016,70000,1,2,2,25,0,0,0,0,0,0,19508,19633,19685,18887,19073,20208,2000,2000,1000,2000,3003,3007,0,17508,17633,18685,16887,16070,17201,0.25011428571428573,0.2519,0.2669285714285714,0.24124285714285715,0.22957142857142857,0.24572857142857144,0
4017,120000,1,1,1,39,1,-2,-2,-2,-1,-1,0,0,0,0,915,0,0,0,0,915,0,0,1,0,0,0,-915,915,0,0.0,0.0,0.0,-0.007625,0.007625,0.0,-7
4018,180000,1,1,2,25,0,0,0,0,0,0,112403,83515,71259,66661,62770,58067,3500,3500,3000,3000,2300,2400,0,108903,80015,68259,63661,60470,55667,0.6050166666666666,0.4445277777777778,0.37921666666666665,0.3536722222222222,0.33594444444444443,0.3092611111111111,0
4019,80000,1,2,1,60,1,-1,-1,-1,-1,-1,-2,759,596,-4,1426,1300,761,597,0,1430,1309,1844,1,-763,162,596,-1434,117,-544,-0.0095375,0.002025,0.00745,-0.017925,0.0014625,-0.0068,-4
4020,340000,1,1,2,30,1,-2,-2,-2,-2,-2,0,0,0,0,0,0,0,0,0,0,0,0,0,0,0,0,0,0,0,0.0,0.0,0.0,0.0,0.0,0.0,-9
4021,80000,1,2,1,45,0,0,0,0,0,0,79552,81392,80966,79295,81142,80672,3130,3107,2847,3134,3072,3010,1,76422,78285,78119,76161,78070,77662,0.955275,0.9785625,0.9764875,0.9520125,0.975875,0.970775,0
4022,20000,0,2,2,34,1,2,0,0,0,0,15095,14459,12607,16430,19230,0,0,6000,5000,3000,0,0,0,15095,8459,7607,13430,19230,0,0.75475,0.42295,0.38035,0.6715,0.9615,0.0,3
4023,230000,1,1,2,41,-1,-1,-1,-1,-1,0,177,0,376,47992,3099,2389,0,376,48042,3099,0,0,0,177,-376,-47666,44893,3099,2389,0.0007695652173913043,-0.0016347826086956522,-0.20724347826086956,0.19518695652173912,0.013473913043478261,0.01038695652173913,-5
4024,80000,0,1,2,26,0,0,0,0,0,0,84488,83593,72883,67337,60807,59088,2871,2727,3170,1940,2200,1700,0,81617,80866,69713,65397,58607,57388,1.0202125,1.010825,0.8714125,0.8174625,0.7325875,0.71735,0
4025,240000,0,1,2,30,0,0,0,0,0,0,213483,216856,220514,217068,5886,11841,8008,10038,10029,1038,7000,0,0,205475,206818,210485,216030,-1114,11841,0.8561458333333334,0.8617416666666666,0.8770208333333334,0.900125,-0.004641666666666666,0.0493375,0
4026,20000,1,2,2,22,0,0,0,0,0,0,15247,16561,17280,18431,18341,19569,1575,1294,1596,655,1669,0,0,13672,15267,15684,17776,16672,19569,0.6836,0.76335,0.7842,0.8888,0.8336,0.97845,0
4027,70000,1,1,2,29,0,0,0,0,0,0,66867,66502,54263,47562,43735,43509,3020,5040,2000,2000,12000,5000,0,63847,61462,52263,45562,31735,38509,0.9121,0.8780285714285714,0.7466142857142857,0.6508857142857143,0.45335714285714285,0.5501285714285714,0
4028,200000,0,2,1,57,-1,-1,-1,-1,-1,-1,780,0,780,390,0,390,0,780,390,0,390,390,1,780,-780,390,390,-390,0,0.0039,-0.0039,0.00195,0.00195,-0.00195,0.0,-6
4029,230000,1,3,1,48,1,-1,-1,-1,-1,-1,-5,4582,2883,20099,13870,4234,4587,2883,20099,13870,4234,0,1,-4592,1699,-17216,6229,9636,4234,-0.019965217391304347,0.00738695652173913,-0.07485217391304348,0.027082608695652172,0.04189565217391304,0.01840869565217391,-4
4030,80000,0,2,2,29,-1,-1,-1,0,0,0,28175,0,68227,68040,69840,69840,0,68227,2000,2000,0,0,0,28175,-68227,66227,66040,69840,69840,0.3521875,-0.8528375,0.8278375,0.8255,0.873,0.873,-3
4031,80000,1,3,1,55,0,0,0,-2,-2,-2,72462,41300,0,0,0,0,3000,0,0,0,0,0,1,69462,41300,0,0,0,0,0.868275,0.51625,0.0,0.0,0.0,0.0,-6
4032,30000,1,2,1,36,-1,-1,-1,-1,-1,-1,326,326,833,326,802,802,326,833,326,802,326,0,1,0,-507,507,-476,476,802,0.0,-0.0169,0.0169,-0.015866666666666668,0.015866666666666668,0.026733333333333335,-6
4033,60000,1,1,1,25,0,0,0,0,0,0,45575,43303,27113,19582,19109,17236,1432,11279,1960,1000,633,527,1,44143,32024,25153,18582,18476,16709,0.7357166666666667,0.5337333333333333,0.4192166666666667,0.3097,0.30793333333333334,0.27848333333333336,0
4034,400000,1,2,2,30,2,0,0,0,0,0,24054,25381,26085,26779,29283,29764,1624,1328,1022,3000,1000,1171,0,22430,24053,25063,23779,28283,28593,0.056075,0.0601325,0.0626575,0.0594475,0.0707075,0.0714825,2
4035,380000,0,1,2,33,-1,-1,-2,-2,-2,-2,2500,0,0,0,0,0,0,0,0,0,0,0,0,2500,0,0,0,0,0,0.006578947368421052,0.0,0.0,0.0,0.0,0.0,-10
4036,50000,0,3,1,47,1,-2,-2,-2,-2,-2,0,0,0,0,0,0,0,0,0,0,0,0,1,0,0,0,0,0,0,0.0,0.0,0.0,0.0,0.0,0.0,-9
4037,400000,1,1,1,32,-2,-2,-2,-2,-2,-1,110,532,2651,0,644,636,587,2651,0,644,636,572,1,-477,-2119,2651,-644,8,64,-0.0011925,-0.0052975,0.0066275,-0.00161,2e-05,0.00016,-11
4038,200000,1,2,1,37,0,0,0,0,0,0,114480,117791,123108,124327,127011,134519,5000,7000,4500,4500,9500,5000,1,109480,110791,118608,119827,117511,129519,0.5474,0.553955,0.59304,0.599135,0.587555,0.647595,0
4039,470000,0,1,2,31,0,0,0,0,0,0,99931,95096,80388,75631,71464,65915,5070,4019,2019,2120,2096,1744,0,94861,91077,78369,73511,69368,64171,0.20183191489361701,0.19378085106382978,0.16674255319148937,0.1564063829787234,0.14759148936170213,0.1365340425531915,0
4040,30000,1,2,2,22,0,0,0,0,0,0,27388,29016,26941,27491,6726,0,2075,1000,550,135,0,0,0,25313,28016,26391,27356,6726,0,0.8437666666666667,0.9338666666666666,0.8797,0.9118666666666667,0.2242,0.0,0
4041,10000,1,2,2,21,-1,-1,2,0,0,0,8126,8830,8898,9517,8505,4557,1668,1000,1000,170,0,0,0,6458,7830,7898,9347,8505,4557,0.6458,0.783,0.7898,0.9347,0.8505,0.4557,0
4042,390000,1,1,2,29,0,0,0,0,0,0,196172,196262,157388,123706,115813,112143,9599,10054,4242,4346,5000,5000,0,186573,186208,153146,119360,110813,107143,0.4783923076923077,0.4774564102564103,0.3926820512820513,0.30605128205128207,0.28413589743589746,0.274725641025641,0
4043,20000,1,2,1,45,-1,-1,-1,0,-1,-1,10827,8264,2480,390,880,1560,8264,2480,0,880,1070,40000,1,2563,5784,2480,-490,-190,-38440,0.12815,0.2892,0.124,-0.0245,-0.0095,-1.922,-5
4044,50000,1,2,2,33,0,0,0,0,0,0,51444,52607,48083,30205,29747,30042,2000,1500,1690,1200,1200,992,0,49444,51107,46393,29005,28547,29050,0.98888,1.02214,0.92786,0.5801,0.57094,0.581,0
4045,100000,1,1,2,35,0,0,0,0,0,0,99031,90779,84891,76232,77833,74885,3300,4300,3000,2626,2913,2600,0,95731,86479,81891,73606,74920,72285,0.95731,0.86479,0.81891,0.73606,0.7492,0.72285,0
4046,160000,1,1,2,46,-2,-2,-2,-2,-2,-2,6241,8788,0,0,0,0,8805,0,0,0,0,0,0,-2564,8788,0,0,0,0,-0.016025,0.054925,0.0,0.0,0.0,0.0,-12
4047,80000,0,1,2,27,0,0,0,0,0,0,72565,63342,51529,41484,34097,29200,10000,4000,2000,3000,2500,0,0,62565,59342,49529,38484,31597,29200,0.7820625,0.741775,0.6191125,0.48105,0.3949625,0.365,0
4048,280000,1,2,2,36,0,0,0,0,0,0,91093,92775,81718,83347,85623,87252,3224,2965,2987,3623,3148,3194,0,87869,89810,78731,79724,82475,84058,0.31381785714285715,0.32075,0.2811821428571429,0.28472857142857144,0.2945535714285714,0.30020714285714284,0
4049,140000,1,3,1,25,-2,-2,-2,-2,-2,-2,76910,22972,28336,30281,38339,80792,1994,18002,3001,9004,45117,40158,1,74916,4970,25335,21277,-6778,40634,0.5351142857142858,0.0355,0.18096428571428572,0.15197857142857144,-0.048414285714285715,0.29024285714285714,-12
4050,320000,0,2,2,27,0,0,0,0,0,0,319069,323319,298072,180882,175560,131390,12661,11157,5730,5904,5890,2464,0,306408,312162,292342,174978,169670,128926,0.957525,0.97550625,0.91356875,0.54680625,0.53021875,0.40289375,0
4051,220000,1,2,2,35,0,0,0,0,0,0,34819,30937,30348,23459,23200,21281,2006,2022,1002,1007,1000,1008,0,32813,28915,29346,22452,22200,20273,0.14915,0.13143181818181818,0.1333909090909091,0.10205454545454545,0.1009090909090909,0.09215,0
4052,190000,1,3,1,27,0,0,2,-1,-1,0,43903,53382,21811,2921,107441,108642,10882,0,2921,107441,4000,3700,1,33021,53382,18890,-104520,103441,104942,0.17379473684210525,0.28095789473684213,0.09942105263157895,-0.5501052631578948,0.5444263157894736,0.5523263157894737,0
4053,240000,1,2,1,46,0,0,0,0,0,0,8751,9900,10605,10765,11765,4311,1295,1000,1000,1000,1000,1000,1,7456,8900,9605,9765,10765,3311,0.031066666666666666,0.037083333333333336,0.04002083333333333,0.0406875,0.04485416666666667,0.013795833333333334,0
4054,160000,0,1,2,42,-2,-2,-2,-2,-2,-2,51997,0,0,0,0,0,0,0,0,0,0,0,0,51997,0,0,0,0,0,0.32498125,0.0,0.0,0.0,0.0,0.0,-12
4055,210000,1,1,2,39,-1,-1,-1,0,-1,-1,3962,1772,3608,1918,1429,2381,1777,3613,5,1433,2387,2857,0,2185,-1841,3603,485,-958,-476,0.010404761904761905,-0.008766666666666667,0.017157142857142857,0.0023095238095238095,-0.004561904761904762,-0.002266666666666667,-5
4056,200000,0,2,1,39,-1,-1,-1,-1,-1,-1,326,326,326,326,326,326,326,326,326,326,326,326,1,0,0,0,0,0,0,0.0,0.0,0.0,0.0,0.0,0.0,-6
4057,60000,1,2,1,47,0,0,0,2,-1,2,27970,28004,31688,30448,452,302,1456,4140,0,904,0,12985,1,26514,23864,31688,29544,452,-12683,0.4419,0.3977333333333333,0.5281333333333333,0.4924,0.007533333333333334,-0.21138333333333334,3
4058,20000,0,1,2,42,0,0,0,-2,-2,-1,15610,18250,0,0,0,1000,3000,0,0,0,1000,8024,0,12610,18250,0,0,-1000,-7024,0.6305,0.9125,0.0,0.0,-0.05,-0.3512,-5
4059,90000,1,3,1,40,0,0,0,0,0,0,89928,81721,76947,46589,47730,49488,3416,4142,1700,1888,2710,1500,1,86512,77579,75247,44701,45020,47988,0.9612444444444445,0.8619888888888889,0.8360777777777778,0.4966777777777778,0.5002222222222222,0.5332,0
4060,100000,1,3,1,45,3,2,2,2,-1,-1,94471,92058,97624,94316,2065,0,0,8806,0,2065,0,0,1,94471,83252,97624,92251,2065,0,0.94471,0.83252,0.97624,0.92251,0.02065,0.0,7
4061,80000,1,1,2,37,-1,-1,-1,-1,-1,-1,10115,249,5986,188,1644,16872,258,5995,188,1644,16872,4000,0,9857,-5746,5798,-1456,-15228,12872,0.1232125,-0.071825,0.072475,-0.0182,-0.19035,0.1609,-6
4062,270000,1,1,1,42,2,2,5,5,4,3,1250,1250,1250,1250,650,350,0,0,0,0,0,0,1,1250,1250,1250,1250,650,350,0.004629629629629629,0.004629629629629629,0.004629629629629629,0.004629629629629629,0.0024074074074074076,0.0012962962962962963,21
4063,120000,1,1,3,44,0,0,2,0,0,0,70096,76446,73732,12329,12329,0,8100,0,247,0,0,0,0,61996,76446,73485,12329,12329,0,0.5166333333333334,0.63705,0.612375,0.10274166666666666,0.10274166666666666,0.0,2
4064,180000,0,1,1,48,0,0,0,0,0,0,64788,66092,65236,65912,66523,67020,3000,2370,3000,3000,2588,2500,1,61788,63722,62236,62912,63935,64520,0.34326666666666666,0.3540111111111111,0.34575555555555554,0.3495111111111111,0.3551944444444444,0.35844444444444445,0
4065,180000,0,1,2,37,-1,-1,-1,-1,0,0,49531,45612,0,245863,250472,251024,45612,0,245863,5009,5040,0,0,3919,45612,-245863,240854,245432,251024,0.02177222222222222,0.2534,-1.3659055555555555,1.3380777777777777,1.3635111111111111,1.3945777777777777,-4
4066,90000,1,2,2,39,-1,2,-1,-1,0,0,2489,1242,1062,1062,1062,0,0,1062,1062,0,0,0,0,2489,180,0,1062,1062,0,0.027655555555555555,0.002,0.0,0.0118,0.0118,0.0,-1
4067,430000,1,1,1,34,-1,-1,-1,-1,-1,-1,5149,4588,11164,1531,9848,10178,4600,11220,1531,9902,10202,5926,1,549,-6632,9633,-8371,-354,4252,0.0012767441860465115,-0.015423255813953488,0.02240232558139535,-0.019467441860465118,-0.0008232558139534883,0.009888372093023255,-6
4068,470000,0,1,2,29,-1,0,0,0,0,0,215666,209106,207970,212373,193628,184908,7395,8037,9048,10000,6115,5750,0,208271,201069,198922,202373,187513,179158,0.44312978723404256,0.4278063829787234,0.4232382978723404,0.43058085106382976,0.39896382978723405,0.38118723404255317,-1
4069,60000,1,3,1,48,-1,-1,-2,-2,-2,-1,2970,430,430,717,430,4171,430,430,717,430,4171,2914,1,2540,0,-287,287,-3741,1257,0.042333333333333334,0.0,-0.004783333333333333,0.004783333333333333,-0.06235,0.02095,-9
4070,110000,0,2,1,26,0,0,0,0,0,0,52489,53615,54803,55729,57001,58036,2000,2050,1895,2068,1982,1995,1,50489,51565,52908,53661,55019,56041,0.4589909090909091,0.4687727272727273,0.4809818181818182,0.4878272727272727,0.5001727272727273,0.5094636363636363,0
4071,10000,0,2,1,30,-1,-1,-1,-1,-2,-2,390,0,780,0,0,0,0,780,0,0,0,0,1,390,-780,780,0,0,0,0.039,-0.078,0.078,0.0,0.0,0.0,-8
4072,200000,1,2,2,46,-2,-2,-2,-2,-2,-2,0,0,0,0,0,0,0,0,0,0,0,600,0,0,0,0,0,0,-600,0.0,0.0,0.0,0.0,0.0,-0.003,-12
4073,330000,1,1,2,26,0,0,0,0,0,0,58667,38323,32726,43579,28908,20777,2213,5000,20000,1000,672,1200,0,56454,33323,12726,42579,28236,19577,0.17107272727272727,0.10097878787878788,0.03856363636363636,0.12902727272727274,0.08556363636363637,0.059324242424242425,0
4074,260000,1,3,2,42,-1,-1,-2,-2,-2,-2,6783,0,0,0,0,0,0,0,0,0,0,0,0,6783,0,0,0,0,0,0.02608846153846154,0.0,0.0,0.0,0.0,0.0,-10
4075,180000,0,1,2,38,1,2,0,0,0,0,124233,125768,126202,127677,99764,0,5000,4200,3000,5000,2000,0,0,119233,121568,123202,122677,97764,0,0.6624055555555556,0.6753777777777777,0.6844555555555556,0.6815388888888889,0.5431333333333334,0.0,3
4076,100000,0,1,2,33,2,0,0,0,0,0,101329,103532,100485,101552,100752,100652,3900,6000,3900,4100,17000,3750,0,97429,97532,96585,97452,83752,96902,0.97429,0.97532,0.96585,0.97452,0.83752,0.96902,2
4077,270000,1,1,2,29,0,0,0,0,0,0,125120,102046,91426,93262,96104,98374,4000,2969,3000,4000,3500,3450,0,121120,99077,88426,89262,92604,94924,0.4485925925925926,0.36695185185185186,0.3275037037037037,0.3306,0.34297777777777777,0.35157037037037037,0
4078,130000,1,1,1,47,0,0,0,0,0,0,113470,110794,65715,67523,68131,68140,4000,3000,5500,3000,3000,1700,1,109470,107794,60215,64523,65131,66440,0.8420769230769231,0.8291846153846154,0.4631923076923077,0.49633076923076924,0.5010076923076923,0.5110769230769231,0
4079,180000,0,2,2,28,1,2,2,2,2,2,29484,30309,28313,942,1038,492,2000,942,0,492,0,600,0,27484,29367,28313,450,1038,-108,0.1526888888888889,0.16315,0.15729444444444443,0.0025,0.0057666666666666665,-0.0006,11
4080,320000,0,2,2,32,0,0,0,0,0,0,21460,23412,25331,25741,26800,28817,3000,3000,1500,2000,3000,2000,0,18460,20412,23831,23741,23800,26817,0.0576875,0.0637875,0.074471875,0.074190625,0.074375,0.083803125,0
4081,30000,1,2,2,25,2,2,2,2,3,2,300,300,300,1126,826,676,0,0,828,0,0,31496,0,300,300,-528,1126,826,-30820,0.01,0.01,-0.0176,0.037533333333333335,0.027533333333333333,-1.0273333333333334,13
4082,200000,1,2,1,29,-2,-2,-2,-2,-2,-2,8350,14139,3580,6386,868,10415,14185,7425,6386,868,10647,4320,1,-5835,6714,-2806,5518,-9779,6095,-0.029175,0.03357,-0.01403,0.02759,-0.048895,0.030475,-12
4083,240000,0,2,2,31,0,0,0,0,0,0,231467,231619,234261,231597,42209,26348,8500,9358,5104,864,527,0,0,222967,222261,229157,230733,41682,26348,0.9290291666666667,0.9260875,0.9548208333333333,0.9613875,0.173675,0.10978333333333333,0
4084,260000,0,2,2,30,0,0,0,2,0,0,98560,100980,222102,108724,68500,69174,4000,11900,207,2003,2003,2003,0,94560,89080,221895,106721,66497,67171,0.3636923076923077,0.3426153846153846,0.8534423076923077,0.4104653846153846,0.2557576923076923,0.25835,2
4085,50000,1,1,2,25,0,0,0,0,0,0,10973,12092,13386,13663,14440,15150,1300,1500,500,1000,1000,1000,0,9673,10592,12886,12663,13440,14150,0.19346,0.21184,0.25772,0.25326,0.2688,0.283,0
4086,100000,0,2,2,25,0,0,-1,-1,-1,-1,49199,48285,390,390,390,390,1000,390,390,390,390,390,0,48199,47895,0,0,0,0,0.48199,0.47895,0.0,0.0,0.0,0.0,-4
4087,150000,1,1,2,33,-1,0,0,-2,-2,-2,10544,11982,-18,-18,-18,-18,2000,0,0,0,0,0,0,8544,11982,-18,-18,-18,-18,0.05696,0.07988,-0.00012,-0.00012,-0.00012,-0.00012,-7
4088,400000,1,1,2,39,0,0,0,0,0,0,404924,359634,360270,325340,328627,329948,13521,12374,11643,11868,18000,15000,0,391403,347260,348627,313472,310627,314948,0.9785075,0.86815,0.8715675,0.78368,0.7765675,0.78737,0
4089,70000,1,2,1,44,0,0,0,0,0,0,68687,69531,71271,70712,50793,50605,2545,2918,6329,1996,1977,1975,1,66142,66613,64942,68716,48816,48630,0.9448857142857143,0.9516142857142857,0.9277428571428571,0.9816571428571429,0.6973714285714285,0.6947142857142857,0
4090,50000,1,3,1,53,1,-2,-2,-2,-2,-2,0,0,0,0,0,0,0,0,0,0,0,0,1,0,0,0,0,0,0,0.0,0.0,0.0,0.0,0.0,0.0,-9
4091,360000,1,1,2,29,-1,-1,-1,-2,-2,-2,1146,2500,0,0,0,0,2500,0,0,0,0,0,0,-1354,2500,0,0,0,0,-0.003761111111111111,0.006944444444444444,0.0,0.0,0.0,0.0,-9
4092,490000,1,1,1,36,-2,-2,-2,-2,-2,-2,1886,9444,3180,7715,6507,3424,9480,3182,7779,6517,3434,5132,1,-7594,6262,-4599,1198,3073,-1708,-0.01549795918367347,0.012779591836734694,-0.009385714285714285,0.0024448979591836736,0.006271428571428571,-0.0034857142857142856,-12
4093,360000,1,3,2,39,1,-2,-2,-2,-2,-2,0,0,0,0,0,0,0,0,0,0,0,0,0,0,0,0,0,0,0,0.0,0.0,0.0,0.0,0.0,0.0,-9
4094,500000,1,1,2,50,-2,-2,-2,-2,-2,-2,0,0,0,0,0,706,0,0,0,0,706,18115,0,0,0,0,0,-706,-17409,0.0,0.0,0.0,0.0,-0.001412,-0.034818,-12
4095,160000,0,2,2,38,4,3,2,2,3,2,99340,96860,99911,103928,101540,99587,0,5500,6700,0,27,2800,0,99340,91360,93211,103928,101513,96787,0.620875,0.571,0.58256875,0.64955,0.63445625,0.60491875,16
4096,170000,0,2,1,59,2,2,2,2,2,2,44619,45386,46365,47304,47727,49315,1800,2000,2000,1500,2500,0,1,42819,43386,44365,45804,45227,49315,0.2518764705882353,0.25521176470588236,0.2609705882352941,0.26943529411764705,0.2660411764705882,0.29008823529411765,12
4097,50000,1,2,1,49,-1,-1,0,0,-1,-1,3126,25362,23683,22833,1352,20791,25368,1237,457,1354,20794,540,1,-22242,24125,23226,21479,-19442,20251,-0.44484,0.4825,0.46452,0.42958,-0.38884,0.40502,-4
4098,360000,0,3,1,44,-1,-1,-1,-1,-1,-1,1982,-18,3746,-4,906,850,0,3764,0,910,854,1131,1,1982,-3782,3746,-914,52,-281,0.005505555555555555,-0.010505555555555556,0.010405555555555555,-0.0025388888888888887,0.00014444444444444444,-0.0007805555555555556,-6
4099,180000,0,2,1,57,0,0,0,0,0,0,182329,177183,177694,127051,128562,129128,9000,7000,5000,5000,10000,5000,1,173329,170183,172694,122051,118562,124128,0.9629388888888889,0.9454611111111111,0.9594111111111111,0.6780611111111111,0.6586777777777778,0.6896,0
4100,270000,1,1,2,27,0,0,0,0,0,0,196192,200750,204418,197854,173743,149095,9000,9500,8929,7265,5400,5300,0,187192,191250,195489,190589,168343,143795,0.6933037037037038,0.7083333333333334,0.7240333333333333,0.7058851851851852,0.6234925925925926,0.5325740740740741,0
4101,90000,0,2,1,41,0,0,-1,0,0,0,3014,-1750,76674,77974,80064,81747,1757,79786,2836,3657,2972,6228,1,1257,-81536,73838,74317,77092,75519,0.013966666666666667,-0.9059555555555555,0.8204222222222223,0.8257444444444444,0.8565777777777778,0.8391,-1
4102,100000,0,1,2,26,0,0,0,0,0,0,7136,8515,9749,14188,16602,19575,1500,1500,4500,5000,5000,5000,0,5636,7015,5249,9188,11602,14575,0.05636,0.07015,0.05249,0.09188,0.11602,0.14575,0
4103,50000,1,2,2,23,2,0,0,0,0,0,48537,30271,26283,26547,27119,27697,2000,2000,1000,1000,1028,1000,0,46537,28271,25283,25547,26091,26697,0.93074,0.56542,0.50566,0.51094,0.52182,0.53394,2
4104,70000,0,3,1,39,0,0,0,0,0,0,58665,55845,55362,39615,40477,43295,6852,2010,1500,1500,3500,2000,1,51813,53835,53862,38115,36977,41295,0.7401857142857143,0.7690714285714285,0.7694571428571428,0.5445,0.5282428571428571,0.5899285714285715,0
4105,270000,0,1,2,29,-1,-1,-1,-2,-1,-1,38840,197,-61,-61,20207,538,197,0,0,20268,538,29995,0,38643,197,-61,-20329,19669,-29457,0.14312222222222223,0.0007296296296296297,-0.00022592592592592591,-0.07529259259259259,0.07284814814814815,-0.1091,-7
4106,40000,1,1,2,30,0,0,0,2,0,0,18927,21295,25921,25209,26636,29197,3000,5000,0,2000,3000,0,0,15927,16295,25921,23209,23636,29197,0.398175,0.407375,0.648025,0.580225,0.5909,0.729925,2
4107,30000,0,1,2,49,0,0,0,2,0,0,25144,25831,29122,28277,20390,20555,1500,4500,0,900,1000,2000,0,23644,21331,29122,27377,19390,18555,0.7881333333333334,0.7110333333333333,0.9707333333333333,0.9125666666666666,0.6463333333333333,0.6185,2
4108,210000,1,3,2,56,0,-1,-1,-1,-1,0,27316,15316,15316,15623,11090,15316,15316,15316,15623,11090,10000,76826,0,12000,0,-307,4533,1090,-61510,0.05714285714285714,0.0,-0.001461904761904762,0.021585714285714284,0.005190476190476191,-0.2929047619047619,-4
4109,50000,0,2,2,29,2,2,2,2,2,2,39634,40697,41526,42045,42822,43962,2000,1800,1500,1600,2000,1700,0,37634,38897,40026,40445,40822,42262,0.75268,0.77794,0.80052,0.8089,0.81644,0.84524,12
4110,80000,1,2,2,24,-1,-1,-1,-1,-1,-1,386,1392,18634,5433,2053,5781,1396,18754,5449,2059,5798,3098,0,-1010,-17362,13185,3374,-3745,2683,-0.012625,-0.217025,0.1648125,0.042175,-0.0468125,0.0335375,-6
4111,50000,0,2,2,29,2,2,2,2,2,0,35488,36606,37526,38214,37302,38546,2000,1800,1600,0,2000,1600,0,33488,34806,35926,38214,35302,36946,0.66976,0.69612,0.71852,0.76428,0.70604,0.73892,10
4112,30000,1,2,1,29,2,2,0,0,0,0,26414,27189,28235,28669,29355,29913,1500,1800,1200,1300,1200,600,1,24914,25389,27035,27369,28155,29313,0.8304666666666667,0.8463,0.9011666666666667,0.9123,0.9385,0.9771,4
4113,340000,1,1,2,27,-1,-1,-1,-1,0,-1,7453,2928,1564,7726,4536,4961,2942,1586,7742,1300,4985,5956,0,4511,1342,-6178,6426,-449,-995,0.01326764705882353,0.003947058823529412,-0.01817058823529412,0.0189,-0.0013205882352941177,-0.0029264705882352943,-5
4114,30000,0,2,2,47,0,0,0,0,0,0,29596,29625,29523,29494,29464,29891,1600,1500,1500,1500,2000,2301,0,27996,28125,28023,27994,27464,27590,0.9332,0.9375,0.9341,0.9331333333333334,0.9154666666666667,0.9196666666666666,0
4115,30000,0,3,3,54,0,0,0,0,0,0,22987,22298,22352,23221,24339,25943,2500,2000,1500,4000,2000,0,0,20487,20298,20852,19221,22339,25943,0.6829,0.6766,0.6950666666666667,0.6407,0.7446333333333334,0.8647666666666667,0
4116,30000,0,2,1,48,0,0,0,0,0,0,46780,38099,38600,29400,30000,0,1899,1400,1188,600,0,0,1,44881,36699,37412,28800,30000,0,1.4960333333333333,1.2233,1.2470666666666668,0.96,1.0,0.0,0
4117,60000,0,3,2,31,2,2,2,0,0,0,30841,34336,33489,35615,38027,39239,4000,0,3000,3000,2000,3000,0,26841,34336,30489,32615,36027,36239,0.44735,0.5722666666666667,0.50815,0.5435833333333333,0.60045,0.6039833333333333,6
4118,90000,1,2,2,39,-1,0,0,-2,-1,0,2618,8489,371,385,13273,20971,7639,11336,1501,13278,10022,14045,0,-5021,-2847,-1130,-12893,3251,6926,-0.05578888888888889,-0.03163333333333333,-0.012555555555555556,-0.14325555555555555,0.03612222222222222,0.07695555555555555,-4
4119,490000,0,2,2,42,0,0,0,0,0,0,455520,464727,477884,488808,427064,436172,16100,20000,19000,16000,16000,15000,0,439420,444727,458884,472808,411064,421172,0.8967755102040816,0.9076061224489796,0.9364979591836735,0.9649142857142857,0.8389061224489796,0.859534693877551,0
4120,200000,1,1,2,38,-1,-1,-2,-2,-1,-1,399,0,0,0,218,270,0,0,0,218,270,317,0,399,0,0,-218,-52,-47,0.001995,0.0,0.0,-0.00109,-0.00026,-0.000235,-8
4121,150000,0,2,1,45,0,0,0,0,0,2,64869,57318,35970,26727,71112,63889,3049,2049,0,63889,0,4000,1,61820,55269,35970,-37162,71112,59889,0.41213333333333335,0.36846,0.2398,-0.24774666666666667,0.47408,0.39926,2
4122,130000,1,2,1,45,0,0,0,0,0,2,128671,129901,127658,127362,128726,129081,7000,4710,4500,9400,3600,5500,1,121671,125191,123158,117962,125126,123581,0.9359307692307692,0.9630076923076923,0.9473692307692307,0.9074,0.9625076923076923,0.9506230769230769,2
4123,490000,1,2,1,38,-2,-2,-2,-2,-2,-2,0,0,0,0,163,1256,0,0,0,163,1256,1000,1,0,0,0,-163,-1093,256,0.0,0.0,0.0,-0.0003326530612244898,-0.002230612244897959,0.0005224489795918367,-12
4124,10000,1,3,1,52,-1,2,2,2,2,2,2465,3475,4366,4148,4579,4360,1200,1100,0,500,0,500,1,1265,2375,4366,3648,4579,3860,0.1265,0.2375,0.4366,0.3648,0.4579,0.386,9
4125,90000,0,4,2,34,0,0,0,0,0,0,101023,97045,102372,100794,98277,96735,3580,13000,7000,6000,7000,8200,0,97443,84045,95372,94794,91277,88535,1.0827,0.9338333333333333,1.059688888888889,1.0532666666666666,1.0141888888888888,0.9837222222222223,0
4126,50000,1,3,2,36,0,0,0,0,0,0,48831,46763,44302,42942,20103,20163,2002,4228,1603,900,700,810,0,46829,42535,42699,42042,19403,19353,0.93658,0.8507,0.85398,0.84084,0.38806,0.38706,0
4127,50000,0,3,1,48,0,0,0,0,0,0,10420,8451,9641,9468,9294,9263,1310,1500,500,500,500,200,1,9110,6951,9141,8968,8794,9063,0.1822,0.13902,0.18282,0.17936,0.17588,0.18126,0
4128,210000,1,2,1,30,-1,-1,-2,-2,-2,-2,2818,0,0,0,0,0,0,0,0,0,0,0,1,2818,0,0,0,0,0,0.013419047619047619,0.0,0.0,0.0,0.0,0.0,-10
4129,60000,0,2,1,45,0,0,0,0,0,0,20959,20822,17973,18403,17898,17388,1500,1500,2000,1000,1000,1000,1,19459,19322,15973,17403,16898,16388,0.32431666666666664,0.32203333333333334,0.26621666666666666,0.29005,0.28163333333333335,0.27313333333333334,0
4130,200000,1,3,1,52,1,2,2,0,0,0,203385,192055,164665,155614,145920,104728,5891,0,6100,5792,4240,2900,1,197494,192055,158565,149822,141680,101828,0.98747,0.960275,0.792825,0.74911,0.7084,0.50914,5
4131,200000,0,1,2,28,-1,-1,-1,-1,-1,-1,508,10680,1190,527,4524,5522,10712,1194,527,4537,5538,3883,0,-10204,9486,663,-4010,-1014,1639,-0.05102,0.04743,0.003315,-0.02005,-0.00507,0.008195,-6
4132,130000,1,2,2,29,0,0,0,2,0,0,86584,88345,94597,92077,93272,96298,4100,8600,0,3500,7100,3600,0,82484,79745,94597,88577,86172,92698,0.6344923076923077,0.613423076923077,0.7276692307692307,0.6813615384615385,0.6628615384615385,0.7130615384615384,2
4133,180000,1,1,2,44,-2,-2,-2,-2,-2,-2,16891,0,521,0,0,0,0,521,0,0,0,10622,0,16891,-521,521,0,0,-10622,0.09383888888888889,-0.0028944444444444443,0.0028944444444444443,0.0,0.0,-0.05901111111111111,-12
4134,10000,0,2,2,35,0,0,0,0,0,0,8857,8661,9055,9665,9297,5555,2300,1000,1000,1000,2000,3094,0,6557,7661,8055,8665,7297,2461,0.6557,0.7661,0.8055,0.8665,0.7297,0.2461,0
4135,240000,1,2,1,48,-1,-1,-2,-2,-2,-2,101,0,0,0,0,0,0,0,0,0,0,0,1,101,0,0,0,0,0,0.00042083333333333333,0.0,0.0,0.0,0.0,0.0,-10
4136,320000,1,2,2,36,-2,-2,-2,-2,-2,-2,29862,33785,4900,15813,0,0,5000,4905,15873,0,0,21657,0,24862,28880,-10973,15813,0,-21657,0.07769375,0.09025,-0.034290625,0.049415625,0.0,-0.067678125,-12
4137,500000,0,3,1,43,0,0,0,0,0,0,57313,54997,44226,40712,37311,27068,4060,5014,5005,4000,5000,0,1,53253,49983,39221,36712,32311,27068,0.106506,0.099966,0.078442,0.073424,0.064622,0.054136,0
4138,180000,0,1,2,28,1,-2,-2,-2,-1,-1,0,0,0,0,383,2388,0,0,0,773,2395,847,0,0,0,0,-773,-2012,1541,0.0,0.0,0.0,-0.0042944444444444445,-0.011177777777777778,0.008561111111111111,-7
4139,90000,1,2,1,31,2,2,0,0,0,0,90089,91196,89779,89214,88847,88724,3500,4400,5013,4000,4000,4000,1,86589,86796,84766,85214,84847,84724,0.9621,0.9644,0.9418444444444445,0.9468222222222222,0.9427444444444445,0.9413777777777778,4
4140,200000,1,2,2,37,1,-1,-1,-2,-2,-2,-1,297,-2,-2,-2,-2,298,0,0,0,0,544,0,-299,297,-2,-2,-2,-546,-0.001495,0.001485,-1e-05,-1e-05,-1e-05,-0.00273,-7
4141,20000,1,2,1,32,0,0,0,-2,-2,-2,16434,17191,0,0,0,0,1500,0,0,0,0,8000,1,14934,17191,0,0,0,-8000,0.7467,0.85955,0.0,0.0,0.0,-0.4,-6
4142,50000,1,2,2,24,1,2,0,0,0,0,49469,42983,40307,17575,14691,14393,0,2199,1000,5000,2000,5000,0,49469,40784,39307,12575,12691,9393,0.98938,0.81568,0.78614,0.2515,0.25382,0.18786,3
4143,230000,1,1,2,29,0,0,-1,-1,0,0,23586,6633,2525,146959,150080,153186,5576,2525,146959,4452,4586,5497,0,18010,4108,-144434,142507,145494,147689,0.07830434782608696,0.01786086956521739,-0.6279739130434783,0.619595652173913,0.6325826086956522,0.6421260869565217,-2
4144,20000,0,2,2,24,0,0,0,0,-2,-2,15940,19222,20650,0,0,0,3572,2000,0,0,0,0,0,12368,17222,20650,0,0,0,0.6184,0.8611,1.0325,0.0,0.0,0.0,-4
4145,90000,1,2,2,39,0,0,0,0,0,0,45709,45045,42151,37842,30849,28061,2000,2000,1200,1018,1200,710,0,43709,43045,40951,36824,29649,27351,0.48565555555555556,0.4782777777777778,0.4550111111111111,0.40915555555555555,0.32943333333333336,0.3039,0
4146,160000,0,2,2,28,-1,2,2,-2,-1,-1,530,530,-102,-418,-418,1647,0,102,316,123,2847,2,0,530,428,-418,-541,-3265,1645,0.0033125,0.002675,-0.0026125,-0.00338125,-0.02040625,0.01028125,-1
4147,50000,0,3,1,51,-1,-1,-1,-1,-1,0,17453,7802,22214,4985,6551,7117,8338,22232,4985,6551,5000,5000,1,9115,-14430,17229,-1566,1551,2117,0.1823,-0.2886,0.34458,-0.03132,0.03102,0.04234,-5
4148,200000,0,2,1,36,1,-2,-2,-2,-1,-1,0,0,0,0,1680,0,0,0,0,1680,0,0,1,0,0,0,-1680,1680,0,0.0,0.0,0.0,-0.0084,0.0084,0.0,-7
4149,90000,0,2,2,25,0,0,0,0,0,0,79938,67857,66929,67797,47739,48163,3000,3000,3000,3000,2000,2000,0,76938,64857,63929,64797,45739,46163,0.8548666666666667,0.7206333333333333,0.7103222222222222,0.7199666666666666,0.5082111111111111,0.5129222222222222,0
4150,300000,1,3,1,34,-2,-2,-2,-2,-2,-2,-75,29014,21180,-20,-20,4045,29089,21286,0,0,4065,0,1,-29164,7728,21180,-20,-4085,4045,-0.09721333333333333,0.02576,0.0706,-6.666666666666667e-05,-0.013616666666666666,0.013483333333333333,-12
4151,50000,1,2,2,26,0,0,0,0,0,0,29356,30483,31180,18401,18785,19248,1603,1300,658,680,773,524,0,27753,29183,30522,17721,18012,18724,0.55506,0.58366,0.61044,0.35442,0.36024,0.37448,0
4152,10000,0,2,1,50,2,2,2,0,0,0,9415,8852,8297,8792,9277,9744,1000,1000,1000,1000,1000,1000,1,8415,7852,7297,7792,8277,8744,0.8415,0.7852,0.7297,0.7792,0.8277,0.8744,6
4153,20000,1,2,2,24,0,0,0,0,0,0,13542,14852,15571,16584,17067,34262,1543,1262,1275,758,638,1340,0,11999,13590,14296,15826,16429,32922,0.59995,0.6795,0.7148,0.7913,0.82145,1.6461,0
4154,50000,1,2,1,32,0,0,0,0,0,0,48508,49213,38280,12305,6436,0,3037,1800,1130,2000,0,0,1,45471,47413,37150,10305,6436,0,0.90942,0.94826,0.743,0.2061,0.12872,0.0,0
4155,90000,1,3,1,47,2,2,2,0,0,0,92454,94156,91710,79884,49810,51012,4100,0,3424,1790,2012,1814,1,88354,94156,88286,78094,47798,49198,0.9817111111111111,1.0461777777777779,0.9809555555555556,0.8677111111111111,0.5310888888888889,0.5466444444444445,6
4156,50000,0,3,1,41,2,2,2,0,0,0,31303,35716,30087,29610,40736,25690,5700,0,1000,12000,2000,900,1,25603,35716,29087,17610,38736,24790,0.51206,0.71432,0.58174,0.3522,0.77472,0.4958,6
4157,440000,1,4,1,64,0,0,0,0,0,0,133996,136606,136771,141131,147251,150332,6319,5000,6625,10000,5443,5501,1,127677,131606,130146,131131,141808,144831,0.290175,0.29910454545454546,0.2957863636363636,0.298025,0.3222909090909091,0.3291613636363636,0
4158,20000,0,3,2,24,1,2,0,0,0,0,20464,19322,19004,19558,19176,19441,4,1640,1589,1000,1001,1004,0,20460,17682,17415,18558,18175,18437,1.023,0.8841,0.87075,0.9279,0.90875,0.92185,3
4159,180000,1,1,2,28,0,0,0,0,0,-1,12595,18704,24410,29184,7325,326,7000,7000,7000,5000,326,7276,0,5595,11704,17410,24184,6999,-6950,0.031083333333333334,0.06502222222222222,0.09672222222222222,0.13435555555555556,0.03888333333333333,-0.03861111111111111,-1
4160,20000,0,2,2,28,2,2,0,0,0,0,17429,16849,17187,8585,8760,12000,0,1202,1000,175,3240,0,0,17429,15647,16187,8410,5520,12000,0.87145,0.78235,0.80935,0.4205,0.276,0.6,4
4161,190000,1,2,2,34,0,0,0,0,0,0,90945,77668,79321,80401,80872,77377,3500,3500,3000,3083,3000,3000,0,87445,74168,76321,77318,77872,74377,0.46023684210526317,0.3903578947368421,0.40168947368421054,0.40693684210526315,0.40985263157894736,0.3914578947368421,0
4162,170000,1,3,2,47,-1,-1,-1,-1,-1,-1,16089,5454,8846,920,380,4765,5455,8866,921,381,4801,1632,0,10634,-3412,7925,539,-4421,3133,0.06255294117647059,-0.020070588235294118,0.04661764705882353,0.0031705882352941177,-0.026005882352941177,0.01842941176470588,-6
4163,400000,0,1,2,36,-2,-2,-2,-2,-2,-2,0,0,0,0,0,0,0,0,0,0,0,0,0,0,0,0,0,0,0,0.0,0.0,0.0,0.0,0.0,0.0,-12
4164,50000,0,2,2,47,0,0,0,0,0,0,37486,35996,36679,16707,17057,17423,1800,2021,650,619,650,1000,0,35686,33975,36029,16088,16407,16423,0.71372,0.6795,0.72058,0.32176,0.32814,0.32846,0
4165,360000,1,1,2,30,-2,-2,-2,-2,-2,-2,0,0,0,0,0,0,0,0,0,0,0,0,0,0,0,0,0,0,0,0.0,0.0,0.0,0.0,0.0,0.0,-12
4166,10000,1,1,1,39,1,-2,-1,2,0,0,0,0,9996,9689,9747,10328,0,9996,0,363,752,0,1,0,-9996,9996,9326,8995,10328,0.0,-0.9996,0.9996,0.9326,0.8995,1.0328,0
4167,20000,0,2,2,24,-1,-1,-1,-2,-2,-2,2500,3068,-380,-380,-380,-380,3068,0,0,0,0,0,0,-568,3068,-380,-380,-380,-380,-0.0284,0.1534,-0.019,-0.019,-0.019,-0.019,-9
4168,250000,1,1,1,30,-1,-1,-1,2,-1,-1,1923,-574,2533,1607,56694,58091,900,4500,0,57000,5000,0,1,1023,-5074,2533,-55393,51694,58091,0.004092,-0.020296,0.010132,-0.221572,0.206776,0.232364,-3
4169,110000,1,1,2,29,-2,-2,-2,-2,-2,-2,7397,-18,-18,-18,-18,-18,2000,0,0,0,0,0,0,5397,-18,-18,-18,-18,-18,0.049063636363636365,-0.00016363636363636363,-0.00016363636363636363,-0.00016363636363636363,-0.00016363636363636363,-0.00016363636363636363,-12
4170,80000,1,2,2,29,0,0,0,0,0,0,46724,35074,32812,25930,26414,27128,2000,2000,1100,1000,1100,1000,0,44724,33074,31712,24930,25314,26128,0.55905,0.413425,0.3964,0.311625,0.316425,0.3266,0
4171,190000,1,2,2,44,0,0,0,0,0,0,137394,140899,144636,148173,151853,155031,5774,5987,5948,6000,5481,5500,0,131620,134912,138688,142173,146372,149531,0.6927368421052632,0.7100631578947368,0.7299368421052631,0.748278947368421,0.770378947368421,0.7870052631578948,0
4172,110000,1,2,2,24,-1,0,0,0,0,0,90929,92303,92114,70057,28492,107453,3550,3200,2500,1600,80000,4000,0,87379,89103,89614,68457,-51508,103453,0.7943545454545454,0.8100272727272727,0.8146727272727273,0.6223363636363637,-0.4682545454545455,0.9404818181818182,-1
4173,210000,1,2,2,24,-2,-2,-2,-1,-1,-1,973,4197,1772,7293,1508,2498,4224,2631,8132,1563,2506,2135,0,-3251,1566,-6360,5730,-998,363,-0.015480952380952382,0.0074571428571428575,-0.030285714285714287,0.027285714285714285,-0.004752380952380952,0.0017285714285714285,-9
4174,100000,0,3,2,49,-1,-1,-2,-2,-2,-2,1440,0,0,0,0,0,0,0,0,0,0,0,0,1440,0,0,0,0,0,0.0144,0.0,0.0,0.0,0.0,0.0,-10
4175,50000,0,3,1,55,2,0,0,0,0,0,42166,43687,44121,43360,40555,31309,2200,1632,1113,1336,3142,2126,1,39966,42055,43008,42024,37413,29183,0.79932,0.8411,0.86016,0.84048,0.74826,0.58366,2
4176,200000,0,2,1,49,-1,0,-1,0,-1,-1,8143,39869,38685,22125,17778,24354,39100,38759,102,17868,25125,35031,1,-30957,1110,38583,4257,-7347,-10677,-0.154785,0.00555,0.192915,0.021285,-0.036735,-0.053385,-4
4177,300000,0,1,1,38,-1,0,0,0,0,0,105932,100815,103744,103422,111152,110811,5137,30022,5006,10014,4016,4013,1,100795,70793,98738,93408,107136,106798,0.33598333333333336,0.23597666666666667,0.3291266666666667,0.31136,0.35712,0.35599333333333333,-1
4178,50000,0,2,2,37,0,0,0,0,0,0,44756,45746,47010,47277,17410,17002,1736,2000,1267,1000,620,1000,0,43020,43746,45743,46277,16790,16002,0.8604,0.87492,0.91486,0.92554,0.3358,0.32004,0
4179,210000,1,1,1,44,-1,-1,-1,-1,-1,0,360,360,1234,722,1326,360,360,1234,722,1326,0,2388,1,0,-874,512,-604,1326,-2028,0.0,-0.004161904761904762,0.002438095238095238,-0.002876190476190476,0.006314285714285714,-0.009657142857142857,-5
4180,230000,1,3,1,47,0,0,0,0,0,0,182787,173108,163937,90980,91180,90260,7000,5665,4154,3300,3418,3600,1,175787,167443,159783,87680,87762,86660,0.7642913043478261,0.7280130434782609,0.6947086956521739,0.38121739130434784,0.38157391304347826,0.37678260869565217,0
4181,500000,0,1,1,40,0,0,-2,-2,-2,-2,18110,0,0,0,0,0,0,0,0,0,0,0,1,18110,0,0,0,0,0,0.03622,0.0,0.0,0.0,0.0,0.0,-8
4182,160000,1,2,2,39,-1,-1,-1,-1,-1,-1,2828,1473,8404,8875,8509,4630,1473,8404,8875,8509,4630,2038,0,1355,-6931,-471,366,3879,2592,0.00846875,-0.04331875,-0.00294375,0.0022875,0.02424375,0.0162,-6
4183,50000,1,3,3,46,-2,-1,0,0,0,0,-1494,2590,3506,19792,19422,19830,7084,1000,19286,664,689,761,0,-8578,1590,-15780,19128,18733,19069,-0.17156,0.0318,-0.3156,0.38256,0.37466,0.38138,-3
4184,180000,1,1,1,43,-1,-1,-1,0,-1,-1,36484,24049,89271,1946,11859,506,24049,91272,162,11859,506,1304,1,12435,-67223,89109,-9913,11353,-798,0.06908333333333333,-0.37346111111111113,0.49505,-0.055072222222222224,0.06307222222222222,-0.004433333333333333,-5
4185,30000,1,2,3,54,0,0,0,0,0,0,26302,26873,28138,27074,13275,12500,2000,1719,1613,271,2250,0,0,24302,25154,26525,26803,11025,12500,0.8100666666666667,0.8384666666666667,0.8841666666666667,0.8934333333333333,0.3675,0.4166666666666667,0
4186,80000,0,2,2,24,2,2,-2,-1,0,0,1430,0,0,872,22872,20641,0,0,872,22000,2002,2001,0,1430,0,-872,-21128,20870,18640,0.017875,0.0,-0.0109,-0.2641,0.260875,0.233,1
4187,120000,1,2,2,54,0,0,0,0,0,0,20157,19295,13531,10129,11581,12782,2000,1500,1500,2000,1782,2000,0,18157,17795,12031,8129,9799,10782,0.15130833333333332,0.14829166666666665,0.10025833333333334,0.06774166666666667,0.08165833333333333,0.08985,0
4188,390000,0,1,1,36,-2,-2,-2,-2,-2,-2,8040,7818,8051,-5,1965,3088,7857,8091,0,990,3108,8486,1,183,-273,8051,-995,-1143,-5398,0.00046923076923076926,-0.0007,0.020643589743589742,-0.0025512820512820513,-0.0029307692307692307,-0.01384102564102564,-12
4189,30000,0,1,2,24,0,0,0,0,0,0,27576,27089,27986,28580,28649,29147,1500,1500,1050,1100,1000,2000,0,26076,25589,26936,27480,27649,27147,0.8692,0.8529666666666667,0.8978666666666667,0.916,0.9216333333333333,0.9049,0
4190,200000,1,1,2,30,0,0,0,0,0,0,78866,74961,69702,63210,57098,46455,20000,2513,1656,5000,20000,15000,0,58866,72448,68046,58210,37098,31455,0.29433,0.36224,0.34023,0.29105,0.18549,0.157275,0
4191,30000,0,2,2,44,2,2,0,0,0,0,44072,39489,36794,33991,30820,29323,0,1820,1600,1012,2586,2656,0,44072,37669,35194,32979,28234,26667,1.4690666666666667,1.2556333333333334,1.1731333333333334,1.0993,0.9411333333333334,0.8889,4
4192,200000,0,2,2,26,1,2,2,2,2,2,58050,2500,2500,2500,2500,2500,0,0,0,0,0,0,0,58050,2500,2500,2500,2500,2500,0.29025,0.0125,0.0125,0.0125,0.0125,0.0125,11
4193,20000,1,3,1,43,1,-2,-2,-2,-2,-2,0,0,0,0,0,0,0,0,0,0,0,0,1,0,0,0,0,0,0,0.0,0.0,0.0,0.0,0.0,0.0,-9
4194,90000,1,2,2,23,0,0,0,0,0,0,13107,13740,14770,13306,10465,9704,1251,1281,1173,500,1000,1000,0,11856,12459,13597,12806,9465,8704,0.13173333333333334,0.13843333333333332,0.15107777777777778,0.14228888888888888,0.10516666666666667,0.09671111111111111,0
4195,470000,0,1,1,33,-1,-1,-1,-1,0,0,1260,2516,181,3011,2891,3502,2530,181,3020,1804,1517,1958,1,-1270,2335,-2839,1207,1374,1544,-0.002702127659574468,0.0049680851063829785,-0.0060404255319148935,0.0025680851063829787,0.0029234042553191487,0.0032851063829787233,-4
4196,20000,0,2,2,23,1,2,0,0,0,-2,9352,9059,9823,10023,0,0,0,1000,200,0,0,0,0,9352,8059,9623,10023,0,0,0.4676,0.40295,0.48115,0.50115,0.0,0.0,1
4197,210000,1,1,2,33,-1,2,2,-1,-1,-1,970,2273,1303,5385,1814,0,1303,3,5387,1814,0,0,0,-333,2270,-4084,3571,1814,0,-0.0015857142857142858,0.010809523809523809,-0.019447619047619047,0.017004761904761904,0.008638095238095238,0.0,0
4198,150000,0,3,2,29,1,3,2,2,2,2,54803,52996,51169,53979,52639,58508,0,0,4000,0,7127,0,0,54803,52996,47169,53979,45512,58508,0.3653533333333333,0.35330666666666666,0.31446,0.35986,0.3034133333333333,0.3900533333333333,12
4199,80000,1,2,2,44,0,0,0,0,-1,-1,22771,17047,11885,8254,5144,15365,1239,1435,1350,5144,15365,2250,0,21532,15612,10535,3110,-10221,13115,0.26915,0.19515,0.1316875,0.038875,-0.1277625,0.1639375,-2
4200,200000,0,1,2,27,0,0,-1,-1,-1,-1,58725,76287,22869,30268,54466,37127,30229,22946,30684,54589,37208,55031,0,28496,53341,-7815,-24321,17258,-17904,0.14248,0.266705,-0.039075,-0.121605,0.08629,-0.08952,-4
4201,230000,1,1,2,28,-1,-1,-1,-2,-2,-2,6666,6666,0,0,0,0,6666,0,0,0,0,0,0,0,6666,0,0,0,0,0.0,0.028982608695652175,0.0,0.0,0.0,0.0,-9
4202,70000,1,3,1,33,0,0,0,0,0,0,71230,65305,50178,29969,30081,29380,2500,3108,2000,1048,1095,940,1,68730,62197,48178,28921,28986,28440,0.9818571428571429,0.8885285714285714,0.6882571428571429,0.41315714285714283,0.4140857142857143,0.4062857142857143,0
4203,450000,1,1,2,31,2,-1,0,0,0,0,1638,54490,112841,112603,90202,39564,54490,62841,2000,0,1000,27224,0,-52852,-8351,110841,112603,89202,12340,-0.1174488888888889,-0.018557777777777777,0.24631333333333333,0.2502288888888889,0.19822666666666666,0.027422222222222223,1
4204,240000,0,1,2,35,-1,-1,-1,-1,-1,-1,11906,54684,1874,1151,23169,9372,55167,1874,1151,23169,9372,396,0,-43261,52810,723,-22018,13797,8976,-0.18025416666666666,0.22004166666666666,0.0030125,-0.09174166666666667,0.0574875,0.0374,-6
4205,150000,1,2,1,37,-2,-2,-2,-2,-2,-2,0,0,0,283,0,0,0,0,283,0,0,0,1,0,0,-283,283,0,0,0.0,0.0,-0.0018866666666666667,0.0018866666666666667,0.0,0.0,-12
4206,130000,0,2,1,33,-1,-1,-1,-1,-1,-1,99,99,99,99,99,98,99,99,99,99,98,894,1,0,0,0,0,1,-796,0.0,0.0,0.0,0.0,7.692307692307692e-06,-0.006123076923076923,-6
4207,50000,1,2,2,22,1,2,0,0,0,0,44980,41140,31888,28639,26737,24784,7,1580,1621,1020,2473,1079,0,44973,39560,30267,27619,24264,23705,0.89946,0.7912,0.60534,0.55238,0.48528,0.4741,3
4208,130000,1,1,2,30,3,2,2,0,0,0,8830,9533,10220,10353,10636,10711,1000,1000,600,600,400,600,0,7830,8533,9620,9753,10236,10111,0.060230769230769234,0.06563846153846153,0.074,0.07502307692307693,0.07873846153846153,0.07777692307692308,7
4209,300000,0,1,1,40,-2,-2,-2,-2,-2,-2,5649,5649,5649,5699,5466,19878,5649,5649,5699,5616,20272,0,1,0,0,-50,83,-14806,19878,0.0,0.0,-0.00016666666666666666,0.00027666666666666665,-0.04935333333333333,0.06626,-12
4210,50000,0,1,2,29,0,0,0,0,0,0,16303,47714,48916,19894,20572,21230,32000,2000,1000,1000,1000,2000,0,-15697,45714,47916,18894,19572,19230,-0.31394,0.91428,0.95832,0.37788,0.39144,0.3846,0
4211,60000,1,2,1,31,2,2,-1,0,0,0,63201,56600,54952,32094,31232,30384,1132,60994,1436,1047,1056,1053,1,62069,-4394,53516,31047,30176,29331,1.0344833333333334,-0.07323333333333333,0.8919333333333334,0.51745,0.5029333333333333,0.48885,3
4212,530000,0,1,2,30,0,0,0,0,0,0,214022,393664,235392,232640,239004,236657,20000,10000,10000,10000,9000,10500,0,194022,383664,225392,222640,230004,226157,0.3660792452830189,0.7238943396226415,0.42526792452830187,0.4200754716981132,0.43396981132075474,0.42671132075471696,0
4213,100000,1,3,1,40,0,0,0,0,0,0,97763,93834,86360,77594,78030,78506,4500,3000,3000,3000,3000,3000,1,93263,90834,83360,74594,75030,75506,0.93263,0.90834,0.8336,0.74594,0.7503,0.75506,0
4214,360000,0,1,1,34,-1,-1,-1,-1,-1,-1,997,1267,3935,2437,2797,256,1270,3946,2444,2805,258,1,1,-273,-2679,1491,-368,2539,255,-0.0007583333333333333,-0.007441666666666667,0.004141666666666667,-0.0010222222222222223,0.007052777777777778,0.0007083333333333334,-6
4215,30000,1,1,2,23,0,0,2,2,3,2,21077,23793,23130,28790,28038,27451,3383,0,6380,0,0,2300,0,17694,23793,16750,28790,28038,25151,0.5898,0.7931,0.5583333333333333,0.9596666666666667,0.9346,0.8383666666666667,9
4216,340000,1,1,2,42,0,0,0,-1,-1,-1,308023,327245,206832,1682,1352,1520,27245,9184,1682,1352,1520,1442,0,280778,318061,205150,330,-168,78,0.8258176470588235,0.9354735294117648,0.6033823529411765,0.0009705882352941176,-0.0004941176470588235,0.00022941176470588236,-3
4217,100000,1,2,1,39,-2,-2,-2,-2,-2,-2,0,0,0,7700,0,0,0,0,7700,0,0,0,1,0,0,-7700,7700,0,0,0.0,0.0,-0.077,0.077,0.0,0.0,-12
4218,30000,1,1,2,23,1,-2,-2,-2,-1,-1,4000,5645,3508,-27,13744,5906,5645,3508,27,13771,5911,3024,0,-1645,2137,3481,-13798,7833,2882,-0.05483333333333333,0.07123333333333333,0.11603333333333334,-0.45993333333333336,0.2611,0.09606666666666666,-7
4219,130000,1,1,2,25,2,2,-2,-2,-2,-2,1990,0,0,0,0,0,0,0,0,0,0,0,0,1990,0,0,0,0,0,0.015307692307692307,0.0,0.0,0.0,0.0,0.0,-4
4220,160000,1,3,1,53,0,0,0,0,0,0,123760,124218,124438,112113,96459,93449,6018,5810,4591,3524,3542,3426,1,117742,118408,119847,108589,92917,90023,0.7358875,0.74005,0.74904375,0.67868125,0.58073125,0.56264375,0
4221,390000,0,1,2,29,0,0,2,0,0,0,43062,47142,46088,47016,48332,62205,5100,0,2000,2071,15000,2300,0,37962,47142,44088,44945,33332,59905,0.09733846153846154,0.12087692307692308,0.11304615384615385,0.11524358974358974,0.08546666666666666,0.1536025641025641,2
4222,260000,1,2,1,31,-1,-1,-1,-1,-1,-1,2224,1996,1497,-3,2138,900,2007,1501,0,2141,902,197,1,217,495,1497,-2144,1236,703,0.0008346153846153846,0.0019038461538461538,0.005757692307692307,-0.008246153846153846,0.004753846153846154,0.002703846153846154,-6
4223,30000,0,3,1,59,0,0,0,0,0,0,29272,29096,22088,21624,21833,18174,1404,1268,694,866,695,838,1,27868,27828,21394,20758,21138,17336,0.9289333333333334,0.9276,0.7131333333333333,0.6919333333333333,0.7046,0.5778666666666666,0
4224,250000,0,1,1,71,0,0,0,0,0,0,177484,177946,159849,145461,141487,147705,6243,5446,4721,4385,7805,200,1,171241,172500,155128,141076,133682,147505,0.684964,0.69,0.620512,0.564304,0.534728,0.59002,0
4225,420000,0,2,1,34,0,0,0,0,0,0,226007,226465,205276,206521,209775,194883,10000,9600,6700,7000,7042,7112,1,216007,216865,198576,199521,202733,187771,0.5143023809523809,0.5163452380952381,0.4728,0.47505,0.48269761904761904,0.44707380952380954,0
4226,200000,1,1,2,40,2,2,0,0,0,2,185696,181236,185410,189069,197736,183299,0,8600,8300,13257,917,7000,0,185696,172636,177110,175812,196819,176299,0.92848,0.86318,0.88555,0.87906,0.984095,0.881495,6
4227,300000,1,2,1,37,1,-2,-2,-1,-1,-1,0,0,0,363,0,944,0,0,363,0,944,2000,1,0,0,-363,363,-944,-1056,0.0,0.0,-0.00121,0.00121,-0.0031466666666666665,-0.00352,-6
4228,190000,0,2,2,38,0,0,0,0,-1,-1,3816,4575,5029,6494,678,11928,1100,1300,2000,678,11514,0,0,2716,3275,3029,5816,-10836,11928,0.014294736842105263,0.017236842105263158,0.015942105263157896,0.030610526315789473,-0.05703157894736842,0.06277894736842106,-2
4229,180000,1,2,2,28,1,-2,-2,-2,-2,-2,0,0,0,0,0,0,0,0,0,0,0,0,0,0,0,0,0,0,0,0.0,0.0,0.0,0.0,0.0,0.0,-9
4230,50000,1,2,1,35,0,0,0,2,0,0,4555,5764,6974,5315,4645,3955,1290,1500,0,1000,1000,1500,1,3265,4264,6974,4315,3645,2455,0.0653,0.08528,0.13948,0.0863,0.0729,0.0491,2
4231,110000,1,2,1,35,-1,-1,-1,0,0,-1,1245,1245,1490,2490,1245,2675,1245,1490,2245,0,2675,0,1,0,-245,-755,2490,-1430,2675,0.0,-0.0022272727272727275,-0.006863636363636363,0.022636363636363635,-0.013,0.02431818181818182,-4
4232,50000,0,2,2,25,0,0,0,-1,-1,-2,11391,8081,16297,1000,0,0,1286,10048,1003,0,0,0,0,10105,-1967,15294,1000,0,0,0.2021,-0.03934,0.30588,0.02,0.0,0.0,-4
4233,500000,0,1,1,34,1,-1,-1,2,-1,-1,0,198,198,198,115397,120250,198,0,0,115399,6211,2054,1,-198,198,198,-115201,109186,118196,-0.000396,0.000396,0.000396,-0.230402,0.218372,0.236392,-1
4234,200000,1,1,1,46,-1,-1,-1,-1,-1,-1,10687,18021,3275,5430,6683,7790,18031,3275,5430,6871,7790,8901,1,-7344,14746,-2155,-1441,-1107,-1111,-0.03672,0.07373,-0.010775,-0.007205,-0.005535,-0.005555,-6
4235,300000,0,2,2,29,-2,-2,-2,-2,-2,-2,0,0,0,0,0,0,0,0,0,0,0,0,0,0,0,0,0,0,0,0.0,0.0,0.0,0.0,0.0,0.0,-12
4236,200000,1,1,2,26,0,0,0,0,0,0,29339,21624,22409,11671,5493,3288,2000,1770,2003,900,1800,1569,0,27339,19854,20406,10771,3693,1719,0.136695,0.09927,0.10203,0.053855,0.018465,0.008595,0
4237,30000,1,1,2,24,0,0,0,0,0,0,21540,22236,23574,24583,24915,25280,1358,1696,1705,1037,915,929,0,20182,20540,21869,23546,24000,24351,0.6727333333333333,0.6846666666666666,0.7289666666666667,0.7848666666666667,0.8,0.8117,0
4238,20000,0,2,2,22,4,3,2,0,0,2,16226,15682,15146,15856,17090,16677,0,0,1266,1500,0,1915,0,16226,15682,13880,14356,17090,14762,0.8113,0.7841,0.694,0.7178,0.8545,0.7381,11
4239,40000,0,2,1,38,3,2,0,0,2,0,38291,37380,38180,40524,39720,39860,0,1706,3050,0,1565,1278,1,38291,35674,35130,40524,38155,38582,0.957275,0.89185,0.87825,1.0131,0.953875,0.96455,7
4240,350000,1,3,1,31,0,0,0,-1,-1,-1,144718,214075,102601,99735,107130,0,100012,62635,99735,107130,0,0,1,44706,151440,2866,-7395,107130,0,0.12773142857142858,0.4326857142857143,0.008188571428571429,-0.021128571428571427,0.3060857142857143,0.0,-3
4241,300000,1,2,1,33,0,0,0,0,0,0,62951,64491,65692,64969,67771,66428,4007,5000,5000,6000,6000,6000,1,58944,59491,60692,58969,61771,60428,0.19648,0.19830333333333333,0.20230666666666666,0.19656333333333334,0.20590333333333333,0.20142666666666667,0
4242,250000,0,2,1,50,0,0,0,0,-2,-1,238215,182156,121786,-329,-494,1541,9000,5000,0,0,2200,0,1,229215,177156,121786,-329,-2694,1541,0.91686,0.708624,0.487144,-0.001316,-0.010776,0.006164,-3
4243,210000,1,4,2,29,0,0,0,0,0,0,43933,45197,46468,47394,48604,49669,2000,2000,2000,2000,2000,2000,0,41933,43197,44468,45394,46604,47669,0.19968095238095238,0.2057,0.21175238095238094,0.21616190476190475,0.22192380952380952,0.22699523809523808,0
4244,50000,1,1,2,23,0,0,-1,0,0,0,9861,6486,2636,4652,6390,8880,1000,2636,2500,2128,2880,390,0,8861,3850,136,2524,3510,8490,0.17722,0.077,0.00272,0.05048,0.0702,0.1698,-1
4245,70000,0,3,2,53,0,0,0,0,0,0,9928,11259,12262,17046,17618,18321,1497,1500,5000,1000,1000,1000,0,8431,9759,7262,16046,16618,17321,0.12044285714285714,0.1394142857142857,0.10374285714285714,0.22922857142857142,0.2374,0.24744285714285713,0
4246,220000,0,2,1,49,-1,-1,-1,0,0,0,540,1148,20752,19397,19581,25071,1158,20752,1051,7120,14928,1177,1,-618,-19604,19701,12277,4653,23894,-0.002809090909090909,-0.08910909090909092,0.08955,0.055804545454545454,0.02115,0.1086090909090909,-3
4247,50000,0,2,1,36,0,0,0,0,0,0,43900,42499,17494,18178,18541,18929,2268,1604,1288,651,674,734,1,41632,40895,16206,17527,17867,18195,0.83264,0.8179,0.32412,0.35054,0.35734,0.3639,0
4248,280000,1,1,2,35,0,0,0,0,0,0,92095,173354,193994,195250,204850,86279,83959,28869,13000,10000,5279,6160,0,8136,144485,180994,185250,199571,80119,0.029057142857142858,0.5160178571428572,0.6464071428571428,0.6616071428571428,0.7127535714285714,0.2861392857142857,0
4249,200000,1,2,2,35,0,0,0,-1,-1,-1,6512,4312,0,2412,1396,0,2000,0,2412,1396,0,396,0,4512,4312,-2412,1016,1396,-396,0.02256,0.02156,-0.01206,0.00508,0.00698,-0.00198,-3
4250,190000,1,1,1,36,-1,-1,-1,-1,0,0,6915,4923,-2,6381,6383,817,4923,0,6383,2,0,1809,1,1992,4923,-6385,6379,6383,-992,0.01048421052631579,0.025910526315789474,-0.033605263157894735,0.03357368421052632,0.03359473684210526,-0.0052210526315789475,-4
4251,310000,1,1,2,32,0,0,0,0,0,0,35064,38195,39233,39577,42996,46319,4000,2000,2000,4000,4000,4000,0,31064,36195,37233,35577,38996,42319,0.10020645161290323,0.11675806451612904,0.12010645161290323,0.11476451612903225,0.12579354838709678,0.13651290322580645,0
4252,20000,1,2,2,25,0,0,0,0,0,0,4120,5387,6440,7373,8246,11095,1500,1300,1200,1000,3000,406,0,2620,4087,5240,6373,5246,10689,0.131,0.20435,0.262,0.31865,0.2623,0.53445,0
4253,100000,1,1,1,27,1,2,0,0,0,0,77346,75513,77147,78200,78393,72214,0,3451,3000,2841,2620,2500,1,77346,72062,74147,75359,75773,69714,0.77346,0.72062,0.74147,0.75359,0.75773,0.69714,3
4254,30000,1,3,2,44,2,0,0,0,0,2,25039,25989,23078,23697,25257,25595,1700,1384,1003,2100,900,0,0,23339,24605,22075,21597,24357,25595,0.7779666666666667,0.8201666666666667,0.7358333333333333,0.7199,0.8119,0.8531666666666666,4
4255,20000,0,3,2,28,1,2,0,0,3,2,8055,7777,8805,12647,12173,11855,0,1158,4000,0,0,900,0,8055,6619,4805,12647,12173,10955,0.40275,0.33095,0.24025,0.63235,0.60865,0.54775,8
4256,200000,1,1,1,49,0,0,0,0,0,0,51024,27254,36052,38440,40555,49699,10000,10021,5000,6000,10000,10000,1,41024,17233,31052,32440,30555,39699,0.20512,0.086165,0.15526,0.1622,0.152775,0.198495,0
4257,120000,1,2,2,23,0,0,-1,0,-1,-1,7945,3077,700,268,632,8815,1000,1200,200,632,8815,8400,0,6945,1877,500,-364,-8183,415,0.057875,0.01564166666666667,0.004166666666666667,-0.003033333333333333,-0.06819166666666666,0.0034583333333333332,-3
4258,310000,1,1,2,32,-2,-2,-2,-2,-2,-2,20138,8267,65993,8543,1695,750,8267,66008,8543,1695,750,7350,0,11871,-57741,57450,6848,945,-6600,0.038293548387096775,-0.18626129032258065,0.1853225806451613,0.022090322580645163,0.0030483870967741938,-0.02129032258064516,-12
4259,180000,1,1,2,26,-1,-1,-2,-2,-2,-2,3000,0,0,0,0,0,0,0,0,0,0,0,0,3000,0,0,0,0,0,0.016666666666666666,0.0,0.0,0.0,0.0,0.0,-10
4260,220000,1,2,2,27,0,0,0,0,0,0,220588,218136,177720,131874,118918,110338,9000,7500,4500,5000,5000,3000,0,211588,210636,173220,126874,113918,107338,0.9617636363636364,0.9574363636363636,0.7873636363636364,0.5767,0.5178090909090909,0.4879,0
4261,310000,0,2,2,41,0,0,0,0,0,0,369398,342174,298536,168389,151755,73083,10250,9278,7000,7000,5000,188000,0,359148,332896,291536,161389,146755,-114917,1.158541935483871,1.073858064516129,0.9404387096774194,0.5206096774193548,0.4734032258064516,-0.3707,0
4262,180000,1,1,1,27,0,0,0,0,0,0,152158,155181,158437,161664,164873,168344,5539,5741,5852,5881,7607,6135,1,146619,149440,152585,155783,157266,162209,0.81455,0.8302222222222222,0.8476944444444444,0.8654611111111111,0.8737,0.9011611111111111,0
4263,200000,0,1,2,30,1,2,2,2,2,2,182499,184632,180260,192260,187714,195702,6600,0,15000,0,11013,5549,0,175899,184632,165260,192260,176701,190153,0.879495,0.92316,0.8263,0.9613,0.883505,0.950765,11
4264,130000,0,2,2,30,0,0,0,0,-1,0,70142,10724,3995,7556,125682,128453,1100,2000,5000,128000,4700,4600,0,69042,8724,-1005,-120444,120982,123853,0.5310923076923076,0.06710769230769231,-0.007730769230769231,-0.9264923076923077,0.9306307692307693,0.9527153846153846,-1
4265,80000,0,1,2,29,0,0,0,-2,-2,-2,58246,61650,0,0,0,0,5000,0,0,0,0,0,0,53246,61650,0,0,0,0,0.665575,0.770625,0.0,0.0,0.0,0.0,-6
4266,350000,0,1,1,39,-1,-1,2,0,-1,0,325,2770,2247,1930,80392,78638,2770,0,8,80408,3142,2720,1,-2445,2770,2239,-78478,77250,75918,-0.006985714285714286,0.007914285714285714,0.006397142857142857,-0.22422285714285714,0.22071428571428572,0.21690857142857142,-1
4267,20000,1,3,1,45,0,0,0,2,0,0,17235,18253,20858,20202,18950,17709,1610,3215,0,780,640,1400,1,15625,15038,20858,19422,18310,16309,0.78125,0.7519,1.0429,0.9711,0.9155,0.81545,2
4268,180000,1,1,2,29,-1,-1,-1,-1,-1,-1,10447,18006,4815,10060,49264,5983,18006,5860,11470,49613,5983,7133,0,-7559,12146,-6655,-39553,43281,-1150,-0.041994444444444445,0.06747777777777778,-0.03697222222222222,-0.2197388888888889,0.24045,-0.006388888888888889,-6
4269,60000,0,1,1,46,1,2,0,0,0,0,62063,60513,60398,31194,30343,30427,0,1744,1100,1074,1200,1000,1,62063,58769,59298,30120,29143,29427,1.0343833333333334,0.9794833333333334,0.9883,0.502,0.4857166666666667,0.49045,3
4270,20000,0,2,1,31,1,2,2,2,2,2,6313,6559,7789,8505,9212,8922,500,1500,1000,1000,0,400,1,5813,5059,6789,7505,9212,8522,0.29065,0.25295,0.33945,0.37525,0.4606,0.4261,11
4271,200000,1,2,1,37,0,0,0,-1,-1,0,97645,99894,97400,4283,145769,143712,3952,4500,4283,148192,5133,5108,1,93693,95394,93117,-143909,140636,138604,0.468465,0.47697,0.465585,-0.719545,0.70318,0.69302,-2
4272,230000,0,2,1,41,0,0,0,0,0,0,33842,35273,36693,37006,36519,31204,2000,2000,2000,2500,2000,2000,1,31842,33273,34693,34506,34519,29204,0.13844347826086956,0.14466521739130433,0.15083913043478261,0.15002608695652173,0.15008260869565218,0.12697391304347827,0
4273,190000,1,3,1,39,-1,-1,-2,-1,-1,-1,157,-1049,-2681,1975,2244,3294,0,0,6475,2244,2284,0,1,157,-1049,-9156,-269,-40,3294,0.0008263157894736842,-0.005521052631578947,-0.048189473684210525,-0.0014157894736842105,-0.0002105263157894737,0.017336842105263157,-7
4274,150000,0,1,2,33,0,0,0,0,0,0,45335,50262,54793,59244,64096,68837,6000,6000,6000,6000,6001,6000,0,39335,44262,48793,53244,58095,62837,0.2622333333333333,0.29508,0.32528666666666667,0.35496,0.3873,0.41891333333333336,0
4275,170000,1,2,1,38,0,0,0,0,0,2,136768,133840,138172,140265,112529,110318,5000,6800,6500,8300,0,4200,1,131768,127040,131672,131965,112529,106118,0.7751058823529412,0.7472941176470588,0.7745411764705883,0.776264705882353,0.6619352941176471,0.6242235294117647,2
4276,100000,1,1,2,25,-1,-1,-1,-1,0,0,12660,5000,0,6272,10135,11958,5000,0,6272,4000,2000,0,0,7660,5000,-6272,2272,8135,11958,0.0766,0.05,-0.06272,0.02272,0.08135,0.11958,-4
4277,130000,1,3,2,32,0,0,0,0,0,0,12535,14317,15656,4918,6918,8944,2000,2040,3000,2000,2026,6561,0,10535,12277,12656,2918,4892,2383,0.08103846153846155,0.09443846153846154,0.09735384615384615,0.022446153846153845,0.03763076923076923,0.01833076923076923,0
4278,80000,0,3,2,38,0,0,0,0,0,0,7790,9123,10656,11474,13117,15899,1467,2000,1000,2000,3000,0,0,6323,7123,9656,9474,10117,15899,0.0790375,0.0890375,0.1207,0.118425,0.1264625,0.1987375,0
4279,130000,1,2,2,23,0,0,0,0,0,0,111388,113900,109062,105252,103969,104254,6000,5000,6000,10000,10000,5000,0,105388,108900,103062,95252,93969,99254,0.8106769230769231,0.8376923076923077,0.7927846153846154,0.7327076923076923,0.7228384615384615,0.7634923076923077,0
4280,150000,1,1,2,27,-1,0,0,-2,-2,-2,30585,30138,0,0,0,0,6000,0,0,0,0,0,0,24585,30138,0,0,0,0,0.1639,0.20092,0.0,0.0,0.0,0.0,-7
4281,230000,1,3,1,32,0,0,0,0,0,0,195126,88743,92195,94814,98182,98457,5000,5000,5000,5000,4000,5000,1,190126,83743,87195,89814,94182,93457,0.8266347826086956,0.3641,0.3791086956521739,0.390495652173913,0.4094869565217391,0.40633478260869565,0
4282,200000,0,1,2,34,-1,-1,-1,-1,-1,-2,959,451,-1,605,-5,-5,452,0,606,0,0,0,0,507,451,-607,605,-5,-5,0.002535,0.002255,-0.003035,0.003025,-2.5e-05,-2.5e-05,-7
4283,60000,1,2,2,36,0,0,0,0,0,0,57724,56597,50766,47022,31606,30820,2000,5015,2000,3000,1300,1500,0,55724,51582,48766,44022,30306,29320,0.9287333333333333,0.8597,0.8127666666666666,0.7337,0.5051,0.4886666666666667,0
4284,180000,1,1,2,34,0,0,0,0,0,2,85129,88701,91356,94820,100740,99015,5000,5000,5000,7500,0,6000,0,80129,83701,86356,87320,100740,93015,0.4451611111111111,0.46500555555555556,0.47975555555555555,0.4851111111111111,0.5596666666666666,0.51675,2
4285,360000,1,2,2,53,-1,-1,-1,-1,-1,-1,10733,15206,15000,9744,11114,8123,15206,15032,9769,11114,8123,8736,0,-4473,174,5231,-1370,2991,-613,-0.012425,0.00048333333333333334,0.014530555555555555,-0.0038055555555555555,0.008308333333333333,-0.0017027777777777779,-6
4286,30000,1,2,2,24,2,2,7,7,7,7,2550,2550,2550,2550,2550,2550,0,0,0,0,0,0,0,2550,2550,2550,2550,2550,2550,0.085,0.085,0.085,0.085,0.085,0.085,32
4287,20000,0,3,2,46,0,0,0,2,3,5,7790,9985,12001,13978,15932,17572,2500,2500,2500,2500,2500,2500,0,5290,7485,9501,11478,13432,15072,0.2645,0.37425,0.47505,0.5739,0.6716,0.7536,10
4288,50000,1,3,2,54,4,4,3,2,2,0,51300,50222,49097,50036,49145,47639,0,0,2000,0,1900,2000,0,51300,50222,47097,50036,47245,45639,1.026,1.00444,0.94194,1.00072,0.9449,0.91278,15
4289,200000,1,1,2,27,-1,-1,-1,0,0,0,871,665,960,4242,4084,7414,665,960,3908,1014,3500,2880,0,206,-295,-2948,3228,584,4534,0.00103,-0.001475,-0.01474,0.01614,0.00292,0.02267,-3
4290,50000,0,2,2,29,0,0,0,0,0,0,51232,50732,50962,49908,32361,21138,1900,2300,1500,1500,900,900,0,49332,48432,49462,48408,31461,20238,0.98664,0.96864,0.98924,0.96816,0.62922,0.40476,0
4291,80000,1,1,2,38,-2,-2,-2,-2,-2,-2,1927,446,909,1740,2190,518,446,909,1740,2190,518,5062,0,1481,-463,-831,-450,1672,-4544,0.0185125,-0.0057875,-0.0103875,-0.005625,0.0209,-0.0568,-12
4292,130000,1,4,2,27,0,0,0,0,0,0,107599,109902,112635,114472,117556,116090,4030,4600,4200,5000,5000,21932,0,103569,105302,108435,109472,112556,94158,0.7966846153846154,0.8100153846153846,0.8341153846153846,0.8420923076923077,0.8658153846153847,0.7242923076923077,0
4293,360000,1,1,1,31,-1,-1,2,-1,-1,-1,3680,9995,3225,4230,6113,8745,13517,0,4230,6113,8745,6324,1,-9837,9995,-1005,-1883,-2632,2421,-0.027325,0.02776388888888889,-0.0027916666666666667,-0.005230555555555555,-0.007311111111111111,0.006725,-3
4294,100000,1,2,1,33,1,2,2,2,2,2,23384,22722,24909,24210,26103,27554,0,2569,0,2287,2028,0,1,23384,20153,24909,21923,24075,27554,0.23384,0.20153,0.24909,0.21923,0.24075,0.27554,11
4295,20000,0,2,2,23,0,0,0,0,0,0,17728,18835,38099,18471,16408,17135,1700,1262,1244,595,1000,1000,0,16028,17573,36855,17876,15408,16135,0.8014,0.87865,1.84275,0.8938,0.7704,0.80675,0
4296,50000,0,1,2,30,0,0,0,0,0,0,11787,9720,8613,5173,5593,0,1300,1034,0,1200,0,0,0,10487,8686,8613,3973,5593,0,0.20974,0.17372,0.17226,0.07946,0.11186,0.0,0
4297,80000,0,2,2,25,0,0,0,-1,0,0,8852,1946,1473,48029,47525,47181,1000,1000,48029,2000,2000,2000,0,7852,946,-46556,46029,45525,45181,0.09815,0.011825,-0.58195,0.5753625,0.5690625,0.5647625,-1
4298,230000,1,1,1,35,-2,-2,-2,-2,-2,-2,9000,0,0,0,0,0,0,0,0,0,0,0,1,9000,0,0,0,0,0,0.0391304347826087,0.0,0.0,0.0,0.0,0.0,-12
4299,50000,1,2,2,44,0,0,2,3,2,0,16094,18961,20857,20229,19623,19878,3155,2500,0,0,707,713,0,12939,16461,20857,20229,18916,19165,0.25878,0.32922,0.41714,0.40458,0.37832,0.3833,7
4300,200000,1,1,2,29,-1,2,-1,-1,-1,2,2393,183,4847,20183,24815,24248,0,4872,20183,5000,0,1000,0,2393,-4689,-15336,15183,24815,23248,0.011965,-0.023445,-0.07668,0.075915,0.124075,0.11624,0
4301,40000,1,1,2,29,0,0,2,2,2,2,26461,29425,30145,29361,33893,34487,3400,1500,0,5000,1300,0,0,23061,27925,30145,24361,32593,34487,0.576525,0.698125,0.753625,0.609025,0.814825,0.862175,8
4302,80000,1,2,1,31,0,0,-1,0,-1,-1,3601,-876,6440,2802,1290,4547,9,9242,0,1290,4547,1850,1,3592,-10118,6440,1512,-3257,2697,0.0449,-0.126475,0.0805,0.0189,-0.0407125,0.0337125,-3
4303,30000,1,2,2,25,0,0,0,0,0,2,7204,7453,7098,10148,22070,23182,1200,1114,4000,13000,2000,0,0,6004,6339,3098,-2852,20070,23182,0.20013333333333333,0.2113,0.10326666666666667,-0.09506666666666666,0.669,0.7727333333333334,2
4304,380000,1,2,2,31,0,0,0,0,0,0,381530,385605,257188,145505,142529,229320,32640,18077,12005,10028,28888,25000,0,348890,367528,245183,135477,113641,204320,0.9181315789473684,0.967178947368421,0.6452184210526316,0.3565184210526316,0.2990552631578947,0.5376842105263158,0
4305,150000,1,2,2,25,0,0,0,0,0,0,142827,126317,75324,78773,95375,57663,5000,4000,5000,40000,3000,2880,0,137827,122317,70324,38773,92375,54783,0.9188466666666667,0.8154466666666667,0.46882666666666667,0.25848666666666664,0.6158333333333333,0.36522,0
4306,170000,1,1,2,25,0,0,0,0,0,0,70326,71919,68356,68724,68889,69712,3100,3626,2500,2450,2693,2602,0,67226,68293,65856,66274,66196,67110,0.39544705882352943,0.4017235294117647,0.38738823529411764,0.38984705882352944,0.38938823529411765,0.39476470588235296,0
4307,50000,0,3,1,41,2,2,2,2,-2,-2,20186,15773,13555,0,0,0,2700,103,0,0,0,0,1,17486,15670,13555,0,0,0,0.34972,0.3134,0.2711,0.0,0.0,0.0,4
4308,140000,1,2,2,26,0,0,0,0,2,0,141057,144306,141949,141345,136379,126211,7200,19000,10400,0,4931,9100,0,133857,125306,131549,141345,131448,117111,0.9561214285714286,0.8950428571428571,0.9396357142857142,1.009607142857143,0.9389142857142857,0.8365071428571429,2
4309,80000,1,1,2,22,0,-1,0,0,0,0,6518,65145,53655,50279,41166,28657,65145,2386,2000,2000,3000,1000,0,-58627,62759,51655,48279,38166,27657,-0.7328375,0.7844875,0.6456875,0.6034875,0.477075,0.3457125,-1
4310,300000,0,3,2,29,0,0,0,0,0,0,103792,108297,75385,76864,124477,192001,8401,4266,3087,49195,70000,7016,0,95391,104031,72298,27669,54477,184985,0.31797,0.34677,0.24099333333333334,0.09223,0.18159,0.6166166666666667,0
4311,70000,1,1,2,24,0,0,0,0,0,0,42105,35575,32772,29766,29286,29404,1614,2042,2002,1052,1055,1063,0,40491,33533,30770,28714,28231,28341,0.5784428571428571,0.47904285714285716,0.43957142857142856,0.4102,0.4033,0.40487142857142855,0
4312,290000,1,1,1,51,-2,-2,-2,-2,-2,-2,0,22888,783,40720,4352,504,22888,783,40720,4352,504,720,1,-22888,22105,-39937,36368,3848,-216,-0.07892413793103448,0.07622413793103448,-0.13771379310344828,0.12540689655172413,0.013268965517241379,-0.0007448275862068966,-12
4313,20000,1,2,1,46,4,3,2,3,2,0,15833,15286,17021,16461,15901,16294,0,2277,0,0,800,1400,1,15833,13009,17021,16461,15101,14894,0.79165,0.65045,0.85105,0.82305,0.75505,0.7447,14
4314,500000,1,1,2,44,-2,-2,-2,-2,-2,-2,0,5218,3981,0,3672,7617,5218,3981,0,3672,7617,2691,0,-5218,1237,3981,-3672,-3945,4926,-0.010436,0.002474,0.007962,-0.007344,-0.00789,0.009852,-12
4315,360000,0,2,1,36,0,0,0,-1,0,0,33051,13614,-5386,250214,255296,261401,1000,2544,261000,9000,10000,10000,1,32051,11070,-266386,241214,245296,251401,0.08903055555555556,0.03075,-0.7399611111111111,0.6700388888888889,0.6813777777777777,0.6983361111111112,-1
4316,10000,0,2,2,37,0,0,0,0,0,0,17018,13789,8236,9130,7302,7981,1117,2800,1200,265,800,500,0,15901,10989,7036,8865,6502,7481,1.5901,1.0989,0.7036,0.8865,0.6502,0.7481,0
4317,220000,1,1,1,48,-1,-1,-2,-2,-2,-2,3467,3327,839,-3,1856,1528,3340,840,3,1859,2134,1648,1,127,2487,836,-1862,-278,-120,0.0005772727272727273,0.011304545454545454,0.0038,-0.008463636363636364,-0.0012636363636363637,-0.0005454545454545455,-10
4318,130000,0,2,2,22,0,0,0,0,0,0,120479,98341,132260,127335,51104,50536,5601,103012,3965,3508,3011,3033,0,114878,-4671,128295,123827,48093,47503,0.883676923076923,-0.03593076923076923,0.9868846153846154,0.9525153846153847,0.36994615384615387,0.3654076923076923,0
4319,360000,1,1,1,28,0,0,0,0,0,-2,164857,192513,178030,117997,0,0,30650,9300,6000,0,0,0,1,134207,183213,172030,117997,0,0,0.3727972222222222,0.508925,0.4778611111111111,0.32776944444444445,0.0,0.0,-2
4320,240000,0,1,1,44,-1,-1,-1,-1,-1,-1,4221,2188,2701,2427,1104,2362,2188,2701,2427,1104,2362,519,1,2033,-513,274,1323,-1258,1843,0.008470833333333334,-0.0021375,0.0011416666666666667,0.0055125,-0.005241666666666667,0.007679166666666667,-6
4321,310000,1,2,2,27,0,0,0,0,0,0,44834,35597,34161,38689,32710,24343,2015,2000,5034,1045,776,389,0,42819,33597,29127,37644,31934,23954,0.1381258064516129,0.10837741935483872,0.09395806451612904,0.12143225806451613,0.10301290322580645,0.07727096774193548,0
4322,330000,1,1,1,36,1,-2,-2,-1,-1,-1,0,0,0,469,150,3661,0,0,469,150,3661,3800,1,0,0,-469,319,-3511,-139,0.0,0.0,-0.0014212121212121211,0.0009666666666666667,-0.01063939393939394,-0.0004212121212121212,-6
4323,50000,1,2,1,50,0,0,0,0,0,0,51212,50658,48999,49388,48853,47765,2070,2357,1746,1628,1520,2202,1,49142,48301,47253,47760,47333,45563,0.98284,0.96602,0.94506,0.9552,0.94666,0.91126,0
4324,170000,1,3,2,31,1,-2,-2,-2,-1,-1,0,0,0,0,150,167,0,0,0,150,167,2578,0,0,0,0,-150,-17,-2411,0.0,0.0,0.0,-0.0008823529411764706,-0.0001,-0.01418235294117647,-7
4325,120000,0,2,1,52,2,0,0,0,0,0,107269,106791,105262,46605,45590,46204,4449,2731,3000,5000,3000,3000,1,102820,104060,102262,41605,42590,43204,0.8568333333333333,0.8671666666666666,0.8521833333333333,0.34670833333333334,0.35491666666666666,0.3600333333333333,2
4326,270000,1,1,2,31,-2,-2,-2,-2,-2,-2,973,417,1593,913,1471,1302,592,1593,913,1471,1302,7107,0,381,-1176,680,-558,169,-5805,0.001411111111111111,-0.004355555555555555,0.0025185185185185185,-0.0020666666666666667,0.0006259259259259259,-0.0215,-12
4327,110000,0,2,1,30,0,0,0,0,0,0,107372,109156,111795,54358,58499,61445,5000,5000,3000,5000,6000,3000,1,102372,104156,108795,49358,52499,58445,0.9306545454545454,0.9468727272727273,0.9890454545454546,0.4487090909090909,0.4772636363636364,0.5313181818181818,0
4328,60000,1,2,1,39,1,-2,-2,-2,-2,-2,0,0,0,0,0,0,0,0,0,0,0,0,1,0,0,0,0,0,0,0.0,0.0,0.0,0.0,0.0,0.0,-9
4329,10000,0,2,2,27,0,0,0,0,0,2,16944,8261,9252,9590,10129,8932,2296,1139,477,830,0,1241,0,14648,7122,8775,8760,10129,7691,1.4648,0.7122,0.8775,0.876,1.0129,0.7691,2
4330,110000,0,2,1,42,0,0,0,0,2,2,70265,74102,77901,84592,82350,87186,5000,5000,8000,0,7000,0,1,65265,69102,69901,84592,75350,87186,0.5933181818181819,0.6282,0.6354636363636363,0.7690181818181818,0.685,0.7926,4
4331,50000,0,2,1,40,0,0,0,0,0,0,49073,49531,44002,44356,19344,19354,1691,1942,1296,674,693,1000,1,47382,47589,42706,43682,18651,18354,0.94764,0.95178,0.85412,0.87364,0.37302,0.36708,0
4332,40000,1,1,2,26,0,0,0,0,0,0,12308,13604,14873,15624,15972,16308,1500,1500,1000,600,600,1700,0,10808,12104,13873,15024,15372,14608,0.2702,0.3026,0.346825,0.3756,0.3843,0.3652,0
4333,120000,0,1,2,34,1,2,-1,-1,-2,-2,1278,639,621,-18,-18,-18,0,621,0,0,0,0,0,1278,18,621,-18,-18,-18,0.01065,0.00015,0.005175,-0.00015,-0.00015,-0.00015,-3
4334,400000,1,2,1,36,0,-1,2,-1,0,0,20818,1079,799,1883,587,0,1878,0,1883,0,0,0,1,18940,1079,-1084,1883,587,0,0.04735,0.0026975,-0.00271,0.0047075,0.0014675,0.0,0
4335,80000,0,2,2,38,0,0,0,0,0,0,54809,55944,57075,57745,59099,60489,2612,2655,2214,2435,2669,16981,0,52197,53289,54861,55310,56430,43508,0.6524625,0.6661125,0.6857625,0.691375,0.705375,0.54385,0
4336,120000,1,2,1,40,-2,-2,-2,-1,0,0,73900,0,0,3663,3663,0,0,0,3663,0,0,0,1,73900,0,-3663,3663,3663,0,0.6158333333333333,0.0,-0.030525,0.030525,0.030525,0.0,-7
4337,10000,0,3,1,41,0,0,0,0,0,3,6270,7303,8375,9268,10630,10188,1300,1350,1200,1500,0,0,1,4970,5953,7175,7768,10630,10188,0.497,0.5953,0.7175,0.7768,1.063,1.0188,3
4338,50000,1,3,2,56,0,-1,-1,2,0,0,26242,2946,6152,4419,4419,1473,3006,6152,0,0,0,0,0,23236,-3206,6152,4419,4419,1473,0.46472,-0.06412,0.12304,0.08838,0.08838,0.02946,0
4339,70000,1,2,1,34,0,0,0,0,0,0,66946,67741,68790,68523,29163,29247,3007,3248,2661,1135,1160,1169,1,63939,64493,66129,67388,28003,28078,0.9134142857142857,0.9213285714285714,0.9447,0.9626857142857143,0.40004285714285714,0.4011142857142857,0
4340,30000,0,3,1,51,0,0,0,0,0,-2,13386,13218,14453,15525,0,0,1218,1453,1525,0,0,0,1,12168,11765,12928,15525,0,0,0.4056,0.39216666666666666,0.43093333333333333,0.5175,0.0,0.0,-2
4341,180000,1,2,1,26,-2,-2,-2,-2,-2,-1,52666,181987,181255,174825,140909,177257,272817,7017,8201,8246,186732,8000,1,-220151,174970,173054,166579,-45823,169257,-1.2230611111111112,0.9720555555555556,0.9614111111111111,0.9254388888888889,-0.2545722222222222,0.9403166666666667,-11
4342,90000,0,1,1,34,0,0,0,-2,-2,-2,106339,90500,0,0,0,0,20585,0,0,0,0,0,1,85754,90500,0,0,0,0,0.9528222222222222,1.0055555555555555,0.0,0.0,0.0,0.0,-6
4343,80000,1,3,1,52,2,2,3,3,3,2,36649,39448,40101,40748,39816,40607,3700,1600,1600,0,1600,1600,1,32949,37848,38501,40748,38216,39007,0.4118625,0.4731,0.4812625,0.50935,0.4777,0.4875875,15
4344,400000,0,2,1,40,7,6,5,4,3,2,405366,397754,389903,384981,381863,359314,0,0,0,106,2281,42617,1,405366,397754,389903,384875,379582,316697,1.013415,0.994385,0.9747575,0.9621875,0.948955,0.7917425,27
4345,60000,1,2,2,24,1,-2,-1,-1,-2,-2,0,0,1668,844,200,2930,0,1668,844,1044,2930,3783,0,0,-1668,824,-200,-2730,-853,0.0,-0.0278,0.013733333333333334,-0.0033333333333333335,-0.0455,-0.014216666666666667,-7
4346,100000,0,3,1,40,0,0,-1,-1,-2,-2,12878,7702,2377,0,0,0,2000,2377,40000,0,0,0,1,10878,5325,-37623,0,0,0,0.10878,0.05325,-0.37623,0.0,0.0,0.0,-6
4347,30000,0,3,2,51,0,0,0,0,0,2,24070,25358,26447,26946,28957,29408,2000,1800,1300,2400,1000,1000,0,22070,23558,25147,24546,27957,28408,0.7356666666666667,0.7852666666666667,0.8382333333333334,0.8182,0.9319,0.9469333333333333,2
4348,20000,0,1,2,22,1,2,0,0,0,0,10591,10277,11304,12311,12410,13358,0,1500,1500,600,1300,0,0,10591,8777,9804,11711,11110,13358,0.52955,0.43885,0.4902,0.58555,0.5555,0.6679,3
4349,240000,0,1,2,29,0,0,0,0,0,0,240248,221277,201606,183454,180255,184230,11000,9100,8000,8000,7000,8000,0,229248,212177,193606,175454,173255,176230,0.9552,0.8840708333333334,0.8066916666666667,0.7310583333333334,0.7218958333333333,0.7342916666666667,0
4350,50000,1,2,1,33,0,0,0,0,0,0,49450,50067,69594,46181,16770,19890,1743,2236,2807,629,3810,719,1,47707,47831,66787,45552,12960,19171,0.95414,0.95662,1.33574,0.91104,0.2592,0.38342,0
4351,200000,0,1,2,31,-1,-1,-1,0,0,-1,3702,25548,10594,7969,2865,5625,25678,10623,25,16,6000,19,0,-21976,14925,10569,7953,-3135,5606,-0.10988,0.074625,0.052845,0.039765,-0.015675,0.02803,-4
4352,20000,1,1,2,24,2,-1,-1,-1,-1,-1,1150,1661,-29,2992,3664,5364,1661,0,3021,3664,5364,0,0,-511,1661,-3050,-672,-1700,5364,-0.02555,0.08305,-0.1525,-0.0336,-0.085,0.2682,-3
4353,410000,0,2,1,41,0,0,0,0,-1,0,392906,400864,410877,419454,1356,1362,16000,17986,18545,1362,6,0,1,376906,382878,392332,418092,1350,1362,0.9192829268292683,0.9338487804878048,0.9569073170731708,1.0197365853658538,0.003292682926829268,0.003321951219512195,-1
4354,240000,0,1,1,33,0,0,0,0,0,0,167835,170978,172217,163786,81611,79817,7200,8400,7000,3000,2900,3100,1,160635,162578,165217,160786,78711,76717,0.6693125,0.6774083333333333,0.6884041666666667,0.6699416666666667,0.3279625,0.3196541666666667,0
4355,510000,1,3,1,61,0,0,2,0,0,0,181733,192903,181801,178179,223100,216225,17000,0,6508,50000,7000,6000,1,164733,192903,175293,128179,216100,210225,0.3230058823529412,0.37824117647058825,0.34371176470588233,0.2513313725490196,0.4237254901960784,0.4122058823529412,2
4356,200000,1,3,1,42,-1,-1,-1,-1,-1,-1,858,1406,3673,0,150,609,1406,3673,0,150,609,939,1,-548,-2267,3673,-150,-459,-330,-0.00274,-0.011335,0.018365,-0.00075,-0.002295,-0.00165,-6
4357,200000,0,2,2,30,0,0,0,0,0,0,65342,63218,64594,65070,20478,13737,2856,3000,1367,475,344,581,0,62486,60218,63227,64595,20134,13156,0.31243,0.30109,0.316135,0.322975,0.10067,0.06578,0
4358,280000,1,1,1,35,0,0,0,0,0,0,171057,173712,177913,182942,186892,197661,7000,7000,8000,7000,14000,8000,1,164057,166712,169913,175942,172892,189661,0.5859178571428572,0.5954,0.6068321428571428,0.6283642857142857,0.6174714285714286,0.6773607142857143,0
4359,100000,0,2,1,39,0,0,0,0,0,0,74053,75040,76231,78392,79485,81397,3274,3000,3431,2994,3345,3233,1,70779,72040,72800,75398,76140,78164,0.70779,0.7204,0.728,0.75398,0.7614,0.78164,0
4360,60000,1,2,1,36,0,0,0,0,0,-1,59945,57262,27275,22095,14293,12217,1805,5816,1000,5000,12217,8000,1,58140,51446,26275,17095,2076,4217,0.969,0.8574333333333334,0.4379166666666667,0.28491666666666665,0.0346,0.07028333333333334,-1
4361,100000,1,1,2,28,2,2,2,2,2,2,79580,81493,82759,83609,85325,87096,3790,3200,3100,3200,3332,3280,0,75790,78293,79659,80409,81993,83816,0.7579,0.78293,0.79659,0.80409,0.81993,0.83816,12
4362,80000,0,3,2,27,0,-1,-1,-2,-2,-2,13165,2100,0,0,0,0,2100,0,0,0,0,0,0,11065,2100,0,0,0,0,0.1383125,0.02625,0.0,0.0,0.0,0.0,-8
4363,420000,0,1,2,31,-1,0,0,0,-1,-1,31065,25918,20899,14966,5676,134038,2004,3000,1041,5676,135687,4192,0,29061,22918,19858,9290,-130011,129846,0.06919285714285714,0.054566666666666666,0.04728095238095238,0.022119047619047618,-0.30955,0.30915714285714285,-3
4364,30000,0,2,1,45,2,4,4,3,2,2,28854,30467,29721,28961,29397,29988,2372,0,0,1200,1200,1163,1,26482,30467,29721,27761,28197,28825,0.8827333333333334,1.0155666666666667,0.9907,0.9253666666666667,0.9399,0.9608333333333333,17
4365,160000,0,1,2,33,-1,-1,-2,-2,-2,-2,100,0,0,0,0,0,0,0,0,0,0,0,0,100,0,0,0,0,0,0.000625,0.0,0.0,0.0,0.0,0.0,-10
4366,30000,1,2,1,33,0,0,0,0,0,0,28938,30246,30485,30274,29967,23477,1800,1574,1300,886,1000,686,1,27138,28672,29185,29388,28967,22791,0.9046,0.9557333333333333,0.9728333333333333,0.9796,0.9655666666666667,0.7597,0
4367,70000,0,2,2,31,0,0,0,0,0,0,35515,36619,37725,38792,39447,40361,2000,2000,2000,1600,1700,1700,0,33515,34619,35725,37192,37747,38661,0.47878571428571426,0.49455714285714286,0.5103571428571428,0.5313142857142857,0.5392428571428571,0.5523,0
4368,150000,1,1,2,33,-1,-1,-2,-2,-2,-2,717,-959,-959,-959,-959,-959,0,0,0,0,0,0,0,717,-959,-959,-959,-959,-959,0.00478,-0.006393333333333333,-0.006393333333333333,-0.006393333333333333,-0.006393333333333333,-0.006393333333333333,-10
4369,50000,0,2,2,54,2,0,0,0,0,0,46431,47028,48063,48667,17875,17699,1756,2181,2175,773,638,694,0,44675,44847,45888,47894,17237,17005,0.8935,0.89694,0.91776,0.95788,0.34474,0.3401,2
4370,200000,1,1,2,34,-2,-2,-2,-2,-2,-2,500,810,500,0,0,300,810,500,0,0,300,0,0,-310,310,500,0,-300,300,-0.00155,0.00155,0.0025,0.0,-0.0015,0.0015,-12
4371,490000,0,2,1,34,0,0,0,0,-1,0,25015,20912,18817,13424,162851,151961,1340,1397,3193,162856,5461,5010,1,23675,19515,15624,-149432,157390,146951,0.04831632653061225,0.0398265306122449,0.03188571428571429,-0.30496326530612244,0.32120408163265307,0.2999,-1
4372,20000,0,2,2,34,2,2,2,0,0,0,17497,20690,20075,19492,19859,19232,3500,0,1500,805,7000,542,0,13997,20690,18575,18687,12859,18690,0.69985,1.0345,0.92875,0.93435,0.64295,0.9345,6
4373,60000,1,2,1,29,0,0,0,0,0,0,63578,61347,57138,51026,24213,5295,2188,2285,1429,169,426,29350,1,61390,59062,55709,50857,23787,-24055,1.0231666666666666,0.9843666666666666,0.9284833333333333,0.8476166666666667,0.39645,-0.40091666666666664,0
4374,160000,1,3,1,51,-2,-2,-2,-2,-2,-2,0,0,0,0,0,0,0,0,0,0,0,0,1,0,0,0,0,0,0,0.0,0.0,0.0,0.0,0.0,0.0,-12
4375,260000,0,2,2,32,-1,-1,-1,-1,-1,-1,1198,1198,1198,1198,1198,1198,1198,1198,1198,1198,1198,1198,0,0,0,0,0,0,0,0.0,0.0,0.0,0.0,0.0,0.0,-6
4376,220000,1,2,2,30,0,0,0,0,0,0,18598,24781,22901,23815,37748,16657,10000,2015,5000,20000,3000,1210,0,8598,22766,17901,3815,34748,15447,0.03908181818181818,0.10348181818181819,0.08136818181818181,0.01734090909090909,0.15794545454545456,0.07021363636363637,0
4377,200000,1,2,1,35,1,-1,-1,2,0,0,59466,2970,1085,769,453,137,7970,1100,0,0,0,0,1,51496,1870,1085,769,453,137,0.25748,0.00935,0.005425,0.003845,0.002265,0.000685,1
4378,80000,1,3,1,57,0,0,0,0,0,0,80297,65002,62321,43303,40866,40573,3410,13800,3557,1620,1520,1805,1,76887,51202,58764,41683,39346,38768,0.9610875,0.640025,0.73455,0.5210375,0.491825,0.4846,0
4379,320000,0,1,2,33,-2,-2,-2,-2,-2,-2,3903,3609,4615,5256,22760,700,3609,4615,5256,22760,700,1992,0,294,-1006,-641,-17504,22060,-1292,0.00091875,-0.00314375,-0.002003125,-0.0547,0.0689375,-0.0040375,-12
4380,50000,0,2,1,46,-1,0,0,0,-1,0,1853,3656,4400,0,1704,3715,2000,1000,0,1704,2011,0,1,-147,2656,4400,-1704,-307,3715,-0.00294,0.05312,0.088,-0.03408,-0.00614,0.0743,-2
4381,320000,1,1,1,34,-1,-1,-1,-1,-1,-1,800,18873,-150,150,21565,4818,18873,0,500,21565,5000,168492,1,-18073,18873,-650,-21415,16565,-163674,-0.056478125,0.058978125,-0.00203125,-0.066921875,0.051765625,-0.51148125,-6
4382,90000,0,1,2,26,1,2,2,0,0,0,58518,52526,45640,41539,39373,32080,3006,99,1500,1500,2015,1200,0,55512,52427,44140,40039,37358,30880,0.6168,0.5825222222222223,0.49044444444444446,0.44487777777777776,0.4150888888888889,0.3431111111111111,5
4383,570000,1,1,2,32,0,0,0,0,0,0,47758,33050,36283,36502,37669,39102,3000,4880,3000,3000,3000,3000,0,44758,28170,33283,33502,34669,36102,0.07852280701754386,0.04942105263157895,0.05839122807017544,0.05877543859649123,0.06082280701754386,0.06333684210526316,0
4384,100000,1,3,1,50,0,0,0,0,0,0,16469,17885,19587,21256,22895,24514,2000,2000,2000,2000,2000,2000,1,14469,15885,17587,19256,20895,22514,0.14469,0.15885,0.17587,0.19256,0.20895,0.22514,0
4385,10000,1,2,2,22,5,4,3,2,2,2,8541,8270,7995,7720,8224,7944,0,0,0,778,0,158,0,8541,8270,7995,6942,8224,7786,0.8541,0.827,0.7995,0.6942,0.8224,0.7786,18
4386,50000,1,2,2,23,-1,-1,-1,0,-1,-1,780,0,780,390,390,500,0,780,0,390,500,18300,0,780,-780,780,0,-110,-17800,0.0156,-0.0156,0.0156,0.0,-0.0022,-0.356,-5
4387,160000,0,1,2,30,-1,-1,-1,-1,-1,-1,99,2977,15086,8578,13028,21712,2977,15086,9123,13028,29712,50000,0,-2878,-12109,5963,-4450,-16684,-28288,-0.0179875,-0.07568125,0.03726875,-0.0278125,-0.104275,-0.1768,-6
4388,110000,1,1,2,27,0,0,0,0,0,0,112938,113331,108567,110772,111946,111853,6000,5500,5500,4500,4400,4400,0,106938,107831,103067,106272,107546,107453,0.9721636363636363,0.9802818181818181,0.9369727272727273,0.9661090909090909,0.977690909090909,0.9768454545454546,0
4389,210000,1,1,2,43,1,-1,0,0,0,0,-3309,177952,167125,139784,142662,145725,184212,5482,3493,3590,3815,3876,0,-187521,172470,163632,136194,138847,141849,-0.8929571428571429,0.8212857142857143,0.7792,0.6485428571428571,0.6611761904761905,0.6754714285714286,0
4390,340000,1,1,1,42,0,0,0,0,0,0,221587,216472,218817,223329,226176,230921,8409,8500,8500,8500,8500,8500,1,213178,207972,210317,214829,217676,222421,0.6269941176470588,0.6116823529411765,0.6185794117647059,0.63185,0.6402235294117647,0.6541794117647058,0
4391,10000,1,2,2,22,1,2,2,2,0,0,8925,8637,10277,9736,9704,9725,0,1800,0,500,600,500,0,8925,6837,10277,9236,9104,9225,0.8925,0.6837,1.0277,0.9236,0.9104,0.9225,7
4392,230000,1,3,2,54,0,0,0,0,0,0,66108,45000,33477,34914,36352,37745,6840,3000,2000,2000,2000,2000,0,59268,42000,31477,32914,34352,35745,0.2576869565217391,0.1826086956521739,0.13685652173913043,0.14310434782608697,0.14935652173913044,0.15541304347826088,0
4393,90000,1,2,1,36,0,0,2,0,0,0,86155,92406,90049,86984,67076,66533,8600,0,4100,5000,5000,5000,1,77555,92406,85949,81984,62076,61533,0.8617222222222222,1.0267333333333333,0.9549888888888889,0.9109333333333334,0.6897333333333333,0.6837,2
4394,270000,0,3,2,31,0,0,0,0,0,0,188929,191179,171057,163865,167289,167928,10089,7009,7506,10007,6007,6504,0,178840,184170,163551,153858,161282,161424,0.6623703703703704,0.6821111111111111,0.6057444444444444,0.5698444444444445,0.5973407407407407,0.5978666666666667,0
4395,160000,0,2,1,28,0,0,2,2,0,0,62312,66965,67648,66020,67386,68336,5856,2311,0,2377,2000,1881,1,56456,64654,67648,63643,65386,66455,0.35285,0.4040875,0.4228,0.39776875,0.4086625,0.41534375,4
4396,20000,1,1,2,26,1,-2,-1,-1,-1,-1,0,0,450,-150,750,568,0,450,0,900,568,1769,0,0,-450,450,-1050,182,-1201,0.0,-0.0225,0.0225,-0.0525,0.0091,-0.06005,-5
4397,60000,0,2,2,28,0,0,0,0,0,0,55731,57239,57183,24564,24155,25023,3000,1800,1000,1100,1200,1500,0,52731,55439,56183,23464,22955,23523,0.87885,0.9239833333333334,0.9363833333333333,0.3910666666666667,0.38258333333333333,0.39205,0
4398,70000,1,1,2,29,0,0,0,0,0,0,66330,68278,69181,69494,63275,57430,3049,2621,3032,2074,2000,1800,0,63281,65657,66149,67420,61275,55630,0.9040142857142857,0.9379571428571428,0.9449857142857143,0.9631428571428572,0.8753571428571428,0.7947142857142857,0
4399,180000,0,1,2,27,-1,0,0,0,0,0,3210,13852,6482,3246,2016,2334,12000,5004,1000,1000,2300,3000,0,-8790,8848,5482,2246,-284,-666,-0.04883333333333333,0.049155555555555557,0.030455555555555555,0.012477777777777779,-0.0015777777777777778,-0.0037,-1
4400,220000,1,2,1,45,0,0,0,0,0,0,204052,207977,214117,216712,194521,198246,7600,10000,8255,7200,7500,8500,1,196452,197977,205862,209512,187021,189746,0.8929636363636364,0.8998954545454545,0.9357363636363636,0.9523272727272727,0.8500954545454545,0.8624818181818181,0
4401,360000,1,1,1,41,0,0,0,0,0,0,100608,95511,96288,100251,99983,122578,4000,6000,5000,4000,80000,5000,1,96608,89511,91288,96251,19983,117578,0.26835555555555557,0.24864166666666668,0.2535777777777778,0.2673638888888889,0.05550833333333333,0.32660555555555554,0
4402,50000,1,2,2,48,-1,0,0,0,0,0,47295,30348,24446,25535,26109,26689,4000,1800,1500,1000,1000,1500,0,43295,28548,22946,24535,25109,25189,0.8659,0.57096,0.45892,0.4907,0.50218,0.50378,-1
4403,130000,1,2,2,30,0,0,0,0,-2,-2,126834,128882,15621,0,0,0,5802,1000,0,0,0,0,0,121032,127882,15621,0,0,0,0.9310153846153846,0.9837076923076923,0.12016153846153846,0.0,0.0,0.0,-4
4404,30000,1,2,1,37,2,2,2,2,0,0,8229,11076,11787,11301,11677,11766,3000,1188,0,564,426,429,1,5229,9888,11787,10737,11251,11337,0.1743,0.3296,0.3929,0.3579,0.37503333333333333,0.3779,8
4405,50000,1,2,1,23,0,0,0,0,0,0,49103,44351,38726,28598,29277,27310,1800,2128,1000,1100,1000,999,1,47303,42223,37726,27498,28277,26311,0.94606,0.84446,0.75452,0.54996,0.56554,0.52622,0
4406,70000,1,2,2,26,0,0,0,0,0,0,70805,70087,62750,53600,45215,46486,2600,2231,1800,1700,2000,2000,0,68205,67856,60950,51900,43215,44486,0.9743571428571428,0.9693714285714286,0.8707142857142857,0.7414285714285714,0.6173571428571428,0.6355142857142857,0
4407,110000,1,2,2,28,0,0,0,0,0,0,105080,107420,107325,108545,105341,106822,5540,5361,4500,4000,4500,4100,0,99540,102059,102825,104545,100841,102722,0.9049090909090909,0.9278090909090909,0.9347727272727273,0.9504090909090909,0.9167363636363637,0.9338363636363637,0
4408,290000,1,2,1,30,0,0,0,0,0,0,284054,283149,284434,275889,218834,220695,10222,11019,9019,8010,8002,8001,1,273832,272130,275415,267879,210832,212694,0.9442482758620689,0.9383793103448276,0.9497068965517241,0.9237206896551724,0.7270068965517241,0.7334275862068965,0
4409,70000,1,3,3,49,2,0,0,0,0,0,92033,79841,80149,47735,48737,50225,3078,13489,7000,1771,2300,7600,0,88955,66352,73149,45964,46437,42625,1.2707857142857142,0.9478857142857143,1.0449857142857142,0.6566285714285715,0.6633857142857142,0.6089285714285714,2
4410,130000,1,1,1,30,0,0,0,0,-1,-1,9255,10264,7060,4480,3000,0,1204,1000,3990,3000,0,200,1,8051,9264,3070,1480,3000,-200,0.061930769230769234,0.07126153846153846,0.023615384615384614,0.011384615384615385,0.023076923076923078,-0.0015384615384615385,-2
4411,20000,0,3,3,48,1,-2,-1,0,0,0,-739,-5978,16089,14457,20106,10258,0,42400,289,201,410,0,0,-739,-48378,15800,14256,19696,10258,-0.03695,-2.4189,0.79,0.7128,0.9848,0.5129,-2
4412,200000,1,3,1,34,0,0,0,0,0,0,198482,182115,154994,153386,144067,110946,5014,4699,7543,3970,3146,6941,1,193468,177416,147451,149416,140921,104005,0.96734,0.88708,0.737255,0.74708,0.704605,0.520025,0
4413,180000,1,4,2,26,0,0,0,0,0,0,252810,240518,39162,5461,2309,0,8013,3060,109,46,0,0,0,244797,237458,39053,5415,2309,0,1.3599833333333333,1.3192111111111111,0.2169611111111111,0.030083333333333333,0.012827777777777778,0.0,0
4414,180000,1,2,1,30,-1,2,2,-2,-1,0,2759,2414,0,0,1245,546,13,0,0,1245,0,0,1,2746,2414,0,-1245,1245,546,0.015255555555555555,0.013411111111111111,0.0,-0.0069166666666666664,0.0069166666666666664,0.003033333333333333,0
4415,20000,0,3,2,45,0,0,0,0,0,0,5250,7151,9024,10865,12677,14309,2000,2000,2000,2000,2000,2000,0,3250,5151,7024,8865,10677,12309,0.1625,0.25755,0.3512,0.44325,0.53385,0.61545,0
4416,210000,0,2,1,44,1,2,0,0,2,0,89567,85552,86595,89689,85764,85830,0,4100,7200,0,3220,3300,1,89567,81452,79395,89689,82544,82530,0.4265095238095238,0.3878666666666667,0.37807142857142856,0.4270904761904762,0.3930666666666667,0.393,5
4417,260000,1,2,1,34,0,0,0,0,0,0,198788,195154,191504,168983,160592,156826,6105,6345,7027,6000,5000,7000,1,192683,188809,184477,162983,155592,149826,0.7410884615384615,0.7261884615384615,0.7095269230769231,0.6268576923076923,0.5984307692307692,0.5762538461538461,0
4418,200000,1,3,1,69,2,2,2,2,2,-2,2500,2500,2500,2500,0,0,0,0,0,0,0,0,1,2500,2500,2500,2500,0,0,0.0125,0.0125,0.0125,0.0125,0.0,0.0,8
4419,10000,1,2,2,22,1,2,0,0,0,0,10250,8558,10525,10050,9903,9984,0,2126,390,328,476,1287,0,10250,6432,10135,9722,9427,8697,1.025,0.6432,1.0135,0.9722,0.9427,0.8697,3
4420,50000,0,2,2,23,1,-2,-2,-1,-1,-2,0,0,0,1000,0,0,0,0,1000,0,0,0,0,0,0,-1000,1000,0,0,0.0,0.0,-0.02,0.02,0.0,0.0,-7
4421,160000,0,2,1,32,1,2,0,0,0,0,5525,4039,3656,3801,2540,2279,0,1094,1500,0,1000,0,1,5525,2945,2156,3801,1540,2279,0.03453125,0.01840625,0.013475,0.02375625,0.009625,0.01424375,3
4422,50000,0,2,2,23,1,2,0,0,0,0,6226,5981,6870,7038,2268,5051,0,1032,200,285,3000,2000,0,6226,4949,6670,6753,-732,3051,0.12452,0.09898,0.1334,0.13506,-0.01464,0.06102,3
4423,40000,1,3,1,41,1,2,2,2,2,0,20057,20931,21780,23114,22606,22903,1500,1500,2000,0,822,1000,1,18557,19431,19780,23114,21784,21903,0.463925,0.485775,0.4945,0.57785,0.5446,0.547575,9
4424,80000,0,3,1,52,1,2,2,2,0,0,77185,80311,81558,78761,71352,19674,5000,3100,0,2000,713,1500,1,72185,77211,81558,76761,70639,18174,0.9023125,0.9651375,1.019475,0.9595125,0.8829875,0.227175,7
4425,100000,1,1,1,31,-1,-1,0,-1,-1,-1,6033,19922,40000,1133,22579,2834,19922,21000,1133,22579,2834,0,1,-13889,-1078,38867,-21446,19745,2834,-0.13889,-0.01078,0.38867,-0.21446,0.19745,0.02834,-5
4426,160000,1,2,2,42,1,2,2,0,0,0,152699,152630,95758,97251,98010,99669,4462,0,4385,3639,3762,3800,0,148237,152630,91373,93612,94248,95869,0.92648125,0.9539375,0.57108125,0.585075,0.58905,0.59918125,5
4427,500000,1,1,1,30,0,0,-1,0,0,-1,8371,8759,5574,10403,2293,2702,1015,5584,6348,46,2702,4648,1,7356,3175,-774,10357,-409,-1946,0.014712,0.00635,-0.001548,0.020714,-0.000818,-0.003892,-2
4428,10000,1,2,1,37,0,-1,0,0,0,0,10000,7419,7392,8265,8631,17974,7419,1400,1000,500,500,500,1,2581,6019,6392,7765,8131,17474,0.2581,0.6019,0.6392,0.7765,0.8131,1.7474,-1
4429,200000,0,1,2,28,0,0,0,0,0,2,42215,44597,51023,56627,60693,59596,3092,7518,7122,5627,0,2741,0,39123,37079,43901,51000,60693,56855,0.195615,0.185395,0.219505,0.255,0.303465,0.284275,2
4430,360000,1,1,2,50,-1,-1,-1,-1,-1,-1,11530,11753,0,2855,1730,0,11763,0,2855,1730,0,11150,0,-233,11753,-2855,1125,1730,-11150,-0.0006472222222222222,0.03264722222222222,-0.007930555555555555,0.003125,0.004805555555555556,-0.030972222222222224,-6
4431,490000,1,2,2,27,0,0,0,0,0,-1,222705,191752,195022,196099,201289,86703,5011,5217,5000,5340,94762,5026,0,217694,186535,190022,190759,106527,81677,0.4442734693877551,0.38068367346938775,0.3878,0.38930408163265307,0.21740204081632652,0.1666877551020408,-1
4432,350000,0,3,1,31,1,2,2,0,0,0,225434,214620,170451,156922,143062,224387,11000,0,5500,5000,100000,0,1,214434,214620,164951,151922,43062,224387,0.6126685714285715,0.6132,0.47128857142857145,0.43406285714285714,0.12303428571428572,0.6411057142857143,5
4433,260000,1,1,2,36,-1,-1,-2,-1,-1,-2,531,0,0,1245,0,0,0,0,1245,0,0,0,0,531,0,-1245,1245,0,0,0.0020423076923076922,0.0,-0.004788461538461538,0.004788461538461538,0.0,0.0,-8
4434,10000,0,3,2,25,2,0,0,0,0,-2,4693,5371,6327,6055,0,0,1300,1600,400,0,0,0,0,3393,3771,5927,6055,0,0,0.3393,0.3771,0.5927,0.6055,0.0,0.0,0
4435,50000,1,2,2,24,0,0,0,0,0,0,45404,38383,39851,27258,27679,28619,1700,2156,1200,1010,1400,970,0,43704,36227,38651,26248,26279,27649,0.87408,0.72454,0.77302,0.52496,0.52558,0.55298,0
4436,420000,1,1,1,45,2,0,0,0,0,0,412289,414634,409078,412057,402926,373095,16272,17029,15514,15056,13707,14128,1,396017,397605,393564,397001,389219,358967,0.942897619047619,0.9466785714285715,0.9370571428571428,0.9452404761904762,0.9267119047619048,0.8546833333333334,2
4437,380000,1,1,2,40,0,-1,-1,-1,-1,0,4366,2566,4174,-192,15011,12990,2566,4174,192,16350,2000,55500,0,1800,-1608,3982,-16542,13011,-42510,0.004736842105263158,-0.004231578947368421,0.010478947368421053,-0.04353157894736842,0.03423947368421053,-0.11186842105263158,-4
4438,100000,1,3,2,58,0,0,0,0,0,0,98067,96802,97177,99043,74453,76252,4600,5000,4600,3000,3000,3000,0,93467,91802,92577,96043,71453,73252,0.93467,0.91802,0.92577,0.96043,0.71453,0.73252,0
4439,300000,1,2,1,28,0,0,0,-1,0,0,30631,14623,9728,28960,26589,18171,1373,1010,42348,0,0,173,1,29258,13613,-32620,28960,26589,17998,0.09752666666666666,0.04537666666666667,-0.10873333333333333,0.09653333333333333,0.08863,0.059993333333333336,-1
4440,60000,1,3,1,47,0,0,0,0,0,0,33867,35303,36032,37431,37863,38954,2000,1601,2000,1354,1700,1010,1,31867,33702,34032,36077,36163,37944,0.5311166666666667,0.5617,0.5672,0.6012833333333333,0.6027166666666667,0.6324,0
4441,500000,1,3,1,50,0,0,0,0,-1,0,5310,5484,14539,13291,3645,4763,2703,10043,6065,3648,2003,1004,1,2607,-4559,8474,9643,1642,3759,0.005214,-0.009118,0.016948,0.019286,0.003284,0.007518,-1
4442,260000,0,1,2,29,0,0,0,0,0,0,128208,100939,92549,90038,88772,111287,17000,6000,5000,6500,25000,4000,0,111208,94939,87549,83538,63772,107287,0.42772307692307693,0.36515,0.3367269230769231,0.3213,0.2452769230769231,0.4126423076923077,0
4443,100000,0,2,2,22,0,0,0,0,0,0,35986,36663,36218,38044,37222,37740,2548,2625,2451,890,1056,912,0,33438,34038,33767,37154,36166,36828,0.33438,0.34038,0.33767,0.37154,0.36166,0.36828,0
4444,180000,0,1,1,36,0,0,0,0,0,0,163736,116422,99278,95766,97753,95927,4655,2690,2067,2142,2217,1000,1,159081,113732,97211,93624,95536,94927,0.8837833333333334,0.6318444444444444,0.5400611111111111,0.5201333333333333,0.5307555555555555,0.5273722222222222,0
4445,200000,0,1,2,26,-1,-1,-2,-2,-2,-2,299,-201,-201,-201,-201,-201,0,0,0,0,0,0,0,299,-201,-201,-201,-201,-201,0.001495,-0.001005,-0.001005,-0.001005,-0.001005,-0.001005,-10
4446,170000,1,1,1,35,2,2,2,2,2,2,131909,133178,131711,139143,140987,144187,4800,2000,11000,5500,5500,5400,1,127109,131178,120711,133643,135487,138787,0.7477,0.7716352941176471,0.7100647058823529,0.786135294117647,0.7969823529411765,0.8163941176470588,12
4447,200000,0,1,2,32,-2,-2,-2,-2,-2,-2,1100,740,4908,740,5221,740,740,4908,740,5221,740,890,0,360,-4168,4168,-4481,4481,-150,0.0018,-0.02084,0.02084,-0.022405,0.022405,-0.00075,-12
4448,50000,0,3,2,39,-1,-1,-1,0,0,0,238,-152,48257,48455,48195,48828,0,48799,1773,1711,1785,1745,0,238,-48951,46484,46744,46410,47083,0.00476,-0.97902,0.92968,0.93488,0.9282,0.94166,-3
4449,20000,0,1,2,23,2,2,0,0,0,0,15077,15534,16540,17267,17475,17838,1000,1273,1000,631,650,803,0,14077,14261,15540,16636,16825,17035,0.70385,0.71305,0.777,0.8318,0.84125,0.85175,4
4450,340000,1,1,2,47,0,0,0,0,0,0,326065,339260,332032,280450,282510,281197,20070,12747,9582,20070,18092,20102,0,305995,326513,322450,260380,264418,261095,0.899985294117647,0.9603323529411765,0.9483823529411765,0.7658235294117647,0.7777,0.7679264705882353,0
4451,210000,0,1,1,35,-1,-1,-1,-1,-2,-1,205,0,775,0,0,635,0,775,0,0,635,0,1,205,-775,775,0,-635,635,0.0009761904761904762,-0.0036904761904761906,0.0036904761904761906,0.0,-0.0030238095238095237,0.0030238095238095237,-7
4452,100000,0,3,2,26,2,0,0,0,0,0,107643,109895,93420,73119,73642,71579,4048,3105,2700,2510,2703,2700,0,103595,106790,90720,70609,70939,68879,1.03595,1.0679,0.9072,0.70609,0.70939,0.68879,2
4453,50000,1,2,1,37,0,0,0,0,0,0,50664,49163,49811,49978,20062,20259,3000,2500,2000,1102,2000,2900,1,47664,46663,47811,48876,18062,17359,0.95328,0.93326,0.95622,0.97752,0.36124,0.34718,0
4454,210000,1,1,2,29,1,-2,-2,-2,-2,-2,0,0,0,0,0,0,0,0,0,0,0,0,0,0,0,0,0,0,0,0.0,0.0,0.0,0.0,0.0,0.0,-9
4455,230000,1,2,1,46,-2,-2,-2,-2,-2,-2,0,0,0,0,0,0,0,0,0,0,0,83,1,0,0,0,0,0,-83,0.0,0.0,0.0,0.0,0.0,-0.0003608695652173913,-12
4456,290000,1,1,1,46,0,0,0,0,0,0,6615,8494,10336,15127,19685,29275,2000,2000,5000,5000,10000,5000,1,4615,6494,5336,10127,9685,24275,0.015913793103448277,0.022393103448275862,0.0184,0.034920689655172414,0.033396551724137934,0.08370689655172414,0
4457,110000,0,1,2,29,0,0,0,0,0,0,18166,18364,19742,23886,29949,34969,3000,3500,5500,10000,6000,10000,0,15166,14864,14242,13886,23949,24969,0.13787272727272729,0.13512727272727273,0.12947272727272727,0.12623636363636365,0.2177181818181818,0.2269909090909091,0
4458,150000,1,3,1,46,0,0,0,0,0,0,38985,36466,31907,33300,34681,36060,10107,20000,10000,10000,10000,10000,1,28878,16466,21907,23300,24681,26060,0.19252,0.10977333333333333,0.14604666666666666,0.15533333333333332,0.16454,0.17373333333333332,0
4459,60000,1,3,1,42,0,0,0,0,-2,-1,29243,31093,26401,326,324,1126,3032,1454,326,324,1130,199,1,26211,29639,26075,2,-806,927,0.43685,0.49398333333333333,0.4345833333333333,3.3333333333333335e-05,-0.013433333333333334,0.01545,-3
4460,500000,0,2,1,33,-1,-1,0,-1,0,0,680,1094,1508,1862,3676,4961,1101,1100,2103,2500,2000,2000,1,-421,-6,-595,-638,1676,2961,-0.000842,-1.2e-05,-0.00119,-0.001276,0.003352,0.005922,-3
4461,50000,1,2,1,61,3,2,0,0,0,0,52659,51213,51696,50422,30145,30203,4,2346,2155,1046,1073,1246,1,52655,48867,49541,49376,29072,28957,1.0531,0.97734,0.99082,0.98752,0.58144,0.57914,5
4462,30000,1,1,2,24,2,2,0,0,0,0,23905,23244,23578,25871,26143,26724,0,2000,3000,1000,1000,3500,0,23905,21244,20578,24871,25143,23224,0.7968333333333333,0.7081333333333333,0.6859333333333333,0.8290333333333333,0.8381,0.7741333333333333,4
4463,250000,1,2,2,30,0,0,0,0,0,-1,43694,33357,44167,19806,22231,6852,15284,20087,5093,10000,6876,0,0,28410,13270,39074,9806,15355,6852,0.11364,0.05308,0.156296,0.039224,0.06142,0.027408,-1
4464,50000,1,3,2,25,0,0,0,0,0,0,27232,26777,27129,26613,26057,25924,1439,1464,1401,908,935,924,0,25793,25313,25728,25705,25122,25000,0.51586,0.50626,0.51456,0.5141,0.50244,0.5,0
4465,290000,0,2,2,30,2,2,0,0,0,2,270131,213484,197238,202680,133478,131024,0,9000,10500,17000,0,3500,0,270131,204484,186738,185680,133478,127524,0.9314862068965517,0.7051172413793103,0.6439241379310345,0.6402758620689655,0.4602689655172414,0.4397379310344828,6
4466,240000,0,2,1,33,-1,-1,-1,-1,-1,-1,8383,3470,2220,2220,3356,2220,3470,2220,2220,3356,2220,3829,1,4913,1250,0,-1136,1136,-1609,0.020470833333333334,0.005208333333333333,0.0,-0.004733333333333333,0.004733333333333333,-0.0067041666666666664,-6
4467,540000,0,4,2,49,0,0,0,0,0,0,83722,86030,82860,20879,3698,209167,3538,4380,2067,564,207019,6716,0,80184,81650,80793,20315,-203321,202451,0.1484888888888889,0.1512037037037037,0.14961666666666668,0.03762037037037037,-0.3765203703703704,0.3749092592592593,0
4468,170000,1,2,1,42,-1,-1,-1,-1,-1,-1,1085,326,326,326,326,326,326,326,326,326,326,326,1,759,0,0,0,0,0,0.004464705882352941,0.0,0.0,0.0,0.0,0.0,-6
4469,50000,0,2,2,27,2,2,0,0,0,0,43063,41932,38411,30659,30963,30505,0,1600,1712,1016,2500,0,0,43063,40332,36699,29643,28463,30505,0.86126,0.80664,0.73398,0.59286,0.56926,0.6101,4
4470,20000,0,3,2,24,0,0,0,0,2,2,13470,14748,15761,17497,17075,19777,1500,1264,2000,0,3000,0,0,11970,13484,13761,17497,14075,19777,0.5985,0.6742,0.68805,0.87485,0.70375,0.98885,4
4471,190000,0,3,1,41,0,0,0,0,0,0,30425,31419,32450,33458,34122,34833,1467,1498,1506,1170,1209,1215,1,28958,29921,30944,32288,32913,33618,0.15241052631578947,0.15747894736842105,0.16286315789473685,0.16993684210526316,0.17322631578947367,0.17693684210526317,0
4472,30000,1,2,2,25,2,0,0,0,0,0,10343,11069,12082,12473,12623,27460,1200,1201,592,500,1500,0,0,9143,9868,11490,11973,11123,27460,0.3047666666666667,0.32893333333333336,0.383,0.3991,0.3707666666666667,0.9153333333333333,2
4473,50000,0,3,2,45,0,0,0,0,-2,-2,46842,48356,41150,0,0,0,2356,2150,0,0,0,0,0,44486,46206,41150,0,0,0,0.88972,0.92412,0.823,0.0,0.0,0.0,-4
4474,20000,0,2,2,26,1,2,2,2,2,2,14437,15509,15498,14952,15983,15576,1600,535,0,1272,0,1463,0,12837,14974,15498,13680,15983,14113,0.64185,0.7487,0.7749,0.684,0.79915,0.70565,11
4475,50000,0,3,1,47,-1,0,-1,-1,0,0,2840,2522,5500,21709,21056,20061,1000,5500,21709,916,1161,1884,1,1840,-2978,-16209,20793,19895,18177,0.0368,-0.05956,-0.32418,0.41586,0.3979,0.36354,-3
4476,120000,0,2,1,34,2,2,2,2,2,2,115040,117371,119044,120086,120662,118345,6000,5600,4500,4300,0,4800,1,109040,111771,114544,115786,120662,113545,0.9086666666666666,0.931425,0.9545333333333333,0.9648833333333333,1.0055166666666666,0.9462083333333333,12
4477,230000,0,2,1,46,0,0,0,0,0,0,170354,131022,108061,87461,69221,57462,7200,3348,2510,5000,3500,6500,1,163154,127674,105551,82461,65721,50962,0.7093652173913043,0.555104347826087,0.45891739130434783,0.3585260869565217,0.28574347826086954,0.22157391304347826,0
4478,200000,1,1,2,33,0,0,0,0,0,0,196304,195766,195191,182027,139901,135720,9000,8939,8099,5000,5000,5000,0,187304,186827,187092,177027,134901,130720,0.93652,0.934135,0.93546,0.885135,0.674505,0.6536,0
4479,80000,0,1,2,46,0,0,0,0,0,0,52674,58068,28116,30656,24750,25543,9000,7000,5004,3000,4000,5000,0,43674,51068,23112,27656,20750,20543,0.545925,0.63835,0.2889,0.3457,0.259375,0.2567875,0
4480,150000,1,2,2,30,-1,0,0,0,0,0,146432,149044,148839,147746,116537,36404,5301,6112,6023,4626,1035,1046,0,141131,142932,142816,143120,115502,35358,0.9408733333333333,0.95288,0.9521066666666667,0.9541333333333334,0.7700133333333333,0.23572,-1
4481,210000,0,1,2,27,0,0,0,0,0,0,42585,43304,45622,47232,47583,53032,8000,5000,4000,3000,8000,3000,0,34585,38304,41622,44232,39583,50032,0.1646904761904762,0.1824,0.1982,0.21062857142857142,0.18849047619047618,0.23824761904761904,0
4482,200000,1,2,1,40,-2,-2,-2,-2,-2,-2,39929,32910,17965,9846,13621,10466,33000,18000,9900,13650,10500,9900,1,6929,14910,8065,-3804,3121,566,0.034645,0.07455,0.040325,-0.01902,0.015605,0.00283,-12
4483,190000,0,2,1,43,0,0,0,0,0,0,90580,72260,80337,84221,91805,100053,10000,10000,10000,9000,10000,22000,1,80580,62260,70337,75221,81805,78053,0.42410526315789476,0.3276842105263158,0.37019473684210524,0.3959,0.43055263157894735,0.41080526315789473,0
4484,140000,1,2,2,27,1,2,2,3,2,2,118013,123630,128308,125776,123659,131290,9044,8200,1000,0,9874,0,0,108969,115430,127308,125776,113785,131290,0.77835,0.8245,0.9093428571428571,0.8984,0.81275,0.9377857142857143,12
4485,290000,1,2,2,34,0,0,0,0,0,0,58481,41773,40597,38441,37454,35484,2000,2000,2000,2000,2000,2000,0,56481,39773,38597,36441,35454,33484,0.19476206896551723,0.13714827586206896,0.13309310344827585,0.12565862068965516,0.1222551724137931,0.11546206896551724,0
4486,260000,1,1,1,31,-1,0,0,0,0,2,8078,27201,27879,28420,39206,37705,20000,2000,2000,12000,0,2000,1,-11922,25201,25879,16420,39206,35705,-0.045853846153846155,0.09692692307692308,0.09953461538461539,0.06315384615384616,0.1507923076923077,0.13732692307692307,1
4487,20000,0,3,2,28,1,2,0,0,0,0,5653,5419,6365,6608,7001,7233,0,1200,350,500,500,300,0,5653,4219,6015,6108,6501,6933,0.28265,0.21095,0.30075,0.3054,0.32505,0.34665,3
4488,230000,0,2,2,39,-1,-1,-1,-1,-1,-1,326,326,326,326,326,326,652,326,326,326,326,326,0,-326,0,0,0,0,0,-0.001417391304347826,0.0,0.0,0.0,0.0,0.0,-6
4489,140000,1,1,2,30,-1,-1,-1,-1,-1,-1,4717,5329,5445,5328,6243,21030,5329,5445,5328,6243,21030,10266,0,-612,-116,117,-915,-14787,10764,-0.004371428571428571,-0.0008285714285714286,0.0008357142857142857,-0.006535714285714285,-0.10562142857142857,0.07688571428571428,-6
4490,160000,1,2,1,31,0,0,0,-1,-1,0,42781,42774,41817,749,5572,10573,2300,2300,749,5572,5573,13793,1,40481,40474,41068,-4823,-1,-3220,0.25300625,0.2529625,0.256675,-0.03014375,-6.25e-06,-0.020125,-2
4491,260000,1,1,2,31,-1,-1,-1,-1,-1,-1,597,1304,5734,24898,150,381,1306,5734,24898,3883,381,2234,0,-709,-4430,-19164,21015,-231,-1853,-0.002726923076923077,-0.017038461538461537,-0.07370769230769231,0.08082692307692307,-0.0008884615384615385,-0.007126923076923077,-6
4492,180000,1,2,2,36,1,-2,-2,-2,-2,-1,0,0,0,0,0,10970,0,0,0,0,10970,0,0,0,0,0,0,-10970,10970,0.0,0.0,0.0,0.0,-0.06094444444444445,0.06094444444444445,-8
4493,200000,1,2,1,43,-1,-1,-1,-1,-1,-1,1875,2239,316,2681,3486,2296,2239,316,2681,3486,2296,3413,1,-364,1923,-2365,-805,1190,-1117,-0.00182,0.009615,-0.011825,-0.004025,0.00595,-0.005585,-6
4494,360000,1,1,2,27,0,0,0,0,0,0,297275,307394,314534,289355,274484,247998,20000,15000,19355,10000,10000,10000,0,277275,292394,295179,279355,264484,237998,0.7702083333333334,0.8122055555555555,0.8199416666666667,0.7759861111111112,0.7346777777777778,0.6611055555555555,0
4495,740000,1,2,1,35,2,-1,-1,-1,-1,-1,960,8154,1477,15713,8988,25449,8229,1487,15754,9012,25596,7003,1,-7269,6667,-14277,6701,-16608,18446,-0.009822972972972972,0.00900945945945946,-0.019293243243243243,0.009055405405405406,-0.022443243243243243,0.024927027027027027,-3
4496,320000,1,2,1,35,0,0,0,0,0,0,158942,155925,126767,114110,109637,95850,5057,4606,5800,3375,3324,2500,1,153885,151319,120967,110735,106313,93350,0.480890625,0.472871875,0.378021875,0.346046875,0.332228125,0.29171875,0
4497,140000,0,1,2,44,-1,-1,-1,-1,-1,-1,5287,5717,7146,5930,5280,5930,5717,7146,5930,5280,5930,0,0,-430,-1429,1216,650,-650,5930,-0.0030714285714285713,-0.010207142857142857,0.008685714285714286,0.004642857142857143,-0.004642857142857143,0.04235714285714286,-6
4498,50000,1,2,2,42,0,0,0,0,0,0,48080,48062,48667,49311,24663,24854,1763,2112,1756,324,336,351,0,46317,45950,46911,48987,24327,24503,0.92634,0.919,0.93822,0.97974,0.48654,0.49006,0
4499,240000,1,3,1,40,1,-2,-1,-1,-1,-1,-55,-55,3545,1338,1075,1744,0,3600,1338,1075,1744,0,1,-55,-3655,2207,263,-669,1744,-0.00022916666666666666,-0.015229166666666667,0.009195833333333334,0.0010958333333333334,-0.0027875,0.007266666666666667,-5
4500,90000,0,2,2,34,0,0,2,0,-1,-1,77846,50281,14033,12628,20172,73512,5700,0,2000,20172,73512,3000,0,72146,50281,12033,-7544,-53340,70512,0.8016222222222222,0.5586777777777778,0.1337,-0.08382222222222223,-0.5926666666666667,0.7834666666666666,0
4501,160000,1,3,1,58,-1,-1,-1,-1,-1,-1,2034,68942,40194,942,942,942,68942,40194,942,942,942,942,1,-66908,28748,39252,0,0,0,-0.418175,0.179675,0.245325,0.0,0.0,0.0,-6
4502,240000,0,1,2,33,0,0,0,0,0,0,85603,63733,61710,50106,18874,18994,2500,3354,1800,1000,1200,2000,0,83103,60379,59910,49106,17674,16994,0.3462625,0.2515791666666667,0.249625,0.20460833333333334,0.07364166666666666,0.07080833333333333,0
4503,20000,1,1,2,25,0,0,0,0,0,0,17776,18886,19551,18964,19676,20116,1700,1300,662,1000,747,602,0,16076,17586,18889,17964,18929,19514,0.8038,0.8793,0.94445,0.8982,0.94645,0.9757,0
4504,500000,0,1,2,30,-2,-2,-2,-2,-2,-1,24349,9543,53947,84388,26154,175790,9605,54218,84839,26283,175857,4914,0,14744,-44675,-30892,58105,-149703,170876,0.029488,-0.08935,-0.061784,0.11621,-0.299406,0.341752,-11
4505,20000,1,3,2,34,1,-2,-2,-2,-2,-2,0,0,0,0,0,0,0,0,0,0,0,0,0,0,0,0,0,0,0,0.0,0.0,0.0,0.0,0.0,0.0,-9
4506,20000,0,2,1,34,0,0,0,0,0,2,9662,10673,11998,13010,13750,13389,1180,1505,1517,1257,0,900,1,8482,9168,10481,11753,13750,12489,0.4241,0.4584,0.52405,0.58765,0.6875,0.62445,2
4507,340000,1,1,2,37,-1,0,-1,0,0,0,20624,20651,16308,21065,20581,15936,8641,16400,15000,15000,10000,10000,0,11983,4251,1308,6065,10581,5936,0.03524411764705882,0.012502941176470588,0.0038470588235294118,0.017838235294117648,0.03112058823529412,0.017458823529411766,-2
4508,110000,1,1,2,25,0,0,0,0,0,0,92332,77807,75559,74371,75126,73799,2800,3703,2700,2200,1810,3000,0,89532,74104,72859,72171,73316,70799,0.8139272727272727,0.6736727272727273,0.6623545454545454,0.6561,0.6665090909090909,0.6436272727272727,0
4509,200000,1,1,2,31,-1,-1,-1,-1,-1,-1,4138,790,1230,390,390,390,790,1230,390,390,390,390,0,3348,-440,840,0,0,0,0.01674,-0.0022,0.0042,0.0,0.0,0.0,-6
4510,100000,0,1,2,30,0,0,0,0,-2,-2,96846,98364,21255,0,0,0,5055,1049,0,0,0,0,0,91791,97315,21255,0,0,0,0.91791,0.97315,0.21255,0.0,0.0,0.0,-4
4511,360000,0,1,1,38,-1,-1,-1,-1,-1,-1,7975,4062,1914,4877,2100,3602,4062,1914,4877,2100,3602,9452,1,3913,2148,-2963,2777,-1502,-5850,0.010869444444444444,0.005966666666666667,-0.008230555555555555,0.007713888888888889,-0.004172222222222222,-0.01625,-6
4512,80000,0,2,2,41,0,0,0,2,0,0,60588,61369,44810,43766,44636,93074,2505,3745,0,1571,2627,1662,0,58083,57624,44810,42195,42009,91412,0.7260375,0.7203,0.560125,0.5274375,0.5251125,1.14265,2
4513,180000,1,1,2,30,2,2,2,2,0,0,14038,16980,16915,17532,18429,20126,3500,500,1200,1500,2000,0,0,10538,16480,15715,16032,16429,20126,0.05854444444444445,0.09155555555555556,0.08730555555555555,0.08906666666666667,0.09127222222222223,0.11181111111111111,8
4514,180000,0,2,1,40,0,0,0,0,0,0,126937,109884,49475,50840,50090,48345,5000,2000,2000,2000,2000,2000,1,121937,107884,47475,48840,48090,46345,0.6774277777777777,0.5993555555555555,0.26375,0.2713333333333333,0.26716666666666666,0.2574722222222222,0
4515,110000,1,2,2,32,-1,-1,-1,0,-1,-1,2015,1403,2684,1149,715,1174,1403,2684,4,715,1174,3805,0,612,-1281,2680,434,-459,-2631,0.0055636363636363635,-0.011645454545454546,0.024363636363636365,0.003945454545454545,-0.004172727272727272,-0.023918181818181818,-5
4516,100000,0,2,2,31,1,2,2,0,0,2,36204,37412,36537,37474,38732,39234,2100,0,2000,2000,1000,0,0,34104,37412,34537,35474,37732,39234,0.34104,0.37412,0.34537,0.35474,0.37732,0.39234,7
4517,20000,1,2,2,27,0,0,0,0,0,0,14248,15703,17140,18127,18605,16351,2000,2000,1600,1030,1000,1000,0,12248,13703,15540,17097,17605,15351,0.6124,0.68515,0.777,0.85485,0.88025,0.76755,0
4518,80000,0,1,1,47,-1,-1,-1,-1,-1,-1,2001,2338,5655,1670,3096,4590,2338,5655,1676,3096,4590,5598,1,-337,-3317,3979,-1426,-1494,-1008,-0.0042125,-0.0414625,0.0497375,-0.017825,-0.018675,-0.0126,-6
4519,80000,1,1,2,25,-1,-1,-2,-2,-2,-2,1672,0,0,0,0,0,0,0,0,0,0,0,0,1672,0,0,0,0,0,0.0209,0.0,0.0,0.0,0.0,0.0,-10
4520,500000,1,2,1,37,0,0,0,0,0,0,71455,79079,73583,79481,115741,168319,10004,10104,10000,40000,10000,10000,1,61451,68975,63583,39481,105741,158319,0.122902,0.13795,0.127166,0.078962,0.211482,0.316638,0
4521,30000,1,2,1,47,0,0,0,0,0,0,30567,58722,30077,29841,20075,12250,3778,1900,1019,26,1131,1209,1,26789,56822,29058,29815,18944,11041,0.8929666666666667,1.8940666666666666,0.9686,0.9938333333333333,0.6314666666666666,0.3680333333333333,0
4522,160000,1,1,2,28,-2,2,0,0,0,0,4145,3930,5859,10299,11825,13121,0,2000,5008,3007,2000,2000,0,4145,1930,851,7292,9825,11121,0.02590625,0.0120625,0.00531875,0.045575,0.06140625,0.06950625,0
4523,20000,1,2,1,41,-1,-1,-1,-1,-1,-1,2468,1077,1140,0,7014,7696,1087,1140,0,7014,800,0,1,1381,-63,1140,-7014,6214,7696,0.06905,-0.00315,0.057,-0.3507,0.3107,0.3848,-6
4524,100000,1,1,2,48,2,2,2,2,2,0,15355,17949,18158,18365,17932,18147,3164,800,800,0,662,3000,0,12191,17149,17358,18365,17270,15147,0.12191,0.17149,0.17358,0.18365,0.1727,0.15147,10
4525,70000,0,3,2,25,1,2,0,0,0,0,69447,67209,56580,24991,16036,16667,0,4000,1500,3000,2500,5000,0,69447,63209,55080,21991,13536,11667,0.9921,0.9029857142857143,0.7868571428571428,0.31415714285714286,0.19337142857142858,0.16667142857142858,3
4526,210000,1,1,1,35,-1,-1,-2,-2,-2,-2,3805,0,0,0,0,0,0,0,0,0,0,0,1,3805,0,0,0,0,0,0.018119047619047618,0.0,0.0,0.0,0.0,0.0,-10
4527,80000,1,2,1,40,1,2,0,0,2,0,63340,53262,39422,33954,29070,27785,6,2006,4000,0,1118,3000,1,63334,51256,35422,33954,27952,24785,0.791675,0.6407,0.442775,0.424425,0.3494,0.3098125,5
4528,210000,1,2,1,43,0,0,0,0,0,0,91152,92917,90651,85295,80416,76946,3348,3381,3400,2684,2744,2892,1,87804,89536,87251,82611,77672,74054,0.4181142857142857,0.4263619047619048,0.4154809523809524,0.3933857142857143,0.3698666666666667,0.35263809523809525,0
4529,200000,1,1,2,28,0,0,0,0,2,2,58833,61991,7357,9471,8538,7685,4100,3000,3000,0,1000,0,0,54733,58991,4357,9471,7538,7685,0.273665,0.294955,0.021785,0.047355,0.03769,0.038425,4
4530,50000,1,2,1,50,0,0,0,0,0,0,32570,34713,39803,41790,44351,46194,3000,6000,3000,3500,3500,1600,1,29570,28713,36803,38290,40851,44594,0.5914,0.57426,0.73606,0.7658,0.81702,0.89188,0
4531,220000,1,2,2,38,-1,-1,-1,-1,-1,-1,22145,5529,4688,1621,8522,4149,5575,4716,1632,8559,4164,10626,0,16570,813,3056,-6938,4358,-6477,0.07531818181818181,0.0036954545454545456,0.013890909090909091,-0.03153636363636363,0.019809090909090908,-0.02944090909090909,-6
4532,230000,1,2,2,31,0,0,-2,-1,-1,0,47906,0,0,1255,80158,81775,0,0,1255,80158,3107,2857,0,47906,0,-1255,-78903,77051,78918,0.20828695652173912,0.0,-0.005456521739130435,-0.3430565217391304,0.33500434782608696,0.34312173913043476,-4
4533,20000,1,1,2,25,-2,-2,-2,-1,-1,-1,0,0,0,6000,16321,286,0,0,6000,16321,286,0,0,0,0,-6000,-10321,16035,286,0.0,0.0,-0.3,-0.51605,0.80175,0.0143,-9
4534,80000,1,2,2,22,2,0,0,0,0,0,73954,77526,99205,74016,48043,48545,5400,3451,3577,2000,1800,1800,0,68554,74075,95628,72016,46243,46745,0.856925,0.9259375,1.19535,0.9002,0.5780375,0.5843125,2
4535,90000,1,1,1,38,-1,-1,0,0,-1,-1,2346,15271,16360,41936,538,2716,15271,2000,30000,538,2716,652,1,-12925,13271,-13640,41398,-2178,2064,-0.1436111111111111,0.14745555555555556,-0.15155555555555555,0.45997777777777776,-0.0242,0.022933333333333333,-4
4536,50000,0,3,1,46,3,3,2,0,0,0,53418,52281,51173,50033,9779,9924,0,7,1104,445,400,204,1,53418,52274,50069,49588,9379,9720,1.06836,1.04548,1.00138,0.99176,0.18758,0.1944,8
4537,300000,1,1,1,40,-1,-1,-1,-1,0,0,10920,3939,10184,115184,63758,19813,3939,11082,115184,19800,0,2356,1,6981,-7143,-105000,95384,63758,17457,0.02327,-0.02381,-0.35,0.31794666666666666,0.21252666666666667,0.05819,-4
4538,30000,1,3,2,24,-1,-1,-1,-1,-1,-1,4882,14630,6323,2870,1485,3926,14630,6485,2870,1485,3926,0,0,-9748,8145,3453,1385,-2441,3926,-0.32493333333333335,0.2715,0.1151,0.04616666666666667,-0.08136666666666667,0.13086666666666666,-6
4539,60000,1,3,2,44,2,2,2,2,2,2,11847,62478,55887,70562,71322,58821,55887,0,20783,2500,0,3000,0,-44040,62478,35104,68062,71322,55821,-0.734,1.0413,0.5850666666666666,1.1343666666666667,1.1887,0.93035,12
4540,220000,0,2,1,38,0,0,0,0,0,0,147048,137560,131090,121259,117003,116902,6364,5892,5000,4369,4178,5000,1,140684,131668,126090,116890,112825,111902,0.6394727272727273,0.5984909090909091,0.5731363636363637,0.5313181818181818,0.5128409090909091,0.5086454545454545,0
4541,130000,1,2,2,23,0,0,0,-2,-2,-2,8690,9500,0,0,0,0,1000,0,0,0,0,0,0,7690,9500,0,0,0,0,0.059153846153846154,0.07307692307692308,0.0,0.0,0.0,0.0,-6
4542,200000,1,2,1,30,-1,2,-1,-1,-1,-1,1626,730,3049,700,2423,2210,233,3049,700,2423,2210,1233,1,1393,-2319,2349,-1723,213,977,0.006965,-0.011595,0.011745,-0.008615,0.001065,0.004885,-3
4543,50000,0,1,2,28,0,0,0,0,0,0,31170,20413,13738,6326,1452,1612,2005,1206,1000,600,500,1000,0,29165,19207,12738,5726,952,612,0.5833,0.38414,0.25476,0.11452,0.01904,0.01224,0
4544,220000,1,1,1,36,0,0,0,0,0,0,215979,210475,216513,196219,200117,204312,7800,9639,7123,7162,7419,7462,1,208179,200836,209390,189057,192698,196850,0.9462681818181818,0.9128909090909091,0.9517727272727273,0.85935,0.8759,0.8947727272727273,0
4545,200000,0,2,1,41,1,2,0,0,0,0,69963,67223,69167,69289,70333,70610,0,2943,2301,2374,2500,5300,1,69963,64280,66866,66915,67833,65310,0.349815,0.3214,0.33433,0.334575,0.339165,0.32655,3
4546,30000,1,3,2,38,2,0,0,2,0,0,24524,25546,28820,28538,28208,29326,1426,3700,718,1500,1500,3000,0,23098,21846,28102,27038,26708,26326,0.7699333333333334,0.7282,0.9367333333333333,0.9012666666666667,0.8902666666666667,0.8775333333333334,4
4547,50000,1,2,1,35,0,0,0,0,0,0,48658,50709,36114,23706,20166,19930,3000,2000,3005,700,1000,1000,1,45658,48709,33109,23006,19166,18930,0.91316,0.97418,0.66218,0.46012,0.38332,0.3786,0
4548,110000,1,1,2,31,2,2,2,2,2,2,91773,93892,94652,97097,98097,100361,4550,3150,4900,3500,4000,3900,0,87223,90742,89752,93597,94097,96461,0.7929363636363637,0.8249272727272727,0.8159272727272727,0.8508818181818182,0.8554272727272727,0.8769181818181818,12
4549,20000,1,2,2,30,1,2,0,0,0,0,16560,15997,17336,18345,18643,19094,0,1600,1602,900,900,636,0,16560,14397,15734,17445,17743,18458,0.828,0.71985,0.7867,0.87225,0.88715,0.9229,3
4550,150000,1,3,1,25,0,0,0,0,0,0,29823,25968,24823,22908,19325,12854,1630,7000,5000,3000,257,40825,1,28193,18968,19823,19908,19068,-27971,0.18795333333333333,0.12645333333333333,0.13215333333333334,0.13272,0.12712,-0.18647333333333332,0
4551,50000,0,1,2,23,0,0,0,0,0,0,20655,21718,22316,22762,20231,19445,1701,1299,745,711,1000,685,0,18954,20419,21571,22051,19231,18760,0.37908,0.40838,0.43142,0.44102,0.38462,0.3752,0
4552,150000,1,1,2,52,0,0,0,0,0,0,126810,58955,29332,36796,19912,23126,5000,13003,15000,11000,10000,3000,0,121810,45952,14332,25796,9912,20126,0.8120666666666667,0.30634666666666666,0.09554666666666667,0.17197333333333334,0.06608,0.13417333333333334,0
4553,50000,1,2,1,55,-1,-1,-2,-2,-2,-2,1100,0,0,0,0,0,0,0,0,0,0,0,1,1100,0,0,0,0,0,0.022,0.0,0.0,0.0,0.0,0.0,-10
4554,120000,1,1,2,24,-1,-1,-1,-1,-1,-1,2946,384,1914,390,0,780,384,1920,390,0,780,0,0,2562,-1536,1524,390,-780,780,0.02135,-0.0128,0.0127,0.00325,-0.0065,0.0065,-6
4555,20000,1,3,1,52,0,0,2,0,0,0,9410,11840,11260,11260,11260,0,2600,0,0,0,0,0,1,6810,11840,11260,11260,11260,0,0.3405,0.592,0.563,0.563,0.563,0.0,2
4556,180000,0,2,1,34,-1,-1,-1,-1,-1,-1,2927,2790,1140,2144,1180,1382,2790,1140,2144,1180,1382,2440,1,137,1650,-1004,964,-202,-1058,0.0007611111111111111,0.009166666666666667,-0.005577777777777778,0.005355555555555555,-0.0011222222222222222,-0.005877777777777778,-6
4557,210000,1,2,1,35,0,0,0,0,0,0,64740,66692,68579,70036,71706,73162,3000,3000,2600,2800,2800,2900,1,61740,63692,65979,67236,68906,70262,0.294,0.3032952380952381,0.3141857142857143,0.32017142857142855,0.32812380952380954,0.33458095238095237,0
4558,300000,1,3,2,40,-1,-1,-1,-1,-1,-1,390,390,390,390,390,390,390,390,390,390,390,390,0,0,0,0,0,0,0,0.0,0.0,0.0,0.0,0.0,0.0,-6
4559,360000,1,3,1,43,-2,-2,-2,-2,-2,-2,4435,799,1071,15584,3195,4261,805,1071,15604,3195,4269,3525,1,3630,-272,-14533,12389,-1074,736,0.010083333333333333,-0.0007555555555555555,-0.040369444444444444,0.03441388888888889,-0.0029833333333333335,0.0020444444444444447,-12
4560,180000,1,2,2,29,0,0,0,0,0,0,151652,146805,143134,136777,133938,133723,6000,7000,5000,5000,5000,4679,0,145652,139805,138134,131777,128938,129044,0.8091777777777778,0.7766944444444445,0.7674111111111112,0.7320944444444445,0.7163222222222222,0.7169111111111112,0
4561,90000,0,2,1,39,2,2,2,2,2,2,26493,30034,29268,31776,32456,31800,4000,0,3000,1500,0,2600,1,22493,30034,26268,30276,32456,29200,0.2499222222222222,0.3337111111111111,0.29186666666666666,0.3364,0.36062222222222223,0.3244444444444444,12
4562,240000,0,1,1,38,-1,-1,-1,-1,-1,-1,4890,4157,14342,11411,3006,13268,4164,14371,11411,3006,13336,0,1,726,-10214,2931,8405,-10330,13268,0.003025,-0.04255833333333333,0.0122125,0.035020833333333334,-0.043041666666666666,0.05528333333333333,-6
4563,160000,1,2,2,38,0,0,0,0,0,0,159637,155003,158156,153699,127366,117812,5580,5680,4950,4350,4300,4360,0,154057,149323,153206,149349,123066,113452,0.96285625,0.93326875,0.9575375,0.93343125,0.7691625,0.709075,0
4564,150000,1,2,1,37,0,0,0,0,0,0,119398,97435,98481,98101,97178,97249,3459,4913,3929,2390,3052,6300,1,115939,92522,94552,95711,94126,90949,0.7729266666666667,0.6168133333333333,0.6303466666666667,0.6380733333333334,0.6275066666666667,0.6063266666666667,0
4565,50000,0,3,2,54,0,0,0,0,0,0,75804,76799,78692,79543,19738,19759,2785,3068,2309,694,716,808,0,73019,73731,76383,78849,19022,18951,1.46038,1.47462,1.52766,1.57698,0.38044,0.37902,0
4566,80000,0,1,2,29,1,2,2,-2,-2,-2,49373,49812,0,0,0,0,1980,19800,0,0,0,0,0,47393,30012,0,0,0,0,0.5924125,0.37515,0.0,0.0,0.0,0.0,-1
4567,350000,1,3,1,36,0,0,2,0,0,0,255751,275156,260963,261263,255566,254941,33010,0,11021,9200,8500,8300,1,222741,275156,249942,252063,247066,246641,0.6364028571428572,0.78616,0.71412,0.72018,0.7059028571428572,0.7046885714285714,2
4568,100000,0,2,1,35,-1,-1,-1,-1,-1,-1,1131,291,291,291,291,502,291,291,291,291,502,80,1,840,0,0,0,-211,422,0.0084,0.0,0.0,0.0,-0.00211,0.00422,-6
4569,220000,0,1,1,48,2,-1,-1,-1,0,-1,1480,9202,26390,13007,7387,20018,9202,26390,13007,0,20018,14661,1,-7722,-17188,13383,13007,-12631,5357,-0.0351,-0.07812727272727273,0.06083181818181818,0.05912272727272727,-0.05741363636363636,0.02435,-2
4570,250000,1,3,3,49,1,2,2,0,0,0,260260,262132,240448,186817,185488,184091,13000,0,6672,7000,7000,9000,0,247260,262132,233776,179817,178488,175091,0.98904,1.048528,0.935104,0.719268,0.713952,0.700364,5
4571,50000,0,2,1,30,1,2,2,0,0,0,49371,50092,49029,25313,26006,27217,1800,240,1000,1100,1800,1500,1,47571,49852,48029,24213,24206,25717,0.95142,0.99704,0.96058,0.48426,0.48412,0.51434,5
4572,230000,1,1,2,31,0,0,0,-1,0,-1,33109,29830,11750,5194,15450,9368,5000,5000,15897,12000,9368,6000,0,28109,24830,-4147,-6806,6082,3368,0.12221304347826087,0.10795652173913044,-0.018030434782608695,-0.029591304347826086,0.026443478260869565,0.014643478260869565,-2
4573,110000,1,2,1,25,1,2,2,2,2,0,102884,100388,104529,81319,76549,77433,0,6000,4000,0,4000,2730,1,102884,94388,100529,81319,72549,74703,0.9353090909090909,0.8580727272727273,0.9139,0.7392636363636363,0.6595363636363636,0.6791181818181818,9
4574,110000,1,3,1,41,0,0,0,0,0,0,101316,104930,106053,108641,48519,33448,5300,4300,4800,2500,2000,2000,1,96016,100630,101253,106141,46519,31448,0.8728727272727272,0.9148181818181819,0.9204818181818182,0.9649181818181818,0.4229,0.2858909090909091,0
4575,60000,1,2,2,24,0,0,0,0,0,0,57674,59213,60764,60070,40479,39871,2500,2505,2000,3003,1500,2100,0,55174,56708,58764,57067,38979,37771,0.9195666666666666,0.9451333333333334,0.9794,0.9511166666666667,0.64965,0.6295166666666666,0
4576,80000,1,1,2,29,1,-2,-1,0,-1,-1,0,0,8061,8061,9390,4337,0,8061,0,9390,4500,0,0,0,-8061,8061,-1329,4890,4337,0.0,-0.1007625,0.1007625,-0.0166125,0.061125,0.0542125,-4
4577,80000,1,3,2,39,-1,-1,-1,-1,-1,-1,4762,6712,1814,4811,1379,6136,6734,1817,4817,1381,6137,6251,0,-1972,4895,-3003,3430,-4758,-115,-0.02465,0.0611875,-0.0375375,0.042875,-0.059475,-0.0014375,-6
4578,490000,0,1,2,30,0,0,0,0,0,0,250637,254499,254762,253583,232878,236555,11032,10000,10000,9012,10000,10000,0,239605,244499,244762,244571,222878,226555,0.48898979591836733,0.49897755102040814,0.4995142857142857,0.4991244897959184,0.4548530612244898,0.46235714285714286,0
4579,20000,0,1,2,22,0,0,0,0,0,0,16620,17446,18534,19145,19547,19947,2000,2000,1278,1000,1000,764,0,14620,15446,17256,18145,18547,19183,0.731,0.7723,0.8628,0.90725,0.92735,0.95915,0
4580,180000,1,2,1,27,1,-1,-1,-1,-1,-1,0,376,0,390,698,636,376,0,390,698,636,456,1,-376,376,-390,-308,62,180,-0.002088888888888889,0.002088888888888889,-0.0021666666666666666,-0.0017111111111111112,0.0003444444444444444,0.001,-4
4581,140000,0,1,2,31,0,0,2,0,0,2,27123,27299,17985,20225,27407,10833,25000,0,3000,7800,0,2500,0,2123,27299,14985,12425,27407,8333,0.015164285714285713,0.19499285714285713,0.10703571428571429,0.08875,0.19576428571428572,0.05952142857142857,4
4582,110000,0,2,1,51,0,0,0,0,0,0,45012,45964,46922,48140,49339,50542,2000,2000,2000,2000,2000,3000,1,43012,43964,44922,46140,47339,47542,0.3910181818181818,0.3996727272727273,0.4083818181818182,0.41945454545454547,0.43035454545454543,0.4322,0
4583,50000,1,3,1,48,0,0,0,0,0,0,47945,35712,23177,8550,6373,5848,4100,1150,1200,1000,1000,1500,1,43845,34562,21977,7550,5373,4348,0.8769,0.69124,0.43954,0.151,0.10746,0.08696,0
4584,80000,1,2,1,36,0,0,0,0,0,0,79407,66491,59040,49555,38185,32582,2491,2540,1566,1485,1258,3600,1,76916,63951,57474,48070,36927,28982,0.96145,0.7993875,0.718425,0.600875,0.4615875,0.362275,0
4585,140000,1,2,2,29,-1,-1,-1,-2,-2,-2,389,403,0,0,0,0,407,0,0,0,0,1260,0,-18,403,0,0,0,-1260,-0.00012857142857142858,0.0028785714285714287,0.0,0.0,0.0,-0.009,-9
4586,20000,1,3,1,41,0,0,0,0,0,0,8777,10461,11583,13079,14546,16149,2000,1600,2000,2000,2000,2000,1,6777,8861,9583,11079,12546,14149,0.33885,0.44305,0.47915,0.55395,0.6273,0.70745,0
4587,300000,1,2,2,31,-2,-2,-2,-2,-2,-2,188,188,585,207,0,0,188,585,207,0,0,378,0,0,-397,378,207,0,-378,0.0,-0.0013233333333333333,0.00126,0.00069,0.0,-0.00126,-12
4588,340000,1,1,2,29,0,0,0,0,0,0,132024,135687,138933,139824,142461,145269,6400,7000,5000,5200,5500,25000,0,125624,128687,133933,134624,136961,120269,0.3694823529411765,0.3784911764705882,0.39392058823529413,0.39595294117647056,0.4028264705882353,0.3537323529411765,0
4589,50000,0,2,2,30,0,0,0,0,0,0,22459,48535,49350,26499,21071,18713,26499,2248,1332,544,713,3703,0,-4040,46287,48018,25955,20358,15010,-0.0808,0.92574,0.96036,0.5191,0.40716,0.3002,0
4590,20000,0,2,2,37,2,2,2,-1,0,-1,3254,2522,0,780,390,390,2000,0,780,0,390,1680,0,1254,2522,-780,780,0,-1290,0.0627,0.1261,-0.039,0.039,0.0,-0.0645,4
4591,360000,1,1,1,33,-1,-1,-1,-1,-1,-1,50067,17607,41262,8882,17348,29216,17607,41285,8882,17348,29216,4043,1,32460,-23678,32380,-8466,-11868,25173,0.09016666666666667,-0.06577222222222222,0.08994444444444444,-0.02351666666666667,-0.032966666666666665,0.069925,-6
4592,550000,0,1,2,31,0,0,0,0,0,0,43769,38907,36111,32723,26946,26439,2018,1520,1131,1005,1107,1019,0,41751,37387,34980,31718,25839,25420,0.07591090909090908,0.06797636363636364,0.0636,0.057669090909090906,0.04698,0.04621818181818182,0
4593,20000,1,2,2,22,1,-1,2,-1,0,0,0,6594,4840,780,390,0,6594,0,780,0,0,11000,0,-6594,6594,4060,780,390,-11000,-0.3297,0.3297,0.203,0.039,0.0195,-0.55,1
4594,90000,1,1,1,36,-1,-1,-2,-2,-2,-1,9999,0,0,0,0,1980,0,0,0,0,1980,0,1,9999,0,0,0,-1980,1980,0.1111,0.0,0.0,0.0,-0.022,0.022,-9
4595,300000,1,3,1,32,0,0,0,0,0,-2,15003,14469,15200,18000,0,0,1469,1200,3000,0,0,0,1,13534,13269,12200,18000,0,0,0.04511333333333333,0.04423,0.04066666666666666,0.06,0.0,0.0,-2
4596,130000,0,2,1,43,-2,-2,-2,-1,0,0,0,0,0,96963,99004,101833,0,0,96963,3554,4435,3304,1,0,0,-96963,93409,94569,98529,0.0,0.0,-0.7458692307692307,0.7185307692307692,0.7274538461538461,0.7579153846153847,-7
4597,200000,1,2,2,38,0,0,0,0,0,0,14956,9023,4963,5418,5131,5741,5000,1155,1000,103,1000,109,0,9956,7868,3963,5315,4131,5632,0.04978,0.03934,0.019815,0.026575,0.020655,0.02816,0
4598,210000,1,1,2,26,0,0,0,0,-1,-1,9899,6000,4100,0,10790,7373,1008,1000,0,10790,7373,0,0,8891,5000,4100,-10790,3417,7373,0.04233809523809524,0.023809523809523808,0.019523809523809523,-0.05138095238095238,0.016271428571428572,0.03510952380952381,-2
4599,50000,1,2,1,28,0,0,2,2,0,0,56701,57421,54587,49571,50028,17159,5000,2000,0,1809,35082,2000,1,51701,55421,54587,47762,14946,15159,1.03402,1.10842,1.09174,0.95524,0.29892,0.30318,4
4600,210000,1,1,1,40,-2,-2,-2,-2,-2,-2,7542,-78,15611,502,781,754,0,15689,504,784,757,2005,1,7542,-15767,15107,-282,24,-1251,0.03591428571428571,-0.07508095238095239,0.07193809523809523,-0.0013428571428571428,0.00011428571428571428,-0.005957142857142857,-12
4601,330000,1,2,1,47,1,-2,-2,-1,-1,-1,0,0,0,3155,4550,1264,0,0,3155,4550,1264,813,1,0,0,-3155,-1395,3286,451,0.0,0.0,-0.009560606060606061,-0.004227272727272727,0.009957575757575757,0.0013666666666666666,-6
4602,50000,1,2,1,27,0,0,0,0,0,0,40491,41522,42725,40802,42422,47912,2003,2206,3000,3000,8000,0,1,38488,39316,39725,37802,34422,47912,0.76976,0.78632,0.7945,0.75604,0.68844,0.95824,0
4603,180000,0,1,2,29,0,0,0,0,2,2,93962,95955,98354,105327,107500,105614,3500,4000,8600,4000,0,8100,0,90462,91955,89754,101327,107500,97514,0.5025666666666667,0.5108611111111111,0.4986333333333333,0.5629277777777778,0.5972222222222222,0.5417444444444445,4
4604,150000,1,2,1,43,-2,-2,-2,-2,-2,-2,5446,6671,4839,807,28023,7613,6682,6095,807,28023,7613,4331,1,-1236,576,4032,-27216,20410,3282,-0.00824,0.00384,0.02688,-0.18144,0.13606666666666667,0.02188,-12
4605,130000,1,1,2,24,0,-1,-1,2,0,0,9920,5500,670,670,670,670,5555,670,0,0,0,0,0,4365,4830,670,670,670,670,0.033576923076923074,0.037153846153846155,0.005153846153846154,0.005153846153846154,0.005153846153846154,0.005153846153846154,0
4606,150000,1,2,1,50,0,0,0,0,0,0,145268,111500,101996,56503,38650,28775,6005,4450,3243,2000,2000,1000,1,139263,107050,98753,54503,36650,27775,0.92842,0.7136666666666667,0.6583533333333333,0.3633533333333333,0.24433333333333335,0.18516666666666667,0
4607,140000,0,3,1,53,0,0,0,0,0,0,133167,135889,81607,83927,84861,86556,5400,3000,4000,3500,3504,3500,1,127767,132889,77607,80427,81357,83056,0.9126214285714286,0.9492071428571428,0.5543357142857143,0.5744785714285714,0.5811214285714286,0.5932571428571428,0
4608,50000,1,2,1,45,0,0,0,0,0,0,47823,48468,50955,49813,49290,50603,3144,3878,3000,2500,2000,1787,1,44679,44590,47955,47313,47290,48816,0.89358,0.8918,0.9591,0.94626,0.9458,0.97632,0
4609,200000,1,1,1,39,0,0,0,0,0,0,193162,191772,174199,173102,152178,129082,7294,5443,6000,5500,5000,5000,1,185868,186329,168199,167602,147178,124082,0.92934,0.931645,0.840995,0.83801,0.73589,0.62041,0
4610,360000,0,2,1,40,-1,-1,2,-1,-1,-1,1473,3125,1473,1473,1473,1473,3125,0,1473,1473,1473,1473,1,-1652,3125,0,0,0,0,-0.004588888888888889,0.008680555555555556,0.0,0.0,0.0,0.0,-3
4611,350000,1,1,1,43,-1,-1,-1,0,-1,-1,6337,4300,16229,56929,7082,4640,4300,16229,45000,108501,4640,638,1,2037,-11929,-28771,-51572,2442,4002,0.00582,-0.034082857142857144,-0.08220285714285715,-0.14734857142857144,0.006977142857142857,0.011434285714285715,-5
4612,80000,0,2,1,33,0,0,0,0,0,0,22064,22338,23352,23301,23900,24965,1700,1700,1000,1500,2000,2000,1,20364,20638,22352,21801,21900,22965,0.25455,0.257975,0.2794,0.2725125,0.27375,0.2870625,0
4613,280000,1,1,2,30,-1,-1,-1,-1,-1,-1,8010,-11,25351,17900,3529,892,3375,25362,18684,3529,892,958,0,4635,-25373,6667,14371,2637,-66,0.016553571428571428,-0.09061785714285714,0.023810714285714286,0.051325,0.009417857142857143,-0.0002357142857142857,-6
4614,60000,0,1,2,31,2,2,2,2,2,2,61432,57751,59200,57558,52992,61325,0,4770,2250,0,50000,0,0,61432,52981,56950,57558,2992,61325,1.0238666666666667,0.8830166666666667,0.9491666666666667,0.9593,0.04986666666666666,1.0220833333333332,12
4615,200000,1,1,1,47,0,0,0,0,0,0,101986,97680,94125,89550,98565,54370,4000,3455,5000,10000,2500,2231,1,97986,94225,89125,79550,96065,52139,0.48993,0.471125,0.445625,0.39775,0.480325,0.260695,0
4616,350000,1,1,2,40,1,-2,-1,-1,-2,-2,-644,-644,5170,-1496,-2366,-2366,0,6033,1500,4,0,1500,0,-644,-6677,3670,-1500,-2366,-3866,-0.00184,-0.01907714285714286,0.010485714285714286,-0.004285714285714286,-0.00676,-0.011045714285714285,-7
4617,100000,1,2,2,29,0,0,0,-1,-1,-1,7815,11139,3708,2180,1949,717,5000,1000,2180,1949,717,39000,0,2815,10139,1528,231,1232,-38283,0.02815,0.10139,0.01528,0.00231,0.01232,-0.38283,-3
4618,260000,0,2,1,28,0,0,0,0,0,0,226244,230647,211483,153072,156149,144646,8304,10044,6000,5576,6000,6200,1,217940,220603,205483,147496,150149,138446,0.8382307692307692,0.8484730769230769,0.7903192307692307,0.5672923076923077,0.5774961538461538,0.5324846153846153,0
4619,200000,0,3,2,40,-1,-1,-1,-1,-1,-1,316,316,316,316,316,316,316,316,316,316,316,316,0,0,0,0,0,0,0,0.0,0.0,0.0,0.0,0.0,0.0,-6
4620,240000,1,2,1,27,0,0,0,0,0,0,240428,235782,129479,125584,128752,130651,7227,4486,3557,4235,3593,349,1,233201,231296,125922,121349,125159,130302,0.9716708333333334,0.9637333333333333,0.524675,0.5056208333333333,0.5214958333333334,0.542925,0
4621,50000,1,2,1,30,0,0,0,-2,-2,-2,50425,51400,0,0,0,0,2400,0,0,0,0,0,1,48025,51400,0,0,0,0,0.9605,1.028,0.0,0.0,0.0,0.0,-6
4622,70000,1,2,1,50,0,0,0,0,0,0,12857,13867,14897,15941,16376,16959,1530,1560,1600,1000,1000,2400,1,11327,12307,13297,14941,15376,14559,0.16181428571428572,0.1758142857142857,0.18995714285714285,0.21344285714285716,0.21965714285714286,0.20798571428571427,0
4623,500000,1,1,2,29,-1,0,0,0,0,0,14217,33651,33134,34571,36003,37416,20000,18000,20000,20000,20007,20007,0,-5783,15651,13134,14571,15996,17409,-0.011566,0.031302,0.026268,0.029142,0.031992,0.034818,-1
4624,130000,1,2,1,47,0,0,0,0,0,0,85317,86865,88760,35671,36977,38931,3813,4013,1274,1878,3116,0,1,81504,82852,87486,33793,33861,38931,0.6269538461538462,0.6373230769230769,0.6729692307692308,0.2599461538461538,0.2604692307692308,0.29946923076923077,0
4625,350000,1,3,1,38,-2,-2,-2,-2,-2,-2,1316,3033,2168,7951,4986,3641,3061,2181,8071,5002,3654,5820,1,-1745,852,-5903,2949,1332,-2179,-0.004985714285714286,0.0024342857142857144,-0.016865714285714286,0.008425714285714286,0.0038057142857142855,-0.006225714285714286,-12
4626,260000,0,3,1,48,0,0,0,0,0,0,154927,158848,160654,155059,141570,134143,8000,6000,7100,5300,5000,5000,1,146927,152848,153554,149759,136570,129143,0.5651038461538461,0.5878769230769231,0.5905923076923076,0.5759961538461539,0.5252692307692308,0.49670384615384616,0
4627,50000,1,2,2,24,0,0,0,0,0,0,26735,26994,28331,27138,26499,27301,1500,1798,1605,966,1247,1500,0,25235,25196,26726,26172,25252,25801,0.5047,0.50392,0.53452,0.52344,0.50504,0.51602,0
4628,200000,0,1,1,32,-1,2,-1,2,-1,-1,760,380,760,380,380,0,0,760,0,380,0,154350,1,760,-380,760,0,380,-154350,0.0038,-0.0019,0.0038,0.0,0.0019,-0.77175,0
4629,580000,1,1,1,31,0,0,0,0,0,0,484798,475282,485511,488800,500723,511905,19000,20036,20000,20000,20056,16987,1,465798,455246,465511,468800,480667,494918,0.8031,0.7849068965517242,0.8026051724137931,0.8082758620689655,0.8287362068965517,0.8533068965517241,0
4630,70000,1,2,1,41,2,3,3,3,3,2,50460,52331,53896,54426,52956,54459,3000,3000,2000,0,2500,2200,1,47460,49331,51896,54426,50456,52259,0.678,0.7047285714285715,0.7413714285714286,0.7775142857142857,0.7208,0.7465571428571428,16
4631,170000,0,3,1,47,-2,-2,-2,-2,-2,-2,1521,0,0,0,0,0,0,0,0,0,0,0,1,1521,0,0,0,0,0,0.008947058823529412,0.0,0.0,0.0,0.0,0.0,-12
4632,240000,0,1,2,29,1,-2,-2,-2,-2,-2,0,0,0,0,0,0,0,0,0,0,0,0,0,0,0,0,0,0,0,0.0,0.0,0.0,0.0,0.0,0.0,-9
4633,480000,1,3,1,41,-2,-2,-2,-2,-2,-2,14867,26665,199960,9033,19371,22593,26734,199982,9033,19371,22593,2000,1,-11867,-173317,190927,-10338,-3222,20593,-0.024722916666666667,-0.3610770833333333,0.3977645833333333,-0.0215375,-0.0067125,0.042902083333333334,-12
4634,360000,1,1,2,32,-1,-1,-1,0,0,0,13819,2148,34766,14138,14690,19792,2148,34766,2005,2190,7300,20296,0,11671,-32618,32761,11948,7390,-504,0.032419444444444445,-0.09060555555555555,0.09100277777777778,0.033188888888888886,0.020527777777777777,-0.0014,-3
4635,500000,0,1,1,51,-2,-2,-2,-2,-2,-2,10063,10166,11579,68712,26476,8974,10395,11888,88612,26476,8974,11522,1,-332,-1722,-77033,42236,17502,-2548,-0.000664,-0.003444,-0.154066,0.084472,0.035004,-0.005096,-12
4636,140000,1,1,2,33,-2,-2,-2,-2,-2,-2,1825,0,1264,0,0,1980,0,1264,0,0,1980,1351,0,1825,-1264,1264,0,-1980,629,0.013035714285714286,-0.00902857142857143,0.00902857142857143,0.0,-0.014142857142857143,0.004492857142857143,-12
4637,140000,1,1,1,41,0,0,0,0,0,0,142129,130705,99736,80445,81005,79387,15126,9064,4009,5014,5011,7006,1,127003,121641,95727,75431,75994,72381,0.9071642857142858,0.8688642857142858,0.6837642857142857,0.5387928571428572,0.5428142857142857,0.5170071428571429,0
4638,140000,0,2,1,48,0,0,0,0,0,0,131959,117153,109570,100086,76125,77720,4153,3965,3211,2772,2817,3211,1,127806,113188,106359,97314,73308,74509,0.9129,0.8084857142857143,0.7597071428571428,0.6951,0.5236285714285714,0.5322071428571429,0
4639,120000,1,2,2,26,0,0,0,-2,-2,-1,4787,6190,0,0,0,4800,1500,0,0,0,4800,0,0,3287,6190,0,0,-4800,4800,0.02739166666666667,0.051583333333333335,0.0,0.0,-0.04,0.04,-5
4640,350000,1,2,1,46,-1,-1,-1,-1,-1,-1,13000,13576,15059,13000,25300,626,13576,15059,13000,25300,626,0,1,-576,-1483,2059,-12300,24674,626,-0.0016457142857142857,-0.004237142857142857,0.005882857142857143,-0.03514285714285714,0.07049714285714286,0.0017885714285714286,-6
4641,110000,0,2,2,24,0,0,0,0,0,0,74349,70338,71796,73253,74138,75691,3101,3187,3244,2700,2748,3331,0,71248,67151,68552,70553,71390,72360,0.6477090909090909,0.6104636363636363,0.6232,0.6413909090909091,0.649,0.6578181818181819,0
4642,360000,1,2,1,37,-2,-2,-2,-2,-2,-2,0,0,0,0,474,0,0,0,0,474,0,0,1,0,0,0,-474,474,0,0.0,0.0,0.0,-0.0013166666666666667,0.0013166666666666667,0.0,-12
4643,190000,0,2,1,48,0,-1,0,0,0,0,6450,189102,189018,175871,157218,151618,189717,7779,6092,5018,6168,1218,1,-183267,181323,182926,170853,151050,150400,-0.9645631578947368,0.9543315789473684,0.9627684210526316,0.8992263157894737,0.795,0.791578947368421,-1
4644,50000,0,2,2,31,0,0,3,2,0,0,10426,14466,13952,13418,13686,13456,4231,0,0,451,456,449,0,6195,14466,13952,12967,13230,13007,0.1239,0.28932,0.27904,0.25934,0.2646,0.26014,5
4645,240000,0,1,1,53,0,0,0,0,0,0,232943,236437,133385,136654,136639,123951,9700,5000,5500,5500,5000,5000,1,223243,231437,127885,131154,131639,118951,0.9301791666666667,0.9643208333333333,0.5328541666666666,0.546475,0.5484958333333333,0.4956291666666667,0
4646,200000,0,4,2,40,2,0,0,0,0,0,58118,205712,194265,139360,82750,0,150000,7673,5000,5000,0,0,0,-91882,198039,189265,134360,82750,0,-0.45941,0.990195,0.946325,0.6718,0.41375,0.0,2
4647,260000,1,2,2,29,-2,-2,-1,0,0,-1,-5,-5,9571,7235,0,197,0,9576,29,0,197,568,0,-5,-9581,9542,7235,-197,-371,-1.923076923076923e-05,-0.03685,0.0367,0.027826923076923075,-0.0007576923076923077,-0.001426923076923077,-6
4648,10000,1,2,1,26,2,2,2,2,2,0,2742,5015,4789,6199,5951,6255,2500,0,1500,0,400,400,1,242,5015,3289,6199,5551,5855,0.0242,0.5015,0.3289,0.6199,0.5551,0.5855,10
4649,170000,1,3,1,36,0,0,0,0,0,0,85780,80568,79823,79335,79506,80252,2906,3002,3000,3000,3500,3000,1,82874,77566,76823,76335,76006,77252,0.4874941176470588,0.4562705882352941,0.4519,0.4490294117647059,0.4470941176470588,0.4544235294117647,0
4650,120000,1,1,2,26,1,-1,-1,-1,-1,-2,-93,936,0,680,0,0,1029,0,680,0,0,1381,0,-1122,936,-680,680,0,-1381,-0.00935,0.0078,-0.005666666666666667,0.005666666666666667,0.0,-0.011508333333333334,-5
4651,30000,1,2,1,45,0,0,0,0,0,0,30788,30395,27294,27216,26432,30692,1759,1762,1717,966,5739,1577,1,29029,28633,25577,26250,20693,29115,0.9676333333333333,0.9544333333333334,0.8525666666666667,0.875,0.6897666666666666,0.9705,0
4652,120000,1,2,1,37,-1,-1,-1,-1,-1,-1,396,396,396,2707,3247,396,396,396,2707,3247,396,595,1,0,0,-2311,-540,2851,-199,0.0,0.0,-0.019258333333333332,-0.0045,0.023758333333333333,-0.0016583333333333333,-6
4653,280000,1,3,1,45,0,0,0,0,0,0,50415,59538,67642,39396,26096,34104,10000,10000,36432,0,10000,28580,1,40415,49538,31210,39396,16096,5524,0.14433928571428573,0.17692142857142856,0.11146428571428571,0.1407,0.057485714285714286,0.01972857142857143,0
4654,50000,1,2,2,27,0,0,0,2,0,0,42391,44689,48172,46937,48570,50144,3000,4200,0,3000,3800,0,0,39391,40489,48172,43937,44770,50144,0.78782,0.80978,0.96344,0.87874,0.8954,1.00288,2
4655,50000,0,1,2,42,-1,-1,0,0,0,0,12751,19660,14659,14951,14195,14471,22660,1300,519,518,515,528,0,-9909,18360,14140,14433,13680,13943,-0.19818,0.3672,0.2828,0.28866,0.2736,0.27886,-2
4656,180000,0,1,2,28,0,-1,2,0,0,0,2569,2834,394,904,2514,4054,2834,0,900,2000,4000,2000,0,-265,2834,-506,-1096,-1486,2054,-0.0014722222222222222,0.015744444444444443,-0.002811111111111111,-0.0060888888888888885,-0.008255555555555556,0.011411111111111111,1
4657,160000,1,1,2,31,-1,2,-1,-1,-1,-1,1494,696,1395,898,894,2198,2,1399,903,896,2204,786,0,1492,-703,492,2,-1310,1412,0.009325,-0.00439375,0.003075,1.25e-05,-0.0081875,0.008825,-3
4658,30000,1,1,1,38,0,0,0,0,0,0,26460,27042,27617,28546,13487,8307,2000,1400,1300,700,1000,0,1,24460,25642,26317,27846,12487,8307,0.8153333333333334,0.8547333333333333,0.8772333333333333,0.9282,0.41623333333333334,0.2769,0
4659,20000,1,1,2,25,-1,-1,-1,-1,-1,-2,2650,0,855,640,0,0,0,855,640,0,0,2742,0,2650,-855,215,640,0,-2742,0.1325,-0.04275,0.01075,0.032,0.0,-0.1371,-7
4660,290000,1,1,1,39,-1,-1,-1,-1,-1,-1,264,264,264,264,264,264,264,264,264,264,264,264,1,0,0,0,0,0,0,0.0,0.0,0.0,0.0,0.0,0.0,-6
4661,150000,1,3,2,30,0,0,0,0,0,0,69235,69407,69232,71089,65793,66651,2500,3000,3067,2344,2419,2500,0,66735,66407,66165,68745,63374,64151,0.4449,0.44271333333333335,0.4411,0.4583,0.42249333333333333,0.42767333333333335,0
4662,500000,0,1,1,42,-2,-1,0,0,-2,-2,5121,29478,43892,6420,49240,6772,31305,43864,6453,49470,3723,103686,1,-26184,-14386,37439,-43050,45517,-96914,-0.052368,-0.028772,0.074878,-0.0861,0.091034,-0.193828,-7
4663,50000,0,2,1,39,1,2,2,3,2,0,26094,25376,29548,28786,28024,28772,0,4600,0,0,1200,1200,1,26094,20776,29548,28786,26824,27572,0.52188,0.41552,0.59096,0.57572,0.53648,0.55144,10
4664,200000,1,1,1,50,-1,-1,-1,0,0,-1,1662,2482,19272,22388,21105,3471,2482,19272,10004,10000,3471,13754,1,-820,-16790,9268,12388,17634,-10283,-0.0041,-0.08395,0.04634,0.06194,0.08817,-0.051415,-4
4665,160000,0,1,2,27,-1,-1,-1,-1,-1,-1,5574,3327,5958,55914,23285,29170,3353,7916,56116,23302,11580,9976,0,2221,-4589,-50158,32612,11705,19194,0.01388125,-0.02868125,-0.3134875,0.203825,0.07315625,0.1199625,-6
4666,310000,0,2,1,41,-2,-2,-2,-2,-2,-2,34682,23594,-26,5333,-56,-56,23712,0,5359,0,0,0,1,10970,23594,-5385,5333,-56,-56,0.03538709677419355,0.07610967741935484,-0.017370967741935483,0.017203225806451613,-0.00018064516129032257,-0.00018064516129032257,-12
4667,30000,1,2,2,23,-1,-1,-1,-1,-1,-1,1393,1393,1393,1543,1596,2970,1393,1393,1543,1596,2970,0,0,0,0,-150,-53,-1374,2970,0.0,0.0,-0.005,-0.0017666666666666666,-0.0458,0.099,-6
4668,240000,1,1,2,30,-1,-1,-1,-1,-1,0,3376,0,4649,1528,7378,682,0,4649,1533,7378,0,0,0,3376,-4649,3116,-5850,7378,682,0.014066666666666667,-0.019370833333333334,0.012983333333333333,-0.024375,0.030741666666666667,0.002841666666666667,-5
4669,50000,0,2,2,25,1,4,3,2,2,0,53086,51981,50805,51518,50713,51309,0,0,1800,108,2400,1926,0,53086,51981,49005,51410,48313,49383,1.06172,1.03962,0.9801,1.0282,0.96626,0.98766,12
4670,30000,1,3,1,41,2,2,2,3,2,2,26042,27127,28762,29485,28878,30699,1800,2378,1496,0,2462,0,1,24242,24749,27266,29485,26416,30699,0.8080666666666667,0.8249666666666666,0.9088666666666667,0.9828333333333333,0.8805333333333333,1.0233,13
4671,50000,0,3,2,38,0,0,0,0,0,0,50174,32012,34274,38668,40416,20355,3000,3000,5000,2000,3000,1200,0,47174,29012,29274,36668,37416,19155,0.94348,0.58024,0.58548,0.73336,0.74832,0.3831,0
4672,30000,0,2,2,24,2,-1,-1,-2,-2,-2,390,780,0,0,0,0,780,0,0,0,0,0,0,-390,780,0,0,0,0,-0.013,0.026,0.0,0.0,0.0,0.0,-6
4673,130000,0,3,1,54,-1,-1,-1,-2,-1,-1,193,2499,0,0,428,150,2520,0,0,428,150,285,1,-2327,2499,0,-428,278,-135,-0.0179,0.019223076923076923,0.0,-0.0032923076923076925,0.0021384615384615383,-0.0010384615384615384,-7
4674,50000,1,3,1,52,2,0,0,0,0,0,48970,49366,49803,49830,49539,50418,2100,2128,2079,1896,1803,1954,1,46870,47238,47724,47934,47736,48464,0.9374,0.94476,0.95448,0.95868,0.95472,0.96928,2
4675,30000,0,2,1,23,2,2,2,2,2,2,28224,29276,28635,30127,30525,29793,1800,150,2250,1000,0,700,1,26424,29126,26385,29127,30525,29093,0.8808,0.9708666666666667,0.8795,0.9709,1.0175,0.9697666666666667,12
4676,160000,1,1,1,40,-1,-1,-1,-1,-1,-1,661,2881,362,20680,7429,527,2881,362,20680,7429,527,0,1,-2220,2519,-20318,13251,6902,527,-0.013875,0.01574375,-0.1269875,0.08281875,0.0431375,0.00329375,-6
4677,200000,0,1,1,52,-2,-2,-2,-2,-2,-2,3858,2690,3410,0,0,82150,2690,3487,0,0,85900,396,1,1168,-797,3410,0,-85900,81754,0.00584,-0.003985,0.01705,0.0,-0.4295,0.40877,-12
4678,70000,0,2,1,26,0,0,0,0,0,0,64691,65259,66673,62278,64268,65264,2500,2500,2500,3000,3000,2500,1,62191,62759,64173,59278,61268,62764,0.8884428571428571,0.8965571428571428,0.9167571428571428,0.8468285714285714,0.8752571428571428,0.8966285714285714,0
4679,70000,1,1,1,38,0,0,0,2,2,2,64839,65184,69361,69836,71179,69484,2400,5700,2600,3000,0,2800,1,62439,59484,66761,66836,71179,66684,0.8919857142857143,0.8497714285714286,0.9537285714285715,0.9548,1.0168428571428572,0.9526285714285714,6
4680,170000,0,2,1,54,-1,-1,-1,-2,-2,-1,186,116,0,0,0,275,116,0,0,0,275,0,1,70,116,0,0,-275,275,0.00041176470588235296,0.0006823529411764706,0.0,0.0,-0.0016176470588235294,0.0016176470588235294,-8
4681,20000,0,2,2,30,0,0,0,2,2,2,16728,17759,19752,19155,20385,19218,1307,2300,0,1525,0,1000,0,15421,15459,19752,17630,20385,18218,0.77105,0.77295,0.9876,0.8815,1.01925,0.9109,6
4682,130000,0,3,2,53,-1,-1,-1,-2,-2,-2,7477,6519,1403,5773,2464,2108,6540,1411,5790,2571,2214,4172,0,937,5108,-4387,3202,250,-2064,0.007207692307692307,0.03929230769230769,-0.03374615384615385,0.02463076923076923,0.0019230769230769232,-0.015876923076923077,-9
4683,260000,0,3,2,35,0,0,0,0,0,0,33078,42056,43986,45879,54264,59872,10000,10000,10390,10009,10000,10000,0,23078,32056,33596,35870,44264,49872,0.08876153846153846,0.12329230769230769,0.12921538461538462,0.13796153846153847,0.17024615384615385,0.1918153846153846,0
4684,50000,1,3,1,52,0,0,0,0,0,0,41140,41599,32533,23156,23782,24386,1500,1500,1000,1000,1000,1000,1,39640,40099,31533,22156,22782,23386,0.7928,0.80198,0.63066,0.44312,0.45564,0.46772,0
4685,230000,1,3,2,42,1,-2,-1,-1,-1,-1,0,0,324,0,2600,3007,0,324,0,2600,3407,200,0,0,-324,324,-2600,-807,2807,0.0,-0.0014086956521739131,0.0014086956521739131,-0.011304347826086957,-0.003508695652173913,0.012204347826086957,-5
4686,50000,0,3,1,42,0,0,0,0,0,0,29224,23807,17623,17974,18350,18721,2000,1293,644,666,676,681,1,27224,22514,16979,17308,17674,18040,0.54448,0.45028,0.33958,0.34616,0.35348,0.3608,0
4687,140000,1,1,2,28,0,0,0,0,2,2,123662,124785,128906,137279,140419,142254,4600,6200,12000,5500,5300,0,0,119062,118585,116906,131779,135119,142254,0.8504428571428572,0.8470357142857143,0.8350428571428572,0.9412785714285714,0.9651357142857143,1.0161,4
4688,500000,1,2,1,42,0,0,-2,-2,-2,-2,149838,0,0,0,0,0,0,0,0,0,0,0,1,149838,0,0,0,0,0,0.299676,0.0,0.0,0.0,0.0,0.0,-8
4689,120000,1,4,1,41,-2,-2,-2,-2,-2,-2,0,77,-1460,-1460,-1460,-1460,77,1460,0,0,0,0,1,-77,-1383,-1460,-1460,-1460,-1460,-0.0006416666666666667,-0.011525,-0.012166666666666666,-0.012166666666666666,-0.012166666666666666,-0.012166666666666666,-12
4690,220000,0,1,2,31,0,0,0,0,0,0,163148,158197,158956,157953,157098,157099,5725,5971,5846,5887,5802,5895,0,157423,152226,153110,152066,151296,151204,0.7155590909090909,0.6919363636363637,0.6959545454545455,0.6912090909090909,0.6877090909090909,0.6872909090909091,0
4691,30000,1,1,2,24,-1,0,0,0,0,0,1991,2621,4211,4709,4805,2848,2000,2000,1000,96,0,3000,0,-9,621,3211,4613,4805,-152,-0.0003,0.0207,0.10703333333333333,0.15376666666666666,0.16016666666666668,-0.005066666666666666,-1
4692,30000,1,4,2,22,0,0,0,0,0,0,13738,10455,19869,26173,26848,27266,4000,10001,7000,1107,1000,1010,0,9738,454,12869,25066,25848,26256,0.3246,0.015133333333333334,0.42896666666666666,0.8355333333333334,0.8616,0.8752,0
4693,30000,1,2,1,34,-1,-1,2,0,0,0,411,995,579,1430,1414,1398,1000,0,1420,400,400,0,1,-589,995,-841,1030,1014,1398,-0.019633333333333332,0.033166666666666664,-0.028033333333333334,0.034333333333333334,0.0338,0.0466,0
4694,50000,1,3,1,36,0,0,0,0,0,0,44449,35238,37551,17808,13765,14038,2500,11000,600,500,502,521,1,41949,24238,36951,17308,13263,13517,0.83898,0.48476,0.73902,0.34616,0.26526,0.27034,0
4695,120000,1,2,2,29,1,-2,-2,-2,-2,-2,0,0,0,0,0,0,0,0,0,0,0,0,0,0,0,0,0,0,0,0.0,0.0,0.0,0.0,0.0,0.0,-9
4696,80000,1,3,2,28,-1,-1,-1,-2,-2,-2,4280,2800,0,0,0,0,2800,0,0,0,0,0,0,1480,2800,0,0,0,0,0.0185,0.035,0.0,0.0,0.0,0.0,-9
4697,240000,1,1,2,35,0,0,0,0,0,0,86508,86596,87475,89253,91128,127950,3583,2768,2817,2928,37950,4303,0,82925,83828,84658,86325,53178,123647,0.34552083333333333,0.34928333333333333,0.3527416666666667,0.3596875,0.221575,0.5151958333333333,0
4698,50000,1,3,2,26,0,0,0,-2,-2,-1,6450,10744,0,0,0,239,4500,0,0,0,239,3363,0,1950,10744,0,0,-239,-3124,0.039,0.21488,0.0,0.0,-0.00478,-0.06248,-5
4699,200000,0,2,2,40,0,0,0,0,0,2,16816,17852,18562,18965,24424,23883,1610,1310,713,5800,0,3000,0,15206,16542,17849,13165,24424,20883,0.07603,0.08271,0.089245,0.065825,0.12212,0.104415,2
4700,500000,1,2,2,28,-1,0,0,0,0,0,319082,0,300165,281019,44528,40325,8752,0,21420,1002,935,967,0,310330,0,278745,280017,43593,39358,0.62066,0.0,0.55749,0.560034,0.087186,0.078716,-1
4701,40000,1,2,2,23,0,0,0,2,2,6,20035,21406,24735,24050,43317,44059,2000,4000,0,20000,2000,0,0,18035,17406,24735,4050,41317,44059,0.450875,0.43515,0.618375,0.10125,1.032925,1.101475,10
4702,360000,1,2,1,47,-1,0,0,-1,-1,-1,71006,37066,49018,32760,31489,22316,36448,48833,32928,31646,22428,37984,1,34558,-11767,16090,1114,9061,-15668,0.09599444444444444,-0.03268611111111111,0.044694444444444446,0.0030944444444444444,0.025169444444444446,-0.04352222222222222,-4
4703,20000,0,1,2,42,3,2,2,3,3,3,1050,1050,1050,1050,1050,1050,0,0,0,0,0,0,0,1050,1050,1050,1050,1050,1050,0.0525,0.0525,0.0525,0.0525,0.0525,0.0525,16
4704,480000,1,2,1,37,-1,-1,-1,-1,-1,-1,5269,2217,9731,9272,2718,1498,2217,9731,9272,2718,1498,1138,1,3052,-7514,459,6554,1220,360,0.006358333333333333,-0.015654166666666667,0.00095625,0.013654166666666667,0.0025416666666666665,0.00075,-6
4705,80000,1,3,2,65,0,0,0,0,0,0,84985,84247,81619,30095,20639,7849,4000,2048,1300,1700,401,180,0,80985,82199,80319,28395,20238,7669,1.0123125,1.0274875,1.0039875,0.3549375,0.252975,0.0958625,0
4706,260000,1,1,2,50,0,0,0,0,0,0,254749,259549,258390,256252,250390,251336,11046,10004,10000,10000,10000,20000,0,243703,249545,248390,246252,240390,231336,0.9373192307692307,0.9597884615384615,0.9553461538461538,0.947123076923077,0.9245769230769231,0.8897538461538461,0
4707,360000,1,2,1,33,0,0,0,-2,-2,-2,11596,11775,0,0,0,0,1058,0,0,0,0,0,1,10538,11775,0,0,0,0,0.029272222222222224,0.03270833333333333,0.0,0.0,0.0,0.0,-6
4708,280000,0,2,1,42,0,0,0,0,0,0,148363,148432,151310,141937,144990,147911,6900,6867,5500,5500,5500,5600,1,141463,141565,145810,136437,139490,142311,0.505225,0.5055892857142857,0.52075,0.487275,0.4981785714285714,0.5082535714285714,0
4709,130000,0,2,2,28,2,2,2,2,0,0,132968,134505,135624,129959,93360,90040,6700,6200,0,3500,3238,3216,0,126268,128305,135624,126459,90122,86824,0.9712923076923077,0.9869615384615384,1.0432615384615385,0.9727615384615385,0.6932461538461538,0.667876923076923,8
4710,200000,1,1,2,32,-1,-1,-1,-1,-1,-1,326,6914,2343,23834,11000,1315,6914,2343,23834,11000,1315,1934,0,-6588,4571,-21491,12834,9685,-619,-0.03294,0.022855,-0.107455,0.06417,0.048425,-0.003095,-6
4711,210000,0,1,1,39,-1,-1,-1,-1,-2,-2,840,1665,610,0,0,0,1665,610,0,0,0,3514,1,-825,1055,610,0,0,-3514,-0.003928571428571429,0.005023809523809524,0.0029047619047619048,0.0,0.0,-0.016733333333333333,-8
4712,230000,0,2,2,31,0,0,0,0,0,0,100074,107085,115039,117144,117429,117560,9000,10000,6000,3405,3000,1286,0,91074,97085,109039,113739,114429,116274,0.3959739130434783,0.4221086956521739,0.47408260869565216,0.49451739130434785,0.4975173913043478,0.5055391304347826,0
4713,330000,1,2,2,33,1,-2,-2,-1,0,0,-271,-1648,-2437,95131,46017,46470,0,0,102680,1728,1695,2000,0,-271,-1648,-105117,93403,44322,44470,-0.0008212121212121212,-0.004993939393939394,-0.3185363636363636,0.2830393939393939,0.1343090909090909,0.13475757575757577,-4
4714,20000,1,2,1,50,0,0,2,2,2,2,10511,14913,14382,16820,16411,17287,4593,0,3000,0,1304,1000,1,5918,14913,11382,16820,15107,16287,0.2959,0.74565,0.5691,0.841,0.75535,0.81435,8
4715,130000,0,1,1,29,1,2,0,0,0,0,118723,117323,38765,33349,33463,33795,3001,3000,2000,1000,666,2000,1,115722,114323,36765,32349,32797,31795,0.8901692307692308,0.8794076923076923,0.2828076923076923,0.24883846153846154,0.2522846153846154,0.24457692307692308,3
4716,160000,1,1,1,30,-1,-1,-1,0,-1,-1,960,3597,3633,2707,6087,4852,3597,3633,2702,6087,4852,9425,1,-2637,-36,931,-3380,1235,-4573,-0.01648125,-0.000225,0.00581875,-0.021125,0.00771875,-0.02858125,-5
4717,50000,1,2,2,29,0,0,0,0,0,0,24399,23495,22611,14174,10809,9004,4000,5000,4000,3000,1000,3000,0,20399,18495,18611,11174,9809,6004,0.40798,0.3699,0.37222,0.22348,0.19618,0.12008,0
4718,30000,0,2,1,25,0,0,0,0,0,0,11355,12670,13383,14699,14688,16749,1512,1225,1541,530,2302,0,1,9843,11445,11842,14169,12386,16749,0.3281,0.3815,0.3947333333333333,0.4723,0.41286666666666666,0.5583,0
4719,270000,0,2,2,35,0,0,0,-1,-1,-1,225400,220202,215056,10506,10224,9233,9000,9348,10600,10300,9300,1000,0,216400,210854,204456,206,924,8233,0.8014814814814815,0.7809407407407407,0.7572444444444445,0.000762962962962963,0.0034222222222222223,0.030492592592592592,-3
4720,20000,0,2,1,35,0,0,0,0,0,-1,17584,19819,11280,3680,4480,1650,3013,1005,1000,3000,1650,0,1,14571,18814,10280,680,2830,1650,0.72855,0.9407,0.514,0.034,0.1415,0.0825,-1
4721,20000,0,2,1,48,0,0,0,0,-2,-2,18401,19784,20650,0,0,0,2000,1650,0,0,0,0,1,16401,18134,20650,0,0,0,0.82005,0.9067,1.0325,0.0,0.0,0.0,-4
4722,120000,1,2,2,30,0,0,0,0,0,0,110612,114323,116835,118053,119047,119641,5555,5847,5800,4445,4700,4500,0,105057,108476,111035,113608,114347,115141,0.875475,0.9039666666666667,0.9252916666666666,0.9467333333333333,0.9528916666666667,0.9595083333333333,0
4723,210000,1,2,1,45,0,0,0,0,0,0,209495,213691,214177,192223,125412,113281,8000,10730,7100,4052,4000,3300,1,201495,202961,207077,188171,121412,109981,0.9595,0.9664809523809523,0.9860809523809524,0.8960523809523809,0.578152380952381,0.5237190476190476,0
4724,290000,0,1,1,37,-2,-2,-2,-2,-2,-2,-17,3465,10069,4225,-4,871,3482,10194,4276,0,875,3852,1,-3499,-6729,5793,4225,-879,-2981,-0.01206551724137931,-0.023203448275862067,0.019975862068965518,0.01456896551724138,-0.0030310344827586206,-0.010279310344827586,-12
4725,160000,0,3,1,61,-1,-1,-1,-1,0,-1,390,390,390,780,390,390,390,390,780,0,390,390,1,0,0,-390,780,0,0,0.0,0.0,-0.0024375,0.004875,0.0,0.0,-5
4726,10000,0,3,1,46,0,0,0,0,0,-2,7170,8240,8050,10400,0,0,1200,1000,150,0,0,0,1,5970,7240,7900,10400,0,0,0.597,0.724,0.79,1.04,0.0,0.0,-2
4727,20000,0,2,1,40,1,2,0,0,0,2,8201,8912,10110,10817,11637,11307,1000,1500,1180,1000,0,1000,1,7201,7412,8930,9817,11637,10307,0.36005,0.3706,0.4465,0.49085,0.58185,0.51535,5
4728,20000,0,1,2,22,-1,0,0,0,0,0,7268,12946,8811,9638,11740,11047,11500,6074,9000,5000,6047,1000,0,-4232,6872,-189,4638,5693,10047,-0.2116,0.3436,-0.00945,0.2319,0.28465,0.50235,-1
4729,220000,1,1,1,43,-1,-1,-1,-1,-1,-1,4009,1689,12370,12095,1832,4691,1689,12373,12099,1832,5001,10311,1,2320,-10684,271,10263,-3169,-5620,0.010545454545454545,-0.048563636363636364,0.0012318181818181818,0.04665,-0.014404545454545455,-0.025545454545454545,-6
4730,360000,0,1,1,39,1,-2,-2,-2,-1,-1,0,0,0,0,691,7020,0,0,0,691,7020,0,1,0,0,0,-691,-6329,7020,0.0,0.0,0.0,-0.0019194444444444445,-0.017580555555555554,0.0195,-7
4731,80000,1,3,1,28,0,0,0,0,0,0,72561,62691,61652,54602,50011,49701,2300,2809,2104,1708,1768,1807,1,70261,59882,59548,52894,48243,47894,0.8782625,0.748525,0.74435,0.661175,0.6030375,0.598675,0
4732,20000,1,2,2,22,2,0,0,2,3,2,6655,9711,12450,13949,13437,13082,3200,2900,2000,0,0,4600,0,3455,6811,10450,13949,13437,8482,0.17275,0.34055,0.5225,0.69745,0.67185,0.4241,9
4733,100000,1,1,1,35,2,0,0,2,2,2,47253,49489,53034,53568,54563,56013,3000,5000,2000,2000,2500,2300,1,44253,44489,51034,51568,52063,53713,0.44253,0.44489,0.51034,0.51568,0.52063,0.53713,8
4734,80000,1,3,1,32,0,0,0,0,0,0,58091,58247,59495,58832,57677,58066,2700,2800,2100,2181,2500,2300,1,55391,55447,57395,56651,55177,55766,0.6923875,0.6930875,0.7174375,0.7081375,0.6897125,0.697075,0
4735,240000,0,2,1,31,0,0,0,0,0,0,230234,224376,230666,219162,189589,193546,8200,10000,8000,10000,6531,5543,1,222034,214376,222666,209162,183058,188003,0.9251416666666666,0.8932333333333333,0.927775,0.8715083333333333,0.7627416666666667,0.7833458333333333,0
4736,60000,1,2,2,27,0,-1,-1,0,0,0,7301,11482,39511,39654,38168,36526,11512,39511,1866,1400,2000,1300,0,-4211,-28029,37645,38254,36168,35226,-0.07018333333333333,-0.46715,0.6274166666666666,0.6375666666666666,0.6028,0.5871,-2
4737,200000,1,3,1,50,0,0,0,0,0,0,162296,169288,168430,100175,95267,87086,13000,6900,4200,3000,3200,6000,1,149296,162388,164230,97175,92067,81086,0.74648,0.81194,0.82115,0.485875,0.460335,0.40543,0
4738,20000,1,3,3,41,-2,-2,-2,-2,-2,-2,2795,198,2310,973,406,1317,941,3637,973,406,2228,1923,0,1854,-3439,1337,567,-1822,-606,0.0927,-0.17195,0.06685,0.02835,-0.0911,-0.0303,-12
4739,340000,1,2,2,25,1,-2,-2,-1,-1,-1,0,0,0,1888,4777,4752,0,0,1888,4777,4752,1888,0,0,0,-1888,-2889,25,2864,0.0,0.0,-0.005552941176470589,-0.008497058823529411,7.352941176470588e-05,0.008423529411764706,-6
4740,50000,1,2,2,23,0,0,0,0,0,-1,21699,33109,32856,27438,4786,768,11877,1660,1600,624,768,173,0,9822,31449,31256,26814,4018,595,0.19644,0.62898,0.62512,0.53628,0.08036,0.0119,-1
4741,70000,1,1,2,48,0,0,0,0,0,0,62319,65102,63529,61778,42092,36751,6000,4000,3000,5000,5000,2000,0,56319,61102,60529,56778,37092,34751,0.8045571428571429,0.8728857142857143,0.8647,0.8111142857142857,0.5298857142857143,0.49644285714285713,0
4742,200000,0,2,1,49,-2,-2,-2,-2,-2,-2,390,390,390,390,386,1376,390,390,390,386,1380,5186,1,0,0,0,4,-994,-3810,0.0,0.0,0.0,2e-05,-0.00497,-0.01905,-12
4743,320000,1,1,2,29,-1,-1,-1,-1,-1,0,179226,-200,200,0,10000,210000,0,400,0,10000,200000,0,0,179226,-600,200,-10000,-190000,210000,0.56008125,-0.001875,0.000625,-0.03125,-0.59375,0.65625,-5
4744,180000,0,1,1,40,-2,-2,-2,-2,-2,-2,0,0,0,0,0,0,0,0,0,0,0,0,1,0,0,0,0,0,0,0.0,0.0,0.0,0.0,0.0,0.0,-12
4745,120000,1,2,1,40,0,0,0,0,0,0,109399,109397,36850,37739,38381,39142,3900,1700,1500,1400,1400,1500,1,105499,107697,35350,36339,36981,37642,0.8791583333333334,0.897475,0.2945833333333333,0.302825,0.308175,0.3136833333333333,0
4746,100000,0,2,2,29,0,0,-1,-1,-1,-1,51183,-1478,1261,1044,-217,522,0,4000,1044,0,2000,2000,0,51183,-5478,217,1044,-2217,-1478,0.51183,-0.05478,0.00217,0.01044,-0.02217,-0.01478,-4
4747,260000,1,1,1,35,0,0,0,0,0,0,51133,60247,63615,71839,75506,78647,10000,5000,10000,5000,5000,10000,1,41133,55247,53615,66839,70506,68647,0.15820384615384617,0.21248846153846154,0.20621153846153847,0.2570730769230769,0.2711769230769231,0.2640269230769231,0
4748,300000,1,3,2,36,-2,-2,-2,-2,-1,-1,0,3958,0,0,6536,1400,1979,0,0,6536,1400,50000,0,-1979,3958,0,-6536,5136,-48600,-0.0065966666666666665,0.013193333333333333,0.0,-0.021786666666666666,0.01712,-0.162,-10
4749,380000,0,1,2,27,-1,0,0,0,0,0,73903,66541,58665,43837,72069,61925,2924,2555,1515,37056,2413,1522,0,70979,63986,57150,6781,69656,60403,0.18678684210526317,0.1683842105263158,0.15039473684210528,0.017844736842105264,0.18330526315789475,0.15895526315789474,-1
4750,20000,0,3,1,49,-1,-1,-1,-1,-1,-1,390,678,0,780,0,378,678,0,780,0,378,0,1,-288,678,-780,780,-378,378,-0.0144,0.0339,-0.039,0.039,-0.0189,0.0189,-6
4751,110000,1,1,2,28,0,0,2,0,0,0,112953,225099,221798,111960,111636,111733,12500,0,4400,4218,4323,4550,0,100453,225099,217398,107742,107313,107183,0.9132090909090909,2.0463545454545455,1.9763454545454546,0.9794727272727273,0.9755727272727273,0.9743909090909091,2
4752,160000,1,2,1,42,-2,-2,-2,-2,-2,-2,0,0,0,0,0,0,0,0,0,0,0,0,1,0,0,0,0,0,0,0.0,0.0,0.0,0.0,0.0,0.0,-12
4753,60000,1,2,2,23,0,0,0,0,0,0,55765,56619,54636,18293,18107,18803,2600,1500,1000,1000,1000,3000,0,53165,55119,53636,17293,17107,15803,0.8860833333333333,0.91865,0.8939333333333334,0.2882166666666667,0.2851166666666667,0.26338333333333336,0
4754,170000,0,2,1,40,0,0,0,2,2,2,148211,149659,155442,162471,158294,166836,5400,8200,11400,0,10800,0,1,142811,141459,144042,162471,147494,166836,0.8400647058823529,0.8321117647058823,0.8473058823529411,0.9557117647058824,0.8676117647058823,0.9813882352941177,6
4755,300000,0,2,1,30,-1,-1,-1,-1,-1,-1,165,165,165,165,1759,1394,165,165,165,1759,1394,1790,1,0,0,0,-1594,365,-396,0.0,0.0,0.0,-0.005313333333333333,0.0012166666666666667,-0.00132,-6
4756,130000,1,1,2,23,-2,-2,-2,-2,-2,-2,0,0,0,0,0,1250,0,0,0,0,1250,0,0,0,0,0,0,-1250,1250,0.0,0.0,0.0,0.0,-0.009615384615384616,0.009615384615384616,-12
4757,210000,1,2,1,32,-1,0,0,0,2,0,164015,155235,151267,149478,145041,107495,9320,4894,3301,3,4994,116880,1,154695,150341,147966,149475,140047,-9385,0.7366428571428572,0.7159095238095238,0.7046,0.7117857142857142,0.6668904761904761,-0.04469047619047619,1
4758,80000,0,2,2,24,0,0,0,0,0,0,35926,32813,22638,18805,6058,0,5041,4238,5051,3118,0,0,0,30885,28575,17587,15687,6058,0,0.3860625,0.3571875,0.2198375,0.1960875,0.075725,0.0,0
4759,50000,1,2,1,36,0,0,0,0,0,0,46801,38296,28923,29254,29313,29661,2839,1438,1159,1035,1196,1007,1,43962,36858,27764,28219,28117,28654,0.87924,0.73716,0.55528,0.56438,0.56234,0.57308,0
4760,180000,0,3,2,44,0,0,0,0,0,0,172064,175287,119687,131725,134122,133961,8000,5018,21000,6000,6000,6000,0,164064,170269,98687,125725,128122,127961,0.9114666666666666,0.9459388888888889,0.5482611111111111,0.6984722222222223,0.7117888888888889,0.7108944444444445,0
4761,500000,0,1,2,43,-1,-1,-1,-1,-1,-1,37575,105652,51072,77094,77669,42059,107243,52090,78372,78949,42985,62793,0,-69668,53562,-27300,-1855,34684,-20734,-0.139336,0.107124,-0.0546,-0.00371,0.069368,-0.041468,-6
4762,50000,0,2,2,23,0,0,0,0,0,0,11148,13637,14959,16204,16536,17118,3000,1850,1800,900,1000,1000,0,8148,11787,13159,15304,15536,16118,0.16296,0.23574,0.26318,0.30608,0.31072,0.32236,0
4763,500000,0,1,2,31,-2,-2,-2,-2,-2,-2,26760,747,2652,-11,-213,-213,750,2676,1,0,0,0,0,26010,-1929,2651,-11,-213,-213,0.05202,-0.003858,0.005302,-2.2e-05,-0.000426,-0.000426,-12
4764,210000,1,2,2,30,0,0,0,0,0,0,21780,20974,18652,13464,109722,105573,1325,1074,1000,99000,3745,4000,0,20455,19900,17652,-85536,105977,101573,0.09740476190476191,0.09476190476190476,0.08405714285714286,-0.40731428571428574,0.504652380952381,0.4836809523809524,0
4765,50000,1,2,2,22,1,2,0,0,0,0,51798,50497,30935,14010,19110,19500,0,1663,1544,5500,390,0,0,51798,48834,29391,8510,18720,19500,1.03596,0.97668,0.58782,0.1702,0.3744,0.39,3
4766,170000,1,2,2,27,0,0,0,0,0,0,80848,83678,28461,13263,3637,4814,8000,2000,1000,1000,2000,1000,0,72848,81678,27461,12263,1637,3814,0.4285176470588235,0.48045882352941177,0.16153529411764705,0.07213529411764706,0.009629411764705883,0.02243529411764706,0
4767,490000,0,1,2,28,0,0,0,0,0,0,422483,430538,392670,390031,396687,404885,15358,15049,14500,14000,15021,10664,0,407125,415489,378170,376031,381666,394221,0.8308673469387755,0.8479367346938775,0.7717755102040816,0.7674102040816326,0.7789102040816327,0.8045326530612245,0
4768,310000,1,1,2,27,-1,-1,-1,-1,-1,-1,833,323,1083,2134,2474,2097,323,1093,2140,9201,2103,6571,0,510,-770,-1057,-7067,371,-4474,0.0016451612903225807,-0.0024838709677419356,-0.003409677419354839,-0.022796774193548388,0.001196774193548387,-0.014432258064516128,-6
4769,100000,1,2,1,22,0,0,0,0,0,0,100192,93394,43004,50196,79217,78771,3000,3000,8000,30000,3000,4000,1,97192,90394,35004,20196,76217,74771,0.97192,0.90394,0.35004,0.20196,0.76217,0.74771,0
4770,50000,0,2,1,53,0,0,0,0,0,0,47824,48954,46716,18685,19076,19466,1948,1835,669,692,707,695,1,45876,47119,46047,17993,18369,18771,0.91752,0.94238,0.92094,0.35986,0.36738,0.37542,0
4771,130000,1,2,1,33,0,-1,0,0,-1,-1,9768,8480,2420,0,682,0,8486,1001,0,682,0,0,1,1282,7479,2420,-682,682,0,0.009861538461538462,0.05753076923076923,0.018615384615384617,-0.005246153846153847,0.005246153846153847,0.0,-3
4772,180000,0,3,2,55,0,0,0,0,0,0,193095,186835,182287,159992,145387,137632,6900,7100,5659,5100,4900,4400,0,186195,179735,176628,154892,140487,133232,1.0344166666666668,0.9985277777777778,0.9812666666666666,0.8605111111111111,0.7804833333333333,0.7401777777777778,0
4773,320000,1,2,1,30,-2,-2,-2,-2,-2,-2,1031,1886,2913,-27,-27,5399,1895,2927,0,0,5426,3700,1,-864,-1041,2913,-27,-5453,1699,-0.0027,-0.003253125,0.009103125,-8.4375e-05,-0.017040625,0.005309375,-12
4774,260000,1,1,1,34,-1,-1,-1,-1,-1,-1,16426,6088,4663,3885,4414,2514,6277,4663,4140,4414,2646,7725,1,10149,1425,523,-529,1768,-5211,0.03903461538461538,0.005480769230769231,0.0020115384615384617,-0.0020346153846153847,0.0068,-0.020042307692307693,-6
4775,30000,0,2,1,47,-1,-1,0,0,0,0,778,5898,8610,8402,10878,10790,5900,3000,299,3000,608,274,1,-5122,2898,8311,5402,10270,10516,-0.17073333333333332,0.0966,0.27703333333333335,0.18006666666666668,0.3423333333333333,0.3505333333333333,-2
4776,30000,1,1,2,25,0,0,0,0,0,-2,3924,4972,5873,5993,0,0,1099,1000,120,0,0,0,0,2825,3972,5753,5993,0,0,0.09416666666666666,0.1324,0.19176666666666667,0.19976666666666668,0.0,0.0,-2
4777,20000,0,1,1,40,0,0,0,0,0,0,30832,17896,17258,18981,19496,18594,3500,1500,2000,800,800,700,1,27332,16396,15258,18181,18696,17894,1.3666,0.8198,0.7629,0.90905,0.9348,0.8947,0
4778,120000,1,2,1,34,2,2,2,2,2,2,64139,65430,63937,67290,68565,69784,2900,150,5000,2500,2500,3000,1,61239,65280,58937,64790,66065,66784,0.510325,0.544,0.49114166666666664,0.5399166666666667,0.5505416666666667,0.5565333333333333,12
4779,430000,1,1,1,48,-1,-1,-2,-2,-2,-1,9900,0,0,0,0,2299,0,0,0,0,2299,37980,1,9900,0,0,0,-2299,-35681,0.023023255813953487,0.0,0.0,0.0,-0.005346511627906976,-0.08297906976744186,-9
4780,200000,1,1,1,40,-2,-2,-2,-2,-2,-2,6549,9389,18475,1016,4934,7749,9421,14068,3,4948,7770,23918,1,-2872,-4679,18472,-3932,-2836,-16169,-0.01436,-0.023395,0.09236,-0.01966,-0.01418,-0.080845,-12
4781,80000,0,1,1,34,0,0,2,2,2,0,73839,78934,76649,81845,80021,82334,6700,0,7500,0,4200,3000,1,67139,78934,69149,81845,75821,79334,0.8392375,0.986675,0.8643625,1.0230625,0.9477625,0.991675,6
4782,50000,0,2,2,32,0,0,0,0,0,0,48536,41045,41532,18646,19183,19214,3030,2124,646,828,1097,612,0,45506,38921,40886,17818,18086,18602,0.91012,0.77842,0.81772,0.35636,0.36172,0.37204,0
4783,360000,1,2,1,39,1,-1,-1,-1,-1,-1,0,791,173,1640,287,2418,791,173,1640,287,2426,507,1,-791,618,-1467,1353,-2139,1911,-0.0021972222222222224,0.0017166666666666667,-0.004075,0.003758333333333333,-0.005941666666666666,0.005308333333333333,-4
4784,50000,1,1,2,26,-1,-1,-1,-1,-1,-1,750,0,3116,302,0,5778,0,3116,302,0,5778,200,0,750,-3116,2814,302,-5778,5578,0.015,-0.06232,0.05628,0.00604,-0.11556,0.11156,-6
4785,80000,1,2,2,31,-2,-2,-2,-2,-2,-2,4771,4771,538,15664,150,1150,4771,538,15664,150,1150,791,0,0,4233,-15126,15514,-1000,359,0.0,0.0529125,-0.189075,0.193925,-0.0125,0.0044875,-12
4786,270000,1,2,1,25,0,0,0,0,0,0,21586,239499,203867,188064,147915,139976,239104,7098,6179,5023,6090,4000,1,-217518,232401,197688,183041,141825,135976,-0.8056222222222222,0.8607444444444444,0.7321777777777778,0.6779296296296297,0.5252777777777777,0.5036148148148148,0
4787,500000,1,4,1,32,-1,-1,-1,-1,0,0,5353,5739,5578,57722,55468,55026,6081,5588,58476,1910,1974,2254,1,-728,151,-52898,55812,53494,52772,-0.001456,0.000302,-0.105796,0.111624,0.106988,0.105544,-4
4788,100000,1,3,3,43,0,0,0,0,0,0,61559,51163,43824,39619,35762,33258,2000,1606,1500,2000,1500,1000,0,59559,49557,42324,37619,34262,32258,0.59559,0.49557,0.42324,0.37619,0.34262,0.32258,0
4789,50000,0,3,1,54,0,0,0,0,0,0,47722,47080,48813,49107,18000,17538,2100,3000,2000,1200,1000,3000,1,45622,44080,46813,47907,17000,14538,0.91244,0.8816,0.93626,0.95814,0.34,0.29076,0
4790,500000,0,2,2,40,-1,-1,-1,-1,0,-1,33179,97882,48017,49403,40018,54109,99159,48276,49450,201,54379,9905,0,-65980,49606,-1433,49202,-14361,44204,-0.13196,0.099212,-0.002866,0.098404,-0.028722,0.088408,-5
4791,170000,0,2,2,42,0,0,0,0,0,0,142118,144803,133868,119956,121277,122926,7040,6165,5004,5003,5001,5009,0,135078,138638,128864,114953,116276,117917,0.7945764705882353,0.8155176470588236,0.7580235294117647,0.6761941176470588,0.6839764705882353,0.6936294117647058,0
4792,320000,1,1,2,25,0,0,0,0,0,0,179893,183466,187397,187999,191388,40940,6558,7254,4308,4274,1296,1017,0,173335,176212,183089,183725,190092,39923,0.541671875,0.5506625,0.572153125,0.574140625,0.5940375,0.124759375,0
4793,120000,1,2,1,41,2,0,0,0,0,2,36850,40232,41256,44063,46686,48768,4000,2000,3500,3500,3000,0,1,32850,38232,37756,40563,43686,48768,0.27375,0.3186,0.3146333333333333,0.338025,0.36405,0.4064,4
4794,80000,0,3,1,45,0,0,0,0,0,0,55385,52801,50209,43323,40275,38690,2019,2031,2013,2016,2002,3000,1,53366,50770,48196,41307,38273,35690,0.667075,0.634625,0.60245,0.5163375,0.4784125,0.446125,0
4795,500000,0,2,2,30,-1,-1,-1,-1,-1,-1,869,2496,1924,976,986,1200,2507,1933,980,990,1206,1069,0,-1638,563,944,-14,-220,131,-0.003276,0.001126,0.001888,-2.8e-05,-0.00044,0.000262,-6
4796,100000,0,1,2,27,-1,2,0,0,0,0,17553,10628,5836,6746,7889,0,0,1000,2000,3323,0,0,0,17553,9628,3836,3423,7889,0,0.17553,0.09628,0.03836,0.03423,0.07889,0.0,1
4797,140000,1,2,2,29,0,0,2,0,0,0,122662,123536,104817,102161,85512,83028,6504,4000,4500,3500,4000,3500,0,116158,119536,100317,98661,81512,79528,0.8297,0.8538285714285714,0.71655,0.7047214285714286,0.5822285714285714,0.5680571428571428,2
4798,250000,1,2,2,24,-1,-1,-1,0,0,-1,956,1339,2617,1817,975,1141,1339,2617,0,0,1141,1720,0,-383,-1278,2617,1817,-166,-579,-0.001532,-0.005112,0.010468,0.007268,-0.000664,-0.002316,-4
4799,440000,1,2,1,41,0,0,0,0,0,0,348397,356586,366049,262697,267922,274502,14006,19077,9518,9576,11083,12010,1,334391,337509,356531,253121,256839,262492,0.7599795454545455,0.7670659090909091,0.8102977272727273,0.575275,0.583725,0.5965727272727273,0
4800,120000,1,1,2,25,0,0,-1,0,0,-1,8676,10599,5814,4426,3038,5184,5000,5814,0,0,5184,7048,0,3676,4785,5814,4426,-2146,-1864,0.030633333333333332,0.039875,0.04845,0.03688333333333333,-0.017883333333333334,-0.015533333333333333,-2
4801,430000,1,2,2,33,0,0,0,0,0,0,191520,185187,173041,147383,135848,133591,8266,7666,6590,4711,4746,4421,0,183254,177521,166451,142672,131102,129170,0.4261720930232558,0.41283953488372094,0.3870953488372093,0.3317953488372093,0.3048883720930233,0.3003953488372093,0
4802,330000,0,1,1,46,-1,-1,-1,-1,0,0,7401,4567,6242,24353,20219,23163,4567,6443,24353,10219,13163,5909,1,2834,-1876,-18111,14134,7056,17254,0.008587878787878788,-0.0056848484848484844,-0.054881818181818184,0.04283030303030303,0.021381818181818182,0.05228484848484848,-4
4803,80000,0,2,2,30,2,2,2,0,0,2,72183,81844,78743,79176,81574,78445,10895,0,2900,6355,0,3100,0,61288,81844,75843,72821,81574,75345,0.7661,1.02305,0.9480375,0.9102625,1.019675,0.9418125,8
4804,20000,0,2,2,23,0,0,0,0,0,0,18963,19904,18038,19032,17372,17893,1300,1400,1300,700,800,1000,0,17663,18504,16738,18332,16572,16893,0.88315,0.9252,0.8369,0.9166,0.8286,0.84465,0
4805,80000,1,2,2,24,2,2,3,2,3,2,75444,80025,78129,82581,81053,79133,6400,0,6300,0,0,5000,0,69044,80025,71829,82581,81053,74133,0.86305,1.0003125,0.8978625,1.0322625,1.0131625,0.9266625,14
4806,250000,1,2,1,29,2,2,2,0,0,2,128413,124320,108995,84196,95286,93613,5300,0,3100,12500,0,2100,1,123113,124320,105895,71696,95286,91513,0.492452,0.49728,0.42358,0.286784,0.381144,0.366052,8
4807,50000,1,2,2,33,0,0,0,0,0,0,26740,12498,16264,17918,16072,17041,2000,4000,2000,1000,2000,2396,0,24740,8498,14264,16918,14072,14645,0.4948,0.16996,0.28528,0.33836,0.28144,0.2929,0
4808,50000,1,2,1,33,1,2,0,0,-2,-2,7642,3273,4166,0,0,0,0,1000,0,0,0,0,1,7642,2273,4166,0,0,0,0.15284,0.04546,0.08332,0.0,0.0,0.0,-1
4809,30000,0,3,1,44,0,0,0,0,0,0,10056,11387,12192,12986,13775,14393,1500,1300,1000,1000,1000,1000,1,8556,10087,11192,11986,12775,13393,0.2852,0.33623333333333333,0.37306666666666666,0.39953333333333335,0.42583333333333334,0.44643333333333335,0
4810,140000,0,1,1,43,0,0,0,0,0,0,100021,95122,84315,70871,70923,64202,4535,2856,2503,2378,3014,2048,1,95486,92266,81812,68493,67909,62154,0.6820428571428572,0.6590428571428572,0.5843714285714285,0.4892357142857143,0.4850642857142857,0.4439571428571429,0
4811,20000,0,2,2,43,1,2,0,0,0,0,20251,19637,19539,20080,18855,20130,0,2000,841,696,1600,0,0,20251,17637,18698,19384,17255,20130,1.01255,0.88185,0.9349,0.9692,0.86275,1.0065,3
4812,180000,0,2,1,34,-1,-1,-1,-1,-1,-1,1341,4185,291,570,2260,1583,4185,291,570,2260,1583,3974,1,-2844,3894,-279,-1690,677,-2391,-0.0158,0.021633333333333334,-0.00155,-0.00938888888888889,0.003761111111111111,-0.013283333333333333,-6
4813,300000,1,1,2,27,1,-2,-2,-1,-1,-2,-2,-2,0,876,0,0,874,876,876,0,0,0,0,-876,-878,-876,876,0,0,-0.00292,-0.002926666666666667,-0.00292,0.00292,0.0,0.0,-7
4814,100000,1,2,1,38,2,2,2,0,0,2,37516,38622,37706,38148,40630,39827,2000,0,1369,3100,0,1443,1,35516,38622,36337,35048,40630,38384,0.35516,0.38622,0.36337,0.35048,0.4063,0.38384,8
4815,50000,0,3,2,26,2,0,0,2,2,2,41827,42650,45930,44891,47654,48721,1800,4000,0,3500,2000,0,0,40027,38650,45930,41391,45654,48721,0.80054,0.773,0.9186,0.82782,0.91308,0.97442,8
4816,20000,1,2,1,42,1,2,2,2,0,0,8395,8114,10293,9979,10329,10391,0,2479,0,515,377,617,1,8395,5635,10293,9464,9952,9774,0.41975,0.28175,0.51465,0.4732,0.4976,0.4887,7
4817,260000,1,2,2,41,0,0,0,0,0,0,252582,253302,254767,190432,105466,2312,9725,10617,8555,4722,2146,199485,0,242857,242685,246212,185710,103320,-197173,0.9340653846153846,0.9334038461538462,0.9469692307692308,0.7142692307692308,0.3973846153846154,-0.7583576923076923,0
4818,200000,1,1,2,34,1,-2,-2,-2,-2,-2,-2113,-2113,-2113,-2113,-2113,-2113,0,0,0,0,0,423,0,-2113,-2113,-2113,-2113,-2113,-2536,-0.010565,-0.010565,-0.010565,-0.010565,-0.010565,-0.01268,-9
4819,50000,0,1,1,48,2,2,2,2,0,0,47009,49942,50382,49162,40973,39671,4000,1500,0,1275,1377,1882,1,43009,48442,50382,47887,39596,37789,0.86018,0.96884,1.00764,0.95774,0.79192,0.75578,8
4820,80000,1,2,2,33,-2,-2,-1,-1,0,0,47867,31925,731,55541,56703,57833,1925,731,56000,2055,2070,4447,0,45942,31194,-55269,53486,54633,53386,0.574275,0.389925,-0.6908625,0.668575,0.6829125,0.667325,-6
4821,310000,0,3,1,43,-1,-1,-1,0,-1,-1,4323,650,10453,10115,600,1788,650,10453,202,1098,1788,200,1,3673,-9803,10251,9017,-1188,1588,0.011848387096774193,-0.03162258064516129,0.03306774193548387,0.02908709677419355,-0.003832258064516129,0.0051225806451612906,-5
4822,200000,1,3,1,41,1,-1,-1,-1,0,-1,0,340,0,148,148,198,340,0,148,0,198,7296,1,-340,340,-148,148,-50,-7098,-0.0017,0.0017,-0.00074,0.00074,-0.00025,-0.03549,-3
4823,160000,0,2,2,28,-1,-1,-1,-1,-1,-1,1390,550,550,550,550,550,550,550,550,550,550,550,0,840,0,0,0,0,0,0.00525,0.0,0.0,0.0,0.0,0.0,-6
4824,170000,0,1,2,37,-1,-1,-1,-1,-1,-1,4334,1343,1078,1392,1606,9955,1343,1078,1392,1606,9955,4382,0,2991,265,-314,-214,-8349,5573,0.017594117647058823,0.0015588235294117646,-0.0018470588235294117,-0.0012588235294117647,-0.049111764705882355,0.03278235294117647,-6
4825,10000,1,3,1,49,0,0,0,0,0,0,9807,9976,7538,9322,9567,9766,2114,1131,2155,1400,1354,428,1,7693,8845,5383,7922,8213,9338,0.7693,0.8845,0.5383,0.7922,0.8213,0.9338,0
4826,240000,0,1,1,49,-1,-1,-2,-1,-1,-2,511,-5,-5,561,0,0,0,0,566,0,0,517,1,511,-5,-571,561,0,-517,0.002129166666666667,-2.0833333333333333e-05,-0.0023791666666666666,0.0023375,0.0,-0.0021541666666666666,-8
4827,500000,0,2,1,44,-2,-1,-1,0,0,0,77009,92353,223085,278999,207007,66516,94064,223792,85184,4803,1189,222429,1,-17055,-131439,137901,274196,205818,-155913,-0.03411,-0.262878,0.275802,0.548392,0.411636,-0.311826,-4
4828,160000,0,2,2,43,-1,-1,0,0,0,-1,12458,7146,11529,20860,0,780,7545,5000,10000,0,780,0,0,4913,2146,1529,20860,-780,780,0.03070625,0.0134125,0.00955625,0.130375,-0.004875,0.004875,-3
4829,50000,1,2,2,23,-1,0,0,0,0,0,25622,33564,25680,13577,1148,-6,10122,10028,5000,6,0,0,0,15500,23536,20680,13571,1148,-6,0.31,0.47072,0.4136,0.27142,0.02296,-0.00012,-1
4830,500000,1,1,1,34,-2,-2,-2,-2,-2,-2,13000,13000,13000,13000,13000,13000,13000,13000,13000,13000,13000,13000,1,0,0,0,0,0,0,0.0,0.0,0.0,0.0,0.0,0.0,-12
4831,270000,1,2,1,43,-1,-1,-1,-1,-1,-1,94125,1321,806,629,686,834,1326,920,629,686,834,5112,1,92799,401,177,-57,-148,-4278,0.3437,0.001485185185185185,0.0006555555555555556,-0.0002111111111111111,-0.0005481481481481482,-0.015844444444444446,-6
4832,240000,1,2,1,42,-1,-1,-1,-1,-1,-1,1986,1323,329,9228,7776,7500,1323,329,9228,7776,7500,635,1,663,994,-8899,1452,276,6865,0.0027625,0.004141666666666667,-0.03707916666666667,0.00605,0.00115,0.028604166666666667,-6
4833,300000,0,1,1,42,0,0,0,0,0,0,23742,29184,27048,24113,21683,12680,10000,1976,1200,12689,0,11223,1,13742,27208,25848,11424,21683,1457,0.04580666666666667,0.09069333333333333,0.08616,0.03808,0.07227666666666667,0.004856666666666666,0
4834,30000,1,2,1,39,2,0,0,2,2,0,11436,12439,14911,15819,15346,16666,1500,3000,1500,0,1500,2000,1,9936,9439,13411,15819,13846,14666,0.3312,0.3146333333333333,0.44703333333333334,0.5273,0.46153333333333335,0.48886666666666667,6
4835,50000,0,2,3,35,0,0,0,0,0,0,4943,49411,48859,10076,8442,8610,45200,1285,332,306,308,173,0,-40257,48126,48527,9770,8134,8437,-0.80514,0.96252,0.97054,0.1954,0.16268,0.16874,0
4836,210000,1,2,2,39,0,0,0,0,0,0,193976,196361,200590,204494,208990,214031,7100,7400,7300,7700,8600,5816,0,186876,188961,193290,196794,200390,208215,0.8898857142857143,0.8998142857142857,0.9204285714285714,0.9371142857142857,0.9542380952380952,0.9915,0
4837,140000,1,2,2,27,0,0,0,0,0,0,124753,101551,93649,89574,90413,90596,3626,4324,3207,4000,3500,3390,0,121127,97227,90442,85574,86913,87206,0.8651928571428571,0.6944785714285714,0.6460142857142858,0.6112428571428571,0.6208071428571429,0.6229,0
4838,50000,0,2,2,28,-1,2,-1,0,0,-1,2809,187,3135,937,-3,894,0,3141,2,0,897,906,0,2809,-2954,3133,937,-900,-12,0.05618,-0.05908,0.06266,0.01874,-0.018,-0.00024,-1
4839,100000,1,3,1,43,2,2,0,0,0,0,100792,91738,88883,90710,92471,79318,0,4107,4204,4200,3071,3106,1,100792,87631,84679,86510,89400,76212,1.00792,0.87631,0.84679,0.8651,0.894,0.76212,4
4840,80000,1,3,2,57,0,0,0,0,0,0,78312,77359,76081,76526,27571,28783,3459,3500,1959,982,2000,1482,0,74853,73859,74122,75544,25571,27301,0.9356625,0.9232375,0.926525,0.9443,0.3196375,0.3412625,0
4841,200000,1,1,2,29,0,0,-1,-1,-1,0,11347,30478,7892,1961,1357,1357,25000,8082,2580,1357,0,0,0,-13653,22396,5312,604,1357,1357,-0.068265,0.11198,0.02656,0.00302,0.006785,0.006785,-3
4842,120000,0,2,2,30,0,0,0,0,0,0,98440,100802,104378,106651,108362,96168,4000,5200,5500,5000,5000,5000,0,94440,95602,98878,101651,103362,91168,0.787,0.7966833333333333,0.8239833333333333,0.8470916666666667,0.86135,0.7597333333333334,0
4843,120000,1,2,1,34,0,0,0,0,0,0,119884,105631,73143,75919,77059,78820,4545,2700,4000,3000,3000,4000,1,115339,102931,69143,72919,74059,74820,0.9611583333333333,0.8577583333333333,0.5761916666666667,0.6076583333333333,0.6171583333333334,0.6235,0
4844,20000,0,2,2,28,3,2,2,2,2,-1,150,150,150,150,150,1150,0,0,0,0,1150,0,0,150,150,150,150,-1000,1150,0.0075,0.0075,0.0075,0.0075,-0.05,0.0575,10
4845,200000,0,1,1,40,-1,-1,-1,-1,-1,-1,390,394,388,822,386,540,400,390,830,400,550,310,1,-10,4,-442,422,-164,230,-5e-05,2e-05,-0.00221,0.00211,-0.00082,0.00115,-6
4846,30000,1,1,2,27,0,0,-1,0,0,-2,1512,2458,664,1814,0,0,1000,664,1500,0,0,0,0,512,1794,-836,1814,0,0,0.017066666666666667,0.0598,-0.027866666666666668,0.06046666666666667,0.0,0.0,-3
4847,60000,1,1,2,34,0,0,0,0,0,0,55447,48270,41087,25518,26276,27012,2178,1511,1200,1300,1300,1252,0,53269,46759,39887,24218,24976,25760,0.8878166666666667,0.7793166666666667,0.6647833333333333,0.40363333333333334,0.4162666666666667,0.42933333333333334,0
4848,370000,0,2,2,39,0,0,0,0,0,0,377259,310284,278781,256794,156583,17909,15198,14177,15118,15020,10000,308000,0,362061,296107,263663,241774,146583,-290091,0.9785432432432433,0.8002891891891892,0.7126027027027027,0.6534432432432432,0.3961702702702703,-0.7840297297297297,0
4849,340000,0,1,1,42,-2,-2,-2,-2,-2,-2,6888,2913,340,2823,13045,14006,2913,340,2823,13062,14016,4513,1,3975,2573,-2483,-10239,-971,9493,0.011691176470588236,0.00756764705882353,-0.0073029411764705884,-0.030114705882352943,-0.0028558823529411764,0.027920588235294117,-12
4850,60000,0,3,3,43,0,0,0,0,0,0,70367,66657,63553,59633,55689,52778,2415,3000,2125,2007,3000,1758,0,67952,63657,61428,57626,52689,51020,1.1325333333333334,1.06095,1.0238,0.9604333333333334,0.87815,0.8503333333333334,0
4851,280000,1,1,2,29,-1,-1,-1,-1,-1,-1,3009,3437,4132,2693,659,3277,3454,4170,2703,659,3297,423,0,-445,-733,1429,2034,-2638,2854,-0.0015892857142857143,-0.0026178571428571427,0.005103571428571429,0.0072642857142857144,-0.009421428571428572,0.010192857142857142,-6
4852,200000,1,1,2,26,0,0,0,0,0,0,203025,201474,158869,145723,139960,142193,10010,10000,7000,6000,5500,6000,0,193015,191474,151869,139723,134460,136193,0.965075,0.95737,0.759345,0.698615,0.6723,0.680965,0
4853,130000,0,2,2,28,2,2,0,0,0,0,70952,69264,70184,8518,11296,6514,0,3000,2000,3000,2000,0,0,70952,66264,68184,5518,9296,6514,0.5457846153846154,0.509723076923077,0.5244923076923077,0.04244615384615385,0.07150769230769231,0.050107692307692304,4
4854,130000,0,1,2,25,1,-2,-2,-2,-2,-2,-2000,-2000,-2000,-2000,-2000,-2000,0,0,0,0,0,0,0,-2000,-2000,-2000,-2000,-2000,-2000,-0.015384615384615385,-0.015384615384615385,-0.015384615384615385,-0.015384615384615385,-0.015384615384615385,-0.015384615384615385,-9
4855,80000,0,1,2,35,0,0,0,0,-1,-1,37642,39947,43773,31830,7848,390,4000,5000,5500,7848,390,780,0,33642,34947,38273,23982,7458,-390,0.420525,0.4368375,0.4784125,0.299775,0.093225,-0.004875,-2
4856,10000,1,3,1,45,2,-1,-1,-1,-1,-2,390,390,0,780,5018,5275,390,0,780,5018,375,0,1,0,390,-780,-4238,4643,5275,0.0,0.039,-0.078,-0.4238,0.4643,0.5275,-4
4857,100000,1,3,2,54,1,2,2,2,0,0,66212,64021,66362,61417,57893,58212,0,6700,60,2200,2500,2300,0,66212,57321,66302,59217,55393,55912,0.66212,0.57321,0.66302,0.59217,0.55393,0.55912,7
4858,90000,1,2,1,43,-2,-2,-2,-2,-2,-2,7489,5798,15112,0,0,0,5833,15114,0,0,0,0,1,1656,-9316,15112,0,0,0,0.0184,-0.10351111111111111,0.16791111111111112,0.0,0.0,0.0,-12
4859,80000,1,2,2,27,0,0,0,0,0,0,80088,81371,79183,64862,58651,55230,4791,2418,2118,2066,2150,3000,0,75297,78953,77065,62796,56501,52230,0.9412125,0.9869125,0.9633125,0.78495,0.7062625,0.652875,0
4860,20000,0,2,2,24,1,2,2,0,0,2,7733,8754,8469,9481,10324,10017,1300,0,1157,1000,0,1210,0,6433,8754,7312,8481,10324,8807,0.32165,0.4377,0.3656,0.42405,0.5162,0.44035,7
4861,50000,0,2,2,26,0,0,0,0,0,0,27570,28820,29400,5124,6874,7654,2000,1200,1000,2000,1000,1979,0,25570,27620,28400,3124,5874,5675,0.5114,0.5524,0.568,0.06248,0.11748,0.1135,0
4862,190000,1,2,1,34,0,0,0,2,2,2,84031,86730,93705,91317,96079,94428,5000,9310,0,7200,0,8000,1,79031,77420,93705,84117,96079,86428,0.41595263157894735,0.4074736842105263,0.4931842105263158,0.44272105263157896,0.505678947368421,0.4548842105263158,6
4863,60000,0,1,1,49,2,0,0,0,0,0,60289,57426,25820,25793,28224,28968,1580,1500,1100,3000,1200,1100,1,58709,55926,24720,22793,27024,27868,0.9784833333333334,0.9321,0.412,0.37988333333333335,0.4504,0.4644666666666667,2
4864,150000,1,2,2,27,0,0,0,2,0,0,89302,90745,96314,87862,79936,76971,4200,8000,14,3000,4500,3000,0,85102,82745,96300,84862,75436,73971,0.5673466666666667,0.5516333333333333,0.642,0.5657466666666666,0.5029066666666666,0.49314,2
4865,30000,1,2,2,23,1,2,2,2,2,2,28850,28102,30324,27446,29329,29720,0,2700,0,2300,1000,0,0,28850,25402,30324,25146,28329,29720,0.9616666666666667,0.8467333333333333,1.0108,0.8382,0.9443,0.9906666666666667,11
4866,180000,1,3,2,24,0,0,0,0,0,0,100772,85185,77698,67459,52777,46337,3034,4031,2495,1556,1431,1293,0,97738,81154,75203,65903,51346,45044,0.5429888888888889,0.45085555555555556,0.41779444444444447,0.3661277777777778,0.28525555555555554,0.25024444444444444,0
4867,140000,1,3,1,44,1,-1,-1,-1,-1,-1,-9,900,311,7867,1031,1117,909,311,7867,1031,1117,0,1,-918,589,-7556,6836,-86,1117,-0.006557142857142857,0.004207142857142857,-0.05397142857142857,0.04882857142857143,-0.0006142857142857142,0.007978571428571429,-4
4868,50000,1,3,1,44,0,0,0,0,0,0,46363,47356,48905,49794,8820,9000,1762,2311,2200,176,180,9769,1,44601,45045,46705,49618,8640,-769,0.89202,0.9009,0.9341,0.99236,0.1728,-0.01538,0
4869,30000,1,2,2,23,-1,-1,2,-1,0,0,1434,4925,390,15736,15525,0,6021,0,15736,1000,0,0,0,-4587,4925,-15346,14736,15525,0,-0.1529,0.16416666666666666,-0.5115333333333333,0.4912,0.5175,0.0,-1
4870,500000,0,2,1,33,0,0,0,0,0,0,88832,90687,84613,89944,80339,77214,6047,5016,10055,2513,3009,14542,1,82785,85671,74558,87431,77330,62672,0.16557,0.171342,0.149116,0.174862,0.15466,0.125344,0
4871,50000,1,1,2,30,-2,-2,-2,-2,-2,-2,0,2070,0,0,0,0,2070,0,0,0,0,0,0,-2070,2070,0,0,0,0,-0.0414,0.0414,0.0,0.0,0.0,0.0,-12
4872,230000,1,1,1,36,-1,-1,-1,-1,-1,-1,1240,2078,380,2100,530,2282,2078,380,2100,530,2282,1390,1,-838,1698,-1720,1570,-1752,892,-0.003643478260869565,0.007382608695652174,-0.007478260869565217,0.006826086956521739,-0.007617391304347826,0.0038782608695652173,-6
4873,400000,1,1,2,39,-2,-2,-2,-2,-2,-2,0,0,0,0,0,0,0,0,0,0,0,0,0,0,0,0,0,0,0,0.0,0.0,0.0,0.0,0.0,0.0,-12
4874,190000,0,1,2,27,2,2,2,0,0,2,114355,124449,121093,123126,131120,134135,13500,0,5500,10000,5200,5000,0,100855,124449,115593,113126,125920,129135,0.5308157894736842,0.6549947368421053,0.6083842105263157,0.5954,0.6627368421052632,0.6796578947368421,8
4875,420000,0,1,2,33,1,2,2,-2,-2,-2,170146,9771,0,24683,23702,46093,0,20,24683,752,30002,1056,0,170146,9751,-24683,23931,-6300,45037,0.4051095238095238,0.023216666666666667,-0.05876904761904762,0.05697857142857143,-0.015,0.10723095238095239,-1
4876,260000,0,2,1,38,-1,-1,-1,-1,-1,-1,17949,5693,28669,1207,2654,1441,5722,28811,1313,2667,1447,2588,1,12227,-23118,27356,-1460,1207,-1147,0.04702692307692308,-0.08891538461538462,0.10521538461538461,-0.005615384615384615,0.004642307692307692,-0.0044115384615384615,-6
4877,80000,1,2,1,27,0,0,0,0,0,0,25424,24499,25181,5187,5524,5529,2000,2150,1000,2500,1000,1000,1,23424,22349,24181,2687,4524,4529,0.2928,0.2793625,0.3022625,0.0335875,0.05655,0.0566125,0
4878,60000,1,1,2,27,0,0,0,0,0,0,62321,61015,58160,51237,29999,28972,3000,3016,5011,1005,1000,14000,0,59321,57999,53149,50232,28999,14972,0.9886833333333334,0.96665,0.8858166666666667,0.8372,0.48331666666666667,0.24953333333333333,0
4879,50000,1,3,2,55,0,0,0,0,0,0,47860,47294,45136,29378,29750,30327,1936,3654,1038,1222,1217,946,0,45924,43640,44098,28156,28533,29381,0.91848,0.8728,0.88196,0.56312,0.57066,0.58762,0
4880,50000,0,3,2,28,0,0,0,0,0,0,48963,50381,50287,20406,20206,19690,2500,1293,839,870,940,865,0,46463,49088,49448,19536,19266,18825,0.92926,0.98176,0.98896,0.39072,0.38532,0.3765,0
4881,300000,1,1,2,28,-2,-2,-2,-2,-2,-2,0,0,0,0,0,0,0,0,0,0,0,0,0,0,0,0,0,0,0,0.0,0.0,0.0,0.0,0.0,0.0,-12
4882,160000,0,2,2,32,0,0,0,0,0,-1,38254,38919,17243,18478,3541,6459,1907,2000,2000,300,6459,3000,0,36347,36919,15243,18178,-2918,3459,0.22716875,0.23074375,0.09526875,0.1136125,-0.0182375,0.02161875,-1
4883,100000,0,1,2,30,0,0,0,0,0,0,100544,101167,101007,97862,79099,79812,4511,3711,3685,2797,2897,3046,0,96033,97456,97322,95065,76202,76766,0.96033,0.97456,0.97322,0.95065,0.76202,0.76766,0
4884,20000,0,1,1,50,0,0,-2,-2,-2,-2,9164,0,0,0,0,0,0,50000,0,1300,0,0,1,9164,-50000,0,-1300,0,0,0.4582,-2.5,0.0,-0.065,0.0,0.0,-8
4885,100000,1,2,2,24,0,0,0,0,0,0,101887,102069,100657,101565,101116,101764,4902,4507,3936,3982,4135,3676,0,96985,97562,96721,97583,96981,98088,0.96985,0.97562,0.96721,0.97583,0.96981,0.98088,0
4886,100000,1,2,1,49,0,-1,-1,-1,0,0,5532,5325,5423,29628,13252,3723,5325,5423,29628,0,0,3513,1,207,-98,-24205,29628,13252,210,0.00207,-0.00098,-0.24205,0.29628,0.13252,0.0021,-3
4887,70000,0,1,3,57,0,0,0,0,0,0,69398,70352,69936,68118,65942,62495,2667,2321,2391,2316,2466,1451,0,66731,68031,67545,65802,63476,61044,0.9533,0.9718714285714286,0.9649285714285715,0.9400285714285714,0.9068,0.8720571428571429,0
4888,80000,1,3,1,35,0,0,0,0,0,0,54986,55111,55239,54892,45862,45086,1966,2055,1720,1458,1475,1587,1,53020,53056,53519,53434,44387,43499,0.66275,0.6632,0.6689875,0.667925,0.5548375,0.5437375,0
4889,170000,1,2,1,31,1,-1,2,-1,0,0,0,427,427,23321,23475,25218,427,0,23500,840,2121,0,1,-427,427,-23073,22481,21354,25218,-0.002511764705882353,0.002511764705882353,-0.13572352941176472,0.13224117647058822,0.12561176470588234,0.14834117647058823,1
4890,360000,0,2,1,65,1,-2,-2,-2,-2,-2,0,0,0,0,0,0,0,0,0,0,0,0,1,0,0,0,0,0,0,0.0,0.0,0.0,0.0,0.0,0.0,-9
4891,30000,1,1,1,30,0,0,2,2,0,0,15199,17728,19129,18527,18758,19285,3100,2000,0,679,837,721,1,12099,15728,19129,17848,17921,18564,0.4033,0.5242666666666667,0.6376333333333334,0.5949333333333333,0.5973666666666667,0.6188,4
4892,50000,0,3,2,24,1,2,0,0,-1,-1,50645,48259,45079,30783,1727,150,0,2177,1702,2000,350,0,0,50645,46082,43377,28783,1377,150,1.0129,0.92164,0.86754,0.57566,0.02754,0.003,1
4893,200000,0,2,1,56,0,0,0,0,0,0,195456,199692,171784,175197,179069,189686,8007,6300,6276,6701,13800,0,1,187449,193392,165508,168496,165269,189686,0.937245,0.96696,0.82754,0.84248,0.826345,0.94843,0
4894,350000,1,1,2,30,-2,-2,-2,-2,-2,-2,856,187,375,187,242,184,187,376,187,243,184,828,0,669,-189,188,-56,58,-644,0.0019114285714285715,-0.00054,0.0005371428571428571,-0.00016,0.00016571428571428572,-0.00184,-12
4895,230000,1,1,2,30,1,-2,-2,-2,-2,-2,0,0,0,0,0,0,0,0,0,0,0,0,0,0,0,0,0,0,0,0.0,0.0,0.0,0.0,0.0,0.0,-9
4896,280000,0,2,1,33,0,0,0,0,0,0,207982,196055,182099,185925,188224,186529,8644,6445,15934,7016,6753,6008,1,199338,189610,166165,178909,181471,180521,0.7119214285714286,0.6771785714285714,0.5934464285714286,0.6389607142857143,0.6481107142857143,0.6447178571428571,0
4897,50000,1,3,1,47,1,3,2,2,2,5,28164,27432,28668,29191,35551,34420,0,2000,1300,7000,0,0,1,28164,25432,27368,22191,35551,34420,0.56328,0.50864,0.54736,0.44382,0.71102,0.6884,15
4898,170000,0,2,1,39,-2,-2,-2,-2,-2,-2,0,582,0,582,291,90,582,0,582,291,90,750,1,-582,582,-582,291,201,-660,-0.003423529411764706,0.003423529411764706,-0.003423529411764706,0.001711764705882353,0.0011823529411764705,-0.0038823529411764705,-12
4899,50000,1,2,2,23,0,0,0,0,-1,0,97259,50017,48560,46978,19640,18937,3608,2110,2558,19640,683,699,0,93651,47907,46002,27338,18957,18238,1.87302,0.95814,0.92004,0.54676,0.37914,0.36476,-1
4900,50000,0,2,1,47,-1,-1,-1,2,0,-1,390,390,780,780,390,390,390,780,390,0,390,0,1,0,-390,390,780,0,390,0.0,-0.0078,0.0078,0.0156,0.0,0.0078,-2
4901,230000,1,1,2,27,0,0,0,0,0,0,92167,92799,94328,96203,98474,98835,3340,3401,3420,3797,3476,2818,0,88827,89398,90908,92406,94998,96017,0.386204347826087,0.3886869565217391,0.39525217391304346,0.40176521739130433,0.41303478260869564,0.4174652173913043,0
4902,50000,1,2,1,36,0,0,0,0,0,0,26277,25371,22790,23372,22216,19586,1700,1800,1300,1000,1000,900,1,24577,23571,21490,22372,21216,18686,0.49154,0.47142,0.4298,0.44744,0.42432,0.37372,0
4903,90000,0,1,2,27,0,0,0,2,2,2,56608,57897,63686,65233,66637,67882,2800,7400,3200,2600,2500,2500,0,53808,50497,60486,62633,64137,65382,0.5978666666666667,0.5610777777777778,0.6720666666666667,0.6959222222222222,0.7126333333333333,0.7264666666666667,6
4904,200000,0,2,1,35,0,0,2,0,0,2,187487,200774,196933,187887,101278,99382,16000,0,6451,9000,0,4000,1,171487,200774,190482,178887,101278,95382,0.857435,1.00387,0.95241,0.894435,0.50639,0.47691,4
4905,270000,1,2,2,26,0,0,0,0,0,0,29951,12211,13533,14391,15255,16273,1300,1533,1391,1255,1273,1000,0,28651,10678,12142,13136,13982,15273,0.10611481481481481,0.039548148148148145,0.04497037037037037,0.04865185185185185,0.051785185185185184,0.05656666666666667,0
4906,50000,0,2,1,48,0,0,0,0,0,0,40931,40892,41612,18825,18019,18124,1880,1650,10000,1000,700,600,1,39051,39242,31612,17825,17319,17524,0.78102,0.78484,0.63224,0.3565,0.34638,0.35048,0
4907,50000,0,1,1,35,-1,-1,-1,-1,-2,-2,6290,3770,10060,0,0,0,3770,10060,0,0,0,0,1,2520,-6290,10060,0,0,0,0.0504,-0.1258,0.2012,0.0,0.0,0.0,-8
4908,100000,1,1,2,25,0,0,0,0,0,0,11801,12905,14378,14838,15447,16539,1600,2000,1000,1000,1500,0,0,10201,10905,13378,13838,13947,16539,0.10201,0.10905,0.13378,0.13838,0.13947,0.16539,0
4909,150000,1,2,2,27,0,0,0,0,0,0,143596,147891,147248,139846,142808,150770,6241,5000,4400,4500,9600,0,0,137355,142891,142848,135346,133208,150770,0.9157,0.9526066666666667,0.95232,0.9023066666666667,0.8880533333333334,1.0051333333333334,0
4910,150000,1,2,2,24,0,0,0,0,-1,-1,66731,64787,38948,24707,304,635,3000,3125,2065,307,635,0,0,63731,61662,36883,24400,-331,635,0.4248733333333333,0.41108,0.24588666666666667,0.16266666666666665,-0.0022066666666666667,0.004233333333333334,-2
4911,30000,0,2,2,36,1,2,2,2,0,0,13208,13692,14176,14642,15397,16147,1000,1000,1000,1000,1000,1000,0,12208,12692,13176,13642,14397,15147,0.4069333333333333,0.42306666666666665,0.4392,0.4547333333333333,0.4799,0.5049,7
4912,20000,0,2,2,32,2,0,0,0,0,0,18996,19316,20330,20515,20424,19996,1325,1339,1609,823,723,1705,0,17671,17977,18721,19692,19701,18291,0.88355,0.89885,0.93605,0.9846,0.98505,0.91455,2
4913,50000,0,2,2,24,1,-2,-2,-2,-2,-2,-1000,0,0,0,0,0,1000,0,0,0,2000,0,0,-2000,0,0,0,-2000,0,-0.04,0.0,0.0,0.0,-0.04,0.0,-9
4914,70000,1,2,1,27,0,0,0,0,0,0,69762,68914,69252,70415,69212,70514,2450,2600,2700,2500,2800,2500,1,67312,66314,66552,67915,66412,68014,0.9616,0.9473428571428572,0.9507428571428571,0.9702142857142857,0.9487428571428571,0.9716285714285714,0
4915,200000,1,4,2,27,1,-1,-1,-1,-1,0,777,14893,5635,7518,13226,13845,15103,5652,7529,13226,4906,4666,0,-14326,9241,-1894,-5708,8320,9179,-0.07163,0.046205,-0.00947,-0.02854,0.0416,0.045895,-3
4916,100000,0,3,2,50,0,0,0,0,0,0,95889,96791,97414,69166,53270,-1465,4200,2785,2291,1965,1465,62121,0,91689,94006,95123,67201,51805,-63586,0.91689,0.94006,0.95123,0.67201,0.51805,-0.63586,0
4917,240000,1,2,1,37,-2,-2,-2,-2,-2,-2,-150,-150,-150,-150,-150,-150,0,0,0,0,0,0,1,-150,-150,-150,-150,-150,-150,-0.000625,-0.000625,-0.000625,-0.000625,-0.000625,-0.000625,-12
4918,200000,1,1,2,30,0,0,0,0,-2,-2,199229,132458,59153,0,0,0,6101,3500,0,0,0,0,0,193128,128958,59153,0,0,0,0.96564,0.64479,0.295765,0.0,0.0,0.0,-4
4919,80000,0,1,1,41,1,-2,-2,-2,-2,-2,0,0,0,0,0,0,0,0,0,0,0,0,1,0,0,0,0,0,0,0.0,0.0,0.0,0.0,0.0,0.0,-9
4920,60000,0,3,2,25,0,0,0,0,0,0,56753,57530,59869,59942,28934,27461,2700,3869,2742,1200,1461,1504,0,54053,53661,57127,58742,27473,25957,0.9008833333333334,0.89435,0.9521166666666666,0.9790333333333333,0.4578833333333333,0.43261666666666665,0
4921,500000,0,1,1,58,-1,-1,-1,0,-1,-1,7285,28390,13138,6653,7081,4651,28730,14587,28,7114,4672,3114,1,-21445,13803,13110,-461,2409,1537,-0.04289,0.027606,0.02622,-0.000922,0.004818,0.003074,-5
4922,50000,1,1,2,23,1,-2,-2,-2,-2,-2,0,0,0,0,0,0,0,0,0,0,0,0,0,0,0,0,0,0,0,0.0,0.0,0.0,0.0,0.0,0.0,-9
4923,100000,0,3,2,30,0,0,0,0,0,0,46675,46567,46638,46454,46262,47823,1800,2000,1700,1683,3500,1500,0,44875,44567,44938,44771,42762,46323,0.44875,0.44567,0.44938,0.44771,0.42762,0.46323,0
4924,70000,1,1,1,40,0,0,0,0,0,0,51959,40519,31310,28929,29535,28160,1597,1407,972,1007,1028,913,1,50362,39112,30338,27922,28507,27247,0.7194571428571429,0.5587428571428571,0.4334,0.3988857142857143,0.40724285714285713,0.38924285714285717,0
4925,180000,0,1,1,38,0,0,0,0,0,0,181302,181271,180439,182958,181287,179734,6747,6573,6506,6581,6801,6100,1,174555,174698,173933,176377,174486,173634,0.96975,0.9705444444444444,0.9662944444444445,0.9798722222222223,0.9693666666666667,0.9646333333333333,0
4926,160000,0,1,2,41,0,0,0,0,2,2,42863,43874,44843,50072,49142,52336,2000,2000,6000,0,4200,2000,0,40863,41874,38843,50072,44942,50336,0.25539375,0.2617125,0.24276875,0.31295,0.2808875,0.3146,4
4927,60000,1,1,2,30,1,2,2,2,2,2,41259,40715,43153,43845,44795,45710,400,3406,1700,1800,1800,0,0,40859,37309,41453,42045,42995,45710,0.6809833333333334,0.6218166666666667,0.6908833333333333,0.70075,0.7165833333333333,0.7618333333333334,11
4928,80000,1,2,1,48,0,0,0,0,0,0,77627,80712,48428,52391,23359,24597,5000,5000,5000,3000,2000,3000,1,72627,75712,43428,49391,21359,21597,0.9078375,0.9464,0.54285,0.6173875,0.2669875,0.2699625,0
4929,130000,1,2,1,41,2,2,0,0,0,0,133894,130312,128653,100795,95299,86564,0,7347,4000,3450,3300,4000,1,133894,122965,124653,97345,91999,82564,1.0299538461538462,0.9458846153846154,0.9588692307692308,0.7488076923076923,0.7076846153846154,0.6351076923076923,4
4930,160000,1,2,1,40,-2,-2,-2,-2,-2,-2,0,0,0,0,0,0,0,0,0,0,0,200,1,0,0,0,0,0,-200,0.0,0.0,0.0,0.0,0.0,-0.00125,-12
4931,210000,0,3,1,47,-2,-2,-2,-2,-2,-2,6460,3623,10325,8751,11920,8967,3623,10362,8751,11920,8967,7416,1,2837,-6739,1574,-3169,2953,1551,0.01350952380952381,-0.03209047619047619,0.007495238095238096,-0.01509047619047619,0.014061904761904762,0.007385714285714285,-12
4932,420000,1,2,1,36,-1,-1,-1,-1,-1,-1,3663,4338,3400,2535,3216,4652,4338,3400,2535,3216,2652,2500,1,-675,938,865,-681,564,2152,-0.0016071428571428571,0.0022333333333333333,0.0020595238095238097,-0.0016214285714285714,0.0013428571428571428,0.0051238095238095235,-6
4933,180000,1,1,1,53,1,-2,-2,-2,-2,-2,0,0,0,0,0,0,0,0,0,0,0,0,1,0,0,0,0,0,0,0.0,0.0,0.0,0.0,0.0,0.0,-9
4934,80000,0,1,2,44,0,0,0,0,0,0,77156,77494,77438,67054,60270,56138,3000,2734,2215,4000,2036,2121,0,74156,74760,75223,63054,58234,54017,0.92695,0.9345,0.9402875,0.788175,0.727925,0.6752125,0
4935,160000,0,1,2,29,1,-2,-2,-2,-2,-2,0,0,0,0,0,0,0,0,0,0,0,0,0,0,0,0,0,0,0,0.0,0.0,0.0,0.0,0.0,0.0,-9
4936,370000,1,1,1,42,0,0,0,0,0,0,271452,256269,200761,125646,111185,45816,11295,8300,5000,4600,10000,280000,1,260157,247969,195761,121046,101185,-234184,0.703127027027027,0.6701864864864865,0.5290837837837837,0.32715135135135137,0.27347297297297296,-0.6329297297297297,0
4937,130000,1,2,2,26,0,0,0,0,0,-2,110922,113974,126194,17832,-3000,0,5000,15066,5007,0,3000,825,0,105922,98908,121187,17832,-6000,-825,0.8147846153846153,0.7608307692307692,0.9322076923076923,0.13716923076923077,-0.046153846153846156,-0.006346153846153846,-2
4938,180000,0,1,2,31,0,0,0,0,0,0,17426,29047,30572,38043,39441,42652,12000,2000,8043,2000,4000,12500,0,5426,27047,22529,36043,35441,30152,0.030144444444444446,0.15026111111111112,0.1251611111111111,0.20023888888888888,0.19689444444444446,0.1675111111111111,0
4939,120000,1,1,1,38,-1,-1,2,-1,-1,-1,6856,17329,2047,8568,8814,17180,19600,0,14150,9000,17000,0,1,-12744,17329,-12103,-432,-8186,17180,-0.1062,0.14440833333333333,-0.10085833333333333,-0.0036,-0.06821666666666666,0.14316666666666666,-3
4940,90000,1,2,1,50,0,0,0,2,0,0,43439,44512,47677,46615,47537,48616,2100,4200,0,2000,2000,2000,1,41339,40312,47677,44615,45537,46616,0.45932222222222224,0.4479111111111111,0.5297444444444445,0.49572222222222223,0.5059666666666667,0.5179555555555555,2
4941,20000,1,2,2,23,0,0,3,2,0,0,14418,18829,18248,17657,18007,18385,5000,0,0,644,668,670,0,9418,18829,18248,17013,17339,17715,0.4709,0.94145,0.9124,0.85065,0.86695,0.88575,5
4942,70000,1,2,1,28,1,3,2,0,0,2,9192,8905,8611,8879,9746,8710,0,0,400,1000,0,700,1,9192,8905,8211,7879,9746,8010,0.13131428571428572,0.12721428571428572,0.1173,0.11255714285714286,0.13922857142857142,0.11442857142857144,8
4943,50000,1,2,2,23,0,0,0,0,0,0,50614,48702,47770,37239,20526,19771,2500,1700,2151,687,2000,669,0,48114,47002,45619,36552,18526,19102,0.96228,0.94004,0.91238,0.73104,0.37052,0.38204,0
4944,120000,1,2,2,24,0,0,0,0,0,2,15322,16267,45844,47082,54307,53290,1500,30000,2000,8000,0,5000,0,13822,-13733,43844,39082,54307,48290,0.11518333333333333,-0.11444166666666666,0.3653666666666667,0.3256833333333333,0.45255833333333334,0.40241666666666664,2
4945,470000,0,2,2,29,0,0,0,0,0,0,72830,49502,47771,52979,119678,94721,4003,4003,8003,70003,5030,6003,0,68827,45499,39768,-17024,114648,88718,0.1464404255319149,0.0968063829787234,0.08461276595744681,-0.03622127659574468,0.243931914893617,0.18876170212765958,0
4946,130000,1,2,2,35,0,0,0,-2,-2,-2,1923,1995,0,0,0,0,1000,0,0,0,0,0,0,923,1995,0,0,0,0,0.0071,0.015346153846153846,0.0,0.0,0.0,0.0,-6
4947,50000,0,3,1,48,-1,0,0,0,0,0,50899,50527,50375,46952,50343,48831,2000,2000,2000,5001,5000,5021,1,48899,48527,48375,41951,45343,43810,0.97798,0.97054,0.9675,0.83902,0.90686,0.8762,-1
4948,500000,1,1,2,46,0,0,0,0,-1,-1,20614,18050,15341,15985,1147,5492,5001,3007,8000,1147,5492,3000,0,15613,15043,7341,14838,-4345,2492,0.031226,0.030086,0.014682,0.029676,-0.00869,0.004984,-2
4949,120000,1,2,2,23,0,0,0,0,0,0,116314,115653,108971,83592,22321,32150,6019,5000,5000,2000,20000,10000,0,110295,110653,103971,81592,2321,22150,0.919125,0.9221083333333333,0.866425,0.6799333333333333,0.019341666666666667,0.18458333333333332,0
4950,30000,0,3,1,36,-1,-1,-1,-1,0,-1,1493,1555,390,780,390,390,1858,390,780,0,390,0,1,-365,1165,-390,780,0,390,-0.012166666666666666,0.03883333333333333,-0.013,0.026,0.0,0.013,-5
4951,200000,1,1,1,34,-1,-1,-1,-1,-1,-1,7448,5471,4506,10067,9273,2931,5473,4506,10137,9521,2931,10381,1,1975,965,-5631,546,6342,-7450,0.009875,0.004825,-0.028155,0.00273,0.03171,-0.03725,-6
4952,130000,1,2,1,29,0,0,0,0,0,0,67260,69269,72276,74347,77259,78403,4000,5000,4347,5000,3038,2135,1,63260,64269,67929,69347,74221,76268,0.4866153846153846,0.4943769230769231,0.5225307692307692,0.5334384615384615,0.5709307692307692,0.5866769230769231,0
4953,200000,1,2,1,37,-2,-2,-2,-2,-2,-2,4157,601,432,1602,3017,937,606,432,1602,3017,937,1275,1,3551,169,-1170,-1415,2080,-338,0.017755,0.000845,-0.00585,-0.007075,0.0104,-0.00169,-12
4954,250000,1,1,2,35,-1,-1,-1,-1,0,0,4807,10446,17904,99464,86180,36038,10446,17911,99738,4055,0,0,0,-5639,-7465,-81834,95409,86180,36038,-0.022556,-0.02986,-0.327336,0.381636,0.34472,0.144152,-4
4955,250000,1,2,1,75,0,-1,-1,-1,-1,-1,52874,1631,1536,1010,5572,794,1631,1536,1010,5572,794,1184,1,51243,95,526,-4562,4778,-390,0.204972,0.00038,0.002104,-0.018248,0.019112,-0.00156,-5
4956,180000,1,1,2,27,-1,-1,-1,-1,-1,-1,581,5394,1485,4778,23350,583,5396,1485,4778,23350,583,5883,0,-4815,3909,-3293,-18572,22767,-5300,-0.02675,0.021716666666666665,-0.018294444444444443,-0.10317777777777777,0.12648333333333334,-0.029444444444444443,-6
4957,200000,1,1,1,43,1,-1,-1,-2,-2,-1,0,601,0,0,0,259,601,0,0,0,259,150,1,-601,601,0,0,-259,109,-0.003005,0.003005,0.0,0.0,-0.001295,0.000545,-6
4958,370000,0,2,2,39,1,2,0,0,0,0,343248,334394,337272,340152,345904,322168,5,14005,12004,12362,12006,9555,0,343243,320389,325268,327790,333898,312613,0.9276837837837838,0.8659162162162162,0.8791027027027027,0.8859189189189189,0.902427027027027,0.8449,3
4959,150000,0,1,2,35,-1,-1,-1,-1,-1,-2,3425,9009,-3,780,0,0,9054,0,783,0,0,0,0,-5629,9009,-786,780,0,0,-0.037526666666666667,0.06006,-0.00524,0.0052,0.0,0.0,-7
4960,210000,0,1,1,39,-1,-1,2,2,-1,2,3391,775,450,125,800,325,1000,0,0,1000,0,650,1,2391,775,450,-875,800,-325,0.011385714285714285,0.0036904761904761906,0.002142857142857143,-0.004166666666666667,0.0038095238095238095,-0.0015476190476190477,3
4961,130000,1,1,2,24,0,0,0,2,2,-1,3621,4530,6627,3300,0,18300,1130,2227,200,0,18300,0,0,2491,2303,6427,3300,-18300,18300,0.019161538461538462,0.017715384615384615,0.049438461538461535,0.025384615384615384,-0.14076923076923076,0.14076923076923076,3
4962,230000,1,2,2,28,0,0,-1,-1,-1,-2,24867,24437,3900,870,0,0,4300,3900,870,0,0,0,0,20567,20537,3030,870,0,0,0.08942173913043479,0.08929130434782609,0.013173913043478262,0.003782608695652174,0.0,0.0,-5
4963,70000,1,3,1,27,2,2,2,2,2,2,27241,30416,29628,32350,33218,32532,3628,0,3218,1532,0,2257,1,23613,30416,26410,30818,33218,30275,0.3373285714285714,0.43451428571428574,0.3772857142857143,0.44025714285714285,0.47454285714285716,0.4325,12
4964,140000,0,2,1,38,1,2,2,2,2,2,129497,131877,135309,131671,138771,141146,6000,7000,0,10800,4800,0,1,123497,124877,135309,120871,133971,141146,0.8821214285714286,0.8919785714285714,0.9664928571428572,0.8633642857142857,0.9569357142857143,1.0081857142857142,11
4965,50000,0,2,2,32,0,0,3,2,2,2,15276,19797,19205,18600,19697,20243,4800,0,0,1700,1000,0,0,10476,19797,19205,16900,18697,20243,0.20952,0.39594,0.3841,0.338,0.37394,0.40486,9
4966,100000,1,1,2,29,0,0,0,0,0,0,167410,85536,77303,60178,56436,51773,70001,3769,2008,1950,2001,18000,0,97409,81767,75295,58228,54435,33773,0.97409,0.81767,0.75295,0.58228,0.54435,0.33773,0
4967,320000,1,1,1,58,-2,-2,-2,-2,-2,-2,1100,0,0,0,0,0,0,0,0,0,0,434,1,1100,0,0,0,0,-434,0.0034375,0.0,0.0,0.0,0.0,-0.00135625,-12
4968,200000,1,1,2,27,0,0,0,0,0,0,9314,6020,4817,2098,2280,4778,2020,2817,1098,1280,3778,3098,0,7294,3203,3719,818,-1498,1680,0.03647,0.016015,0.018595,0.00409,-0.00749,0.0084,0
4969,20000,0,3,2,39,0,0,0,0,0,0,30892,16348,13593,10236,17541,16322,5000,2015,3000,10005,3414,270,0,25892,14333,10593,231,14127,16052,1.2946,0.71665,0.52965,0.01155,0.70635,0.8026,0
4970,150000,1,4,1,38,-2,-2,-2,-2,-2,-2,0,0,1597,-3,1764,718,0,1597,0,1767,718,0,1,0,-1597,1597,-1770,1046,718,0.0,-0.010646666666666667,0.010646666666666667,-0.0118,0.006973333333333333,0.0047866666666666665,-12
4971,290000,1,2,1,27,0,0,0,0,-1,0,284298,281970,276346,0,281225,288652,14013,16346,0,281225,11787,12020,1,270285,265624,276346,-281225,269438,276632,0.9320172413793103,0.9159448275862069,0.9529172413793103,-0.9697413793103449,0.929096551724138,0.953903448275862,-1
4972,50000,0,3,2,42,0,0,0,0,0,0,43998,49123,49397,50360,19971,19694,10000,4000,5000,3000,4500,2000,0,33998,45123,44397,47360,15471,17694,0.67996,0.90246,0.88794,0.9472,0.30942,0.35388,0
4973,70000,1,3,1,32,0,0,0,2,0,0,10856,10822,13627,10852,12676,14463,2000,3000,0,2000,3000,4000,1,8856,7822,13627,8852,9676,10463,0.12651428571428572,0.11174285714285714,0.19467142857142858,0.12645714285714285,0.13822857142857142,0.14947142857142856,2
4974,210000,0,1,2,26,0,0,0,0,0,0,204824,209873,214775,111893,107697,105578,10000,10000,5000,4000,4000,4000,0,194824,199873,209775,107893,103697,101578,0.9277333333333333,0.9517761904761904,0.9989285714285714,0.5137761904761905,0.4937952380952381,0.4837047619047619,0
4975,500000,1,2,2,29,0,0,0,0,0,0,455042,364288,261185,215575,174736,118438,12564,10000,6476,5489,5000,5000,0,442478,354288,254709,210086,169736,113438,0.884956,0.708576,0.509418,0.420172,0.339472,0.226876,0
4976,30000,1,2,2,24,0,0,0,0,0,0,27170,27448,27238,27012,26762,25900,2500,2000,2000,1916,1000,1100,0,24670,25448,25238,25096,25762,24800,0.8223333333333334,0.8482666666666666,0.8412666666666667,0.8365333333333334,0.8587333333333333,0.8266666666666667,0
4977,30000,0,2,2,29,6,5,4,3,2,0,32875,32101,31071,30136,28496,29675,0,0,0,0,1642,0,0,32875,32101,31071,30136,26854,29675,1.0958333333333334,1.0700333333333334,1.0357,1.0045333333333333,0.8951333333333333,0.9891666666666666,20
4978,310000,1,3,2,36,-1,-1,-1,-1,-1,-1,6282,5835,912,1688,5590,1649,5864,919,1696,5617,1657,4510,0,418,4916,-784,-3929,3933,-2861,0.0013483870967741936,0.015858064516129033,-0.002529032258064516,-0.012674193548387096,0.012687096774193548,-0.009229032258064516,-6
4979,60000,1,1,2,34,2,-1,-1,0,-1,-1,493,240,823,683,240,998,240,823,0,240,998,223,0,253,-583,823,443,-758,775,0.004216666666666666,-0.009716666666666667,0.013716666666666667,0.007383333333333334,-0.012633333333333333,0.012916666666666667,-2
4980,150000,0,2,1,40,0,0,0,0,0,0,54021,55154,56280,57397,58599,60668,2003,2044,2054,2127,3044,3150,1,52018,53110,54226,55270,55555,57518,0.3467866666666667,0.35406666666666664,0.36150666666666664,0.36846666666666666,0.3703666666666667,0.3834533333333333,0
4981,70000,0,2,2,25,0,-1,-1,-1,-2,-2,34700,21597,3340,0,0,0,21597,3340,0,0,0,8535,0,13103,18257,3340,0,0,-8535,0.1871857142857143,0.2608142857142857,0.047714285714285716,0.0,0.0,-0.12192857142857143,-7
4982,50000,0,2,2,27,0,0,0,-2,-2,-2,26380,26439,-200,-200,-200,-200,1000,0,0,0,0,0,0,25380,26439,-200,-200,-200,-200,0.5076,0.52878,-0.004,-0.004,-0.004,-0.004,-6
4983,220000,1,2,2,30,-1,-1,-1,-1,0,0,596,892,7681,11642,23030,22449,892,7681,20000,20000,0,0,0,-296,-6789,-12319,-8358,23030,22449,-0.0013454545454545455,-0.03085909090909091,-0.05599545454545454,-0.03799090909090909,0.10468181818181818,0.10204090909090908,-4
4984,310000,1,2,1,46,-2,-2,-2,-2,-2,-2,53474,11913,6629,34342,1900,5807,11919,6629,17171,3800,5807,1380,1,41555,5284,-10542,30542,-3907,4427,0.1340483870967742,0.01704516129032258,-0.03400645161290323,0.09852258064516128,-0.012603225806451613,0.014280645161290323,-12
4985,30000,1,2,2,25,1,2,0,0,2,0,13785,13272,14310,16059,15506,15687,0,1560,2300,0,580,1000,0,13785,11712,12010,16059,14926,14687,0.4595,0.3904,0.4003333333333333,0.5353,0.4975333333333333,0.48956666666666665,5
4986,150000,0,1,2,26,-2,-2,-2,-2,-2,-2,0,0,0,0,0,0,0,0,0,0,0,0,0,0,0,0,0,0,0,0.0,0.0,0.0,0.0,0.0,0.0,-12
4987,230000,0,2,2,32,0,0,0,0,0,0,28114,28006,25000,22046,19860,19831,1610,1224,655,627,620,500,0,26504,26782,24345,21419,19240,19331,0.11523478260869566,0.11644347826086957,0.10584782608695652,0.09312608695652173,0.08365217391304348,0.08404782608695652,0
4988,110000,1,2,2,26,-1,-1,-1,-1,-1,0,1687,400,300,922,3509,1979,400,300,922,3509,0,5192,0,1287,100,-622,-2587,3509,-3213,0.0117,0.0009090909090909091,-0.005654545454545455,-0.023518181818181817,0.0319,-0.02920909090909091,-5
4989,20000,1,3,1,23,1,2,2,-2,-2,-2,14428,14310,0,0,0,0,480,0,0,0,0,0,1,13948,14310,0,0,0,0,0.6974,0.7155,0.0,0.0,0.0,0.0,-1
4990,30000,1,3,1,67,2,2,2,0,0,0,27943,30734,28092,29112,29555,28536,3580,0,1800,1200,1083,1200,1,24363,30734,26292,27912,28472,27336,0.8121,1.0244666666666666,0.8764,0.9304,0.9490666666666666,0.9112,6
4991,220000,0,2,1,37,0,0,0,0,0,0,13429,15688,17922,20111,22261,24392,2500,2500,2500,2500,2500,2500,1,10929,13188,15422,17611,19761,21892,0.04967727272727273,0.059945454545454545,0.0701,0.08005,0.08982272727272728,0.09950909090909091,0
4992,50000,1,1,1,41,0,0,0,0,0,0,47739,47481,47066,44367,27496,27677,2000,1817,2000,1500,1001,1010,1,45739,45664,45066,42867,26495,26667,0.91478,0.91328,0.90132,0.85734,0.5299,0.53334,0
4993,360000,0,1,2,30,0,-1,-1,-1,-1,-1,14409,3540,500,500,0,1191,3540,500,500,0,1191,0,0,10869,3040,0,500,-1191,1191,0.030191666666666665,0.008444444444444444,0.0,0.001388888888888889,-0.0033083333333333333,0.0033083333333333333,-5
4994,50000,0,3,2,41,0,0,0,0,0,0,43383,43397,43395,42334,12316,9997,1992,2251,1451,540,503,430,0,41391,41146,41944,41794,11813,9567,0.82782,0.82292,0.83888,0.83588,0.23626,0.19134,0
4995,30000,1,3,2,22,0,0,0,0,0,0,20741,21906,23183,13273,3027,3177,1500,1700,750,200,200,100,0,19241,20206,22433,13073,2827,3077,0.6413666666666666,0.6735333333333333,0.7477666666666667,0.4357666666666667,0.09423333333333334,0.10256666666666667,0
4996,50000,0,2,2,34,0,0,0,0,0,-1,44168,44727,26135,26730,12180,18179,1410,2000,1167,1017,18179,651,0,42758,42727,24968,25713,-5999,17528,0.85516,0.85454,0.49936,0.51426,-0.11998,0.35056,-1
4997,400000,1,2,2,32,-2,-2,-2,-2,-2,-2,0,626,118,10349,2817,2410,626,118,10349,2817,2410,10715,0,-626,508,-10231,7532,407,-8305,-0.001565,0.00127,-0.0255775,0.01883,0.0010175,-0.0207625,-12
4998,150000,0,1,1,41,3,2,2,0,0,2,111056,113467,110235,111376,154802,152304,5700,0,4500,45500,0,5400,1,105356,113467,105735,65876,154802,146904,0.7023733333333333,0.7564466666666667,0.7049,0.43917333333333336,1.0320133333333332,0.97936,9
4999,500000,1,1,1,35,-2,-1,0,-1,-1,-1,5799,36189,23338,7896,8970,215305,36277,6112,10014,9018,215518,20018,1,-30478,30077,13324,-1122,-206548,195287,-0.060956,0.060154,0.026648,-0.002244,-0.413096,0.390574,-6
5000,50000,0,3,1,46,1,2,2,2,-2,-2,51814,53077,51400,0,0,0,2400,0,0,0,0,0,1,49414,53077,51400,0,0,0,0.98828,1.06154,1.028,0.0,0.0,0.0,3
5001,180000,1,1,2,30,0,0,0,0,0,-2,7808,4511,3435,5345,2018,164,1198,1099,2009,2024,164,2159,0,6610,3412,1426,3321,1854,-1995,0.036722222222222226,0.018955555555555555,0.007922222222222223,0.01845,0.0103,-0.011083333333333334,-2
5002,80000,0,2,2,27,0,0,0,0,0,0,60829,57556,59083,60051,41757,42641,2061,2455,2667,2002,2055,1000,0,58768,55101,56416,58049,39702,41641,0.7346,0.6887625,0.7052,0.7256125,0.496275,0.5205125,0
5003,240000,0,1,2,34,0,-1,2,-1,0,0,18825,12675,2880,13267,10036,24731,12880,0,13267,2000,15000,0,0,5945,12675,-10387,11267,-4964,24731,0.024770833333333332,0.0528125,-0.04327916666666667,0.04694583333333333,-0.020683333333333335,0.10304583333333334,0
5004,230000,1,1,1,34,-1,0,0,0,-1,0,4358,6020,9938,9865,6981,12157,3000,5000,5828,6981,6157,6342,1,1358,1020,4110,2884,824,5815,0.0059043478260869565,0.004434782608695652,0.017869565217391303,0.012539130434782608,0.003582608695652174,0.025282608695652173,-2
5005,290000,1,1,1,36,-2,-2,-2,-2,-2,-2,3602,6107,4536,6074,0,817,6107,4538,6074,0,817,1662,1,-2505,1569,-1538,6074,-817,-845,-0.008637931034482758,0.005410344827586207,-0.005303448275862069,0.020944827586206898,-0.0028172413793103447,-0.002913793103448276,-12
5006,170000,0,1,2,25,-2,-1,0,0,0,0,-1028,58324,57657,58832,60002,61260,60751,2100,2135,2148,2225,2396,0,-61779,56224,55522,56684,57777,58864,-0.3634058823529412,0.3307294117647059,0.3266,0.33343529411764705,0.33986470588235296,0.3462588235294118,-3
5007,80000,1,1,2,24,-2,-2,-2,-2,-2,-2,0,698,4949,967,5762,0,698,4949,967,5775,0,0,0,-698,-4251,3982,-4808,5762,0,-0.008725,-0.0531375,0.049775,-0.0601,0.072025,0.0,-12
5008,330000,1,2,2,39,0,0,0,0,0,0,156853,139687,120586,123152,115105,85737,5757,3923,4108,3632,3779,3672,0,151096,135764,116478,119520,111326,82065,0.45786666666666664,0.4114060606060606,0.35296363636363637,0.36218181818181816,0.3373515151515151,0.24868181818181817,0
5009,500000,1,2,2,39,-1,0,-1,-1,-1,2,17749,22130,42532,-118,67910,54976,10106,42744,0,68445,42,1232,0,7643,-20614,42532,-68563,67868,53744,0.015286,-0.041228,0.085064,-0.137126,0.135736,0.107488,-2
5010,180000,1,3,1,34,0,0,0,-1,-1,-1,16386,15793,8441,7142,-679,8321,8500,1500,7500,679,9000,2000,1,7886,14293,941,6463,-9679,6321,0.04381111111111111,0.07940555555555555,0.005227777777777777,0.03590555555555556,-0.05377222222222222,0.035116666666666664,-3
5011,320000,1,1,2,30,0,0,0,0,0,0,2419,3193,5127,6871,7751,8623,2000,2000,2000,1000,1000,1000,0,419,1193,3127,5871,6751,7623,0.001309375,0.003728125,0.009771875,0.018346875,0.021096875,0.023821875,0
5012,180000,1,2,1,36,0,0,0,-2,-1,0,21494,25600,0,0,36565,37353,5000,0,0,36565,1548,1000,1,16494,25600,0,-36565,35017,36353,0.09163333333333333,0.14222222222222222,0.0,-0.2031388888888889,0.1945388888888889,0.20196111111111112,-3
5013,360000,1,2,1,35,0,0,0,-1,-1,0,5157,2461,0,277,2599,3941,1012,0,277,2602,2019,1123,1,4145,2461,-277,-2325,580,2818,0.01151388888888889,0.006836111111111111,-0.0007694444444444445,-0.006458333333333333,0.0016111111111111111,0.007827777777777777,-2
5014,150000,0,1,2,25,-1,-1,-1,-1,-2,-2,3125,8418,797,-3,-3,-3,8443,799,0,0,0,0,0,-5318,7619,797,-3,-3,-3,-0.03545333333333334,0.050793333333333336,0.005313333333333333,-2e-05,-2e-05,-2e-05,-8
5015,310000,1,1,1,29,-2,-2,-2,-2,-2,-2,594,235,5641,0,0,0,477,5648,0,0,0,2287,1,117,-5413,5641,0,0,-2287,0.00037741935483870967,-0.017461290322580644,0.018196774193548388,0.0,0.0,-0.007377419354838709,-12
5016,20000,1,2,2,22,1,2,0,0,2,2,9498,9202,10741,12326,11888,9351,0,2000,1800,0,900,0,0,9498,7202,8941,12326,10988,9351,0.4749,0.3601,0.44705,0.6163,0.5494,0.46755,7
5017,130000,0,2,2,29,0,0,0,0,0,0,130708,132080,130128,101794,101826,101763,6658,5146,4000,4000,3866,3435,0,124050,126934,126128,97794,97960,98328,0.9542307692307692,0.9764153846153846,0.9702153846153846,0.7522615384615384,0.7535384615384615,0.7563692307692308,0
5018,300000,1,3,1,41,1,-2,-2,-2,-2,-2,390,390,780,390,390,5144,390,780,0,390,5144,390,1,0,-390,780,0,-4754,4754,0.0,-0.0013,0.0026,0.0,-0.015846666666666665,0.015846666666666665,-9
5019,50000,0,2,2,23,2,2,0,0,0,0,32589,32583,21197,7666,4768,5685,1000,2000,1000,1000,1000,1000,0,31589,30583,20197,6666,3768,4685,0.63178,0.61166,0.40394,0.13332,0.07536,0.0937,4
5020,240000,0,1,2,32,-2,-2,-2,-2,-2,-2,3162,3162,3124,3162,3162,3162,3162,3124,3200,3162,3162,3131,0,0,38,-76,0,0,31,0.0,0.00015833333333333332,-0.00031666666666666665,0.0,0.0,0.00012916666666666667,-12
5021,20000,1,1,2,25,0,0,0,0,0,0,15810,15947,6012,5689,4587,2293,1249,1125,1000,92,0,20505,0,14561,14822,5012,5597,4587,-18212,0.72805,0.7411,0.2506,0.27985,0.22935,-0.9106,0
5022,150000,1,1,2,24,-2,-2,-2,-2,-2,-2,1495,2053,0,0,0,0,2060,0,0,0,0,0,0,-565,2053,0,0,0,0,-0.003766666666666667,0.013686666666666666,0.0,0.0,0.0,0.0,-12
5023,210000,1,1,1,32,-1,-1,-1,-1,-1,-1,8600,0,4231,4221,4221,4483,0,4231,4221,4221,4483,4300,1,8600,-4231,10,0,-262,183,0.040952380952380955,-0.020147619047619046,4.761904761904762e-05,0.0,-0.0012476190476190475,0.0008714285714285714,-6
5024,70000,1,1,2,24,-1,0,0,0,0,0,28059,17712,18642,20011,19147,19056,2000,3000,3000,2000,2000,3668,0,26059,14712,15642,18011,17147,15388,0.3722714285714286,0.21017142857142856,0.22345714285714285,0.2573,0.24495714285714285,0.21982857142857143,-1
5025,110000,1,2,1,46,0,0,0,0,0,0,110950,111750,111227,110849,110575,110394,4088,3912,3888,3975,4162,3945,1,106862,107838,107339,106874,106413,106449,0.9714727272727273,0.9803454545454545,0.975809090909091,0.9715818181818182,0.9673909090909091,0.9677181818181818,0
5026,50000,1,3,2,42,0,0,0,0,0,0,48926,49759,48803,46472,19766,19761,2019,2063,2217,705,725,927,0,46907,47696,46586,45767,19041,18834,0.93814,0.95392,0.93172,0.91534,0.38082,0.37668,0
5027,50000,0,3,1,37,0,0,0,0,0,0,44320,45211,45559,46164,46685,47272,2021,3259,1754,1665,1723,2099,1,42299,41952,43805,44499,44962,45173,0.84598,0.83904,0.8761,0.88998,0.89924,0.90346,0
5028,160000,1,1,2,35,-1,-1,-1,-1,-1,-1,19082,2815,27380,10028,2824,9940,2815,27380,10050,3000,9940,12498,0,16267,-24565,17330,7028,-7116,-2558,0.10166875,-0.15353125,0.1083125,0.043925,-0.044475,-0.0159875,-6
5029,10000,0,3,2,22,1,4,3,2,2,2,8357,8085,7817,7545,8268,7993,0,0,0,1000,0,750,0,8357,8085,7817,6545,8268,7243,0.8357,0.8085,0.7817,0.6545,0.8268,0.7243,14
5030,70000,1,3,1,42,0,0,0,0,0,0,6489,9372,11179,8688,8295,10147,3000,2000,295,1000,2000,1000,1,3489,7372,10884,7688,6295,9147,0.04984285714285714,0.10531428571428571,0.15548571428571428,0.10982857142857143,0.08992857142857143,0.13067142857142858,0
5031,220000,1,2,1,54,-1,-1,-1,-1,-1,-1,265,4786,2367,2873,11768,7484,4786,2367,2888,11768,7484,13062,1,-4521,2419,-521,-8895,4284,-5578,-0.02055,0.010995454545454546,-0.0023681818181818183,-0.04043181818181818,0.019472727272727273,-0.025354545454545456,-6
5032,250000,1,2,2,55,-2,-2,-1,-1,0,0,603,1867,2470,3887,4731,8710,1867,2661,3887,1000,4000,1000,0,-1264,-794,-1417,2887,731,7710,-0.005056,-0.003176,-0.005668,0.011548,0.002924,0.03084,-6
5033,210000,1,1,2,30,1,2,0,0,0,0,73903,72153,73634,75095,76886,78604,0,2674,2687,3000,3000,3000,0,73903,69479,70947,72095,73886,75604,0.35191904761904763,0.33085238095238095,0.33784285714285717,0.3433095238095238,0.3518380952380952,0.3600190476190476,3
5034,360000,1,1,2,37,-1,-1,-1,-1,-1,-1,3355,5865,3300,6290,8220,28410,5865,3300,6290,8220,28410,4845,0,-2510,2565,-2990,-1930,-20190,23565,-0.0069722222222222225,0.007125,-0.008305555555555556,-0.005361111111111111,-0.05608333333333333,0.06545833333333333,-6
5035,150000,1,2,1,35,0,0,0,0,0,0,128278,131715,133625,49019,44801,39742,7000,6000,1800,1600,2000,1700,1,121278,125715,131825,47419,42801,38042,0.80852,0.8381,0.8788333333333334,0.31612666666666667,0.28534,0.25361333333333336,0
5036,200000,1,2,1,48,-2,-1,2,-1,0,0,22111,32938,10902,6309,4979,2978,11257,0,6309,0,2986,0,1,10854,32938,4593,6309,1993,2978,0.05427,0.16469,0.022965,0.031545,0.009965,0.01489,-2
5037,280000,1,2,1,34,-2,-2,-2,-2,-2,-2,9103,6419,11966,5844,8994,14631,6439,12042,5844,4672,14724,4429,1,2664,-5623,6122,1172,-5730,10202,0.009514285714285715,-0.020082142857142857,0.021864285714285715,0.004185714285714286,-0.020464285714285713,0.03643571428571429,-12
5038,110000,1,3,1,51,0,0,0,0,0,0,105476,109153,109501,105290,78812,78503,5436,5007,5290,8812,8503,8200,1,100040,104146,104211,96478,70309,70303,0.9094545454545454,0.9467818181818182,0.9473727272727273,0.8770727272727272,0.6391727272727272,0.6391181818181818,0
5039,50000,1,2,2,48,0,0,0,0,0,0,50894,49333,9923,10126,10113,10130,1385,1200,350,400,360,400,0,49509,48133,9573,9726,9753,9730,0.99018,0.96266,0.19146,0.19452,0.19506,0.1946,0
5040,30000,1,3,1,33,0,0,0,0,0,0,29666,29033,29345,29125,29859,29016,1763,1676,1456,1190,1056,1592,1,27903,27357,27889,27935,28803,27424,0.9301,0.9119,0.9296333333333333,0.9311666666666667,0.9601,0.9141333333333334,0
5041,80000,1,2,1,32,0,0,0,0,0,0,81074,78262,76163,76813,77511,79069,3700,3400,2900,2900,2841,3100,1,77374,74862,73263,73913,74670,75969,0.967175,0.935775,0.9157875,0.9239125,0.933375,0.9496125,0
5042,50000,1,1,1,40,-1,2,-1,-1,2,2,465,465,760,1360,518,3518,0,760,600,0,3000,0,1,465,-295,160,1360,-2482,3518,0.0093,-0.0059,0.0032,0.0272,-0.04964,0.07036,3
5043,450000,1,1,2,37,-1,0,0,0,0,0,71985,85047,74354,57628,57381,14870,15000,1879,20000,20000,5000,50893,0,56985,83168,54354,37628,52381,-36023,0.12663333333333332,0.18481777777777778,0.12078666666666667,0.08361777777777778,0.11640222222222223,-0.08005111111111111,-1
5044,80000,1,3,1,55,0,0,0,0,0,0,69116,64325,59653,55159,56277,57347,2500,2000,2000,2000,2000,2000,1,66616,62325,57653,53159,54277,55347,0.8327,0.7790625,0.7206625,0.6644875,0.6784625,0.6918375,0
5045,80000,0,2,2,48,0,0,0,0,0,0,74040,74658,72885,47663,48350,47208,3500,2500,2000,2000,2000,2000,0,70540,72158,70885,45663,46350,45208,0.88175,0.901975,0.8860625,0.5707875,0.579375,0.5651,0
5046,320000,1,2,2,36,0,0,0,0,0,0,262613,164486,169691,188527,145676,135254,10043,15005,21640,5004,11628,20020,0,252570,149481,148051,183523,134048,115234,0.78928125,0.467128125,0.462659375,0.573509375,0.4189,0.36010625,0
5047,20000,1,2,1,23,1,2,2,2,2,3,7979,8700,9907,9599,14422,18885,1000,1500,0,5000,5000,900,1,6979,7200,9907,4599,9422,17985,0.34895,0.36,0.49535,0.22995,0.4711,0.89925,12
5048,240000,1,1,2,26,-1,0,-1,-1,-1,-1,28700,21944,12450,27255,6280,7619,1639,12450,28969,6280,7619,3000,0,27061,9494,-16519,20975,-1339,4619,0.11275416666666667,0.039558333333333334,-0.06882916666666666,0.08739583333333334,-0.005579166666666666,0.019245833333333334,-5
5049,280000,1,2,1,39,1,-1,0,0,0,0,-1312,35918,37297,37154,32581,33316,38621,2000,1130,922,1011,5000,1,-39933,33918,36167,36232,31570,28316,-0.14261785714285713,0.12113571428571429,0.12916785714285714,0.1294,0.11275,0.10112857142857143,0
5050,20000,0,2,1,51,0,0,2,0,0,0,16849,18686,18877,19252,19415,19954,2116,800,682,701,858,394,1,14733,17886,18195,18551,18557,19560,0.73665,0.8943,0.90975,0.92755,0.92785,0.978,2
5051,100000,1,2,1,27,1,-2,-2,-2,-2,-1,0,0,0,0,0,4747,0,0,0,0,4747,1198,1,0,0,0,0,-4747,3549,0.0,0.0,0.0,0.0,-0.04747,0.03549,-8
5052,90000,1,2,1,43,-2,-2,-2,-2,-2,-2,0,0,0,0,0,0,0,0,0,0,0,0,1,0,0,0,0,0,0,0.0,0.0,0.0,0.0,0.0,0.0,-12
5053,200000,1,2,2,24,0,0,0,0,0,0,39723,40586,44233,45124,46252,47207,1353,4000,1267,1500,1500,1500,0,38370,36586,42966,43624,44752,45707,0.19185,0.18293,0.21483,0.21812,0.22376,0.228535,0
5054,250000,1,1,1,34,0,0,2,0,0,0,141223,156858,151841,152803,155997,160220,17994,0,5469,5656,6811,3920,1,123229,156858,146372,147147,149186,156300,0.492916,0.627432,0.585488,0.588588,0.596744,0.6252,2
5055,160000,1,2,2,27,2,2,2,2,2,2,157818,161308,162923,161481,155819,168283,7500,5800,5700,0,18100,0,0,150318,155508,157223,161481,137719,168283,0.9394875,0.971925,0.98264375,1.00925625,0.86074375,1.05176875,12
5056,30000,0,1,1,36,-1,2,2,-1,2,2,1123,543,153,1495,955,1735,200,0,1495,0,1170,0,1,923,543,-1342,1495,-215,1735,0.030766666666666668,0.0181,-0.04473333333333333,0.049833333333333334,-0.007166666666666667,0.057833333333333334,6
5057,30000,0,1,3,27,0,0,0,0,0,0,25107,26312,28102,29078,29201,24122,2000,3000,2000,1000,1500,1000,0,23107,23312,26102,28078,27701,23122,0.7702333333333333,0.7770666666666667,0.8700666666666667,0.9359333333333333,0.9233666666666667,0.7707333333333334,0
5058,120000,1,3,1,51,0,0,0,2,2,2,26496,28586,33828,34236,34734,35292,2800,6000,1200,1300,1200,0,1,23696,22586,32628,32936,33534,35292,0.19746666666666668,0.18821666666666667,0.2719,0.2744666666666667,0.27945,0.2941,6
5059,80000,0,1,2,23,-1,-1,-1,-1,-1,0,9183,9606,3158,2941,2313,1367,9643,3167,2953,3753,4,7949,0,-460,6439,205,-812,2309,-6582,-0.00575,0.0804875,0.0025625,-0.01015,0.0288625,-0.082275,-5
5060,450000,0,2,1,55,2,2,-2,-2,-2,-2,2500,0,0,0,0,0,0,0,0,0,0,0,1,2500,0,0,0,0,0,0.005555555555555556,0.0,0.0,0.0,0.0,0.0,-4
5061,230000,0,3,2,24,0,0,0,0,2,0,82066,80317,70854,74413,72447,73418,4000,3500,6000,0,3000,2800,0,78066,76817,64854,74413,69447,70618,0.33941739130434784,0.33398695652173915,0.28197391304347824,0.32353478260869567,0.3019434782608696,0.30703478260869566,2
5062,120000,1,2,1,30,0,0,0,0,0,0,101596,102860,104694,103058,71095,47379,3706,5502,4204,3017,2005,1702,1,97890,97358,100490,100041,69090,45677,0.81575,0.8113166666666667,0.8374166666666667,0.833675,0.57575,0.38064166666666666,0
5063,310000,0,2,2,35,0,0,0,0,0,0,259636,263812,269351,276873,281764,299161,10000,9775,12000,11000,22000,9905,0,249636,254037,257351,265873,259764,289256,0.8052774193548388,0.8194741935483871,0.8301645161290323,0.8576548387096774,0.8379483870967742,0.9330838709677419,0
5064,360000,1,2,1,28,1,-2,-2,-2,-2,-2,0,0,0,0,0,0,0,0,0,0,0,0,1,0,0,0,0,0,0,0.0,0.0,0.0,0.0,0.0,0.0,-9
5065,140000,0,1,1,40,2,0,0,2,2,2,136785,137175,140773,133147,140350,136475,5051,12602,0,12000,0,5000,1,131734,124573,140773,121147,140350,131475,0.9409571428571428,0.8898071428571429,1.0055214285714287,0.8653357142857143,1.0025,0.9391071428571428,8
5066,160000,1,1,1,36,-1,-1,0,-1,-1,-1,1714,2845,3342,171,1770,837,2845,1000,171,1770,837,299,1,-1131,1845,3171,-1599,933,538,-0.00706875,0.01153125,0.01981875,-0.00999375,0.00583125,0.0033625,-5
5067,410000,0,2,1,45,0,0,0,0,0,0,278405,285415,279484,274639,281158,288051,13000,10515,9884,11000,11425,11700,1,265405,274900,269600,263639,269733,276351,0.6473292682926829,0.6704878048780488,0.6575609756097561,0.6430219512195122,0.6578853658536585,0.6740268292682927,0
5068,70000,1,2,1,33,0,0,0,0,0,0,31130,16171,16373,16945,21462,11128,10171,3000,1260,6138,1128,500,1,20959,13171,15113,10807,20334,10628,0.2994142857142857,0.18815714285714286,0.2159,0.1543857142857143,0.2904857142857143,0.15182857142857142,0
5069,50000,1,2,1,24,-2,-2,-2,-2,-2,-2,900,0,0,0,0,0,0,0,0,0,0,0,1,900,0,0,0,0,0,0.018,0.0,0.0,0.0,0.0,0.0,-12
5070,70000,1,3,2,40,0,0,0,0,0,0,60525,60932,60190,25126,24718,27726,14011,14494,6019,7010,8007,5008,0,46514,46438,54171,18116,16711,22718,0.6644857142857142,0.6634,0.7738714285714285,0.2588,0.23872857142857143,0.32454285714285713,0
5071,210000,0,1,2,33,-1,-1,-1,-1,-1,-1,10635,9921,2570,14722,11220,14800,10046,2570,14722,11220,14800,7250,0,589,7351,-12152,3502,-3580,7550,0.002804761904761905,0.03500476190476191,-0.057866666666666663,0.016676190476190476,-0.017047619047619048,0.03595238095238095,-6
5072,30000,1,3,1,38,2,2,0,0,2,2,5685,5448,7347,8024,7751,9607,0,2000,800,0,2000,0,1,5685,3448,6547,8024,5751,9607,0.1895,0.11493333333333333,0.21823333333333333,0.2674666666666667,0.1917,0.3202333333333333,8
5073,130000,1,3,1,41,0,0,0,0,0,0,101885,72686,70672,64530,63041,56493,3500,2389,2368,5000,1964,1707,1,98385,70297,68304,59530,61077,54786,0.7568076923076923,0.5407461538461539,0.5254153846153846,0.45792307692307693,0.4698230769230769,0.4214307692307692,0
5074,80000,0,2,2,23,2,2,0,0,0,0,71528,69817,70719,39288,40500,41668,0,2131,2000,2000,2000,3000,0,71528,67686,68719,37288,38500,38668,0.8941,0.846075,0.8589875,0.4661,0.48125,0.48335,4
5075,60000,0,1,2,28,-1,-1,-2,-2,-2,-2,20000,0,0,0,0,0,0,0,0,0,0,0,0,20000,0,0,0,0,0,0.3333333333333333,0.0,0.0,0.0,0.0,0.0,-10
5076,140000,1,1,2,24,0,0,0,0,0,0,28872,30083,31119,32597,33257,35061,2000,1522,2000,1500,2500,2000,0,26872,28561,29119,31097,30757,33061,0.19194285714285714,0.20400714285714286,0.20799285714285715,0.22212142857142858,0.21969285714285713,0.23615,0
5077,500000,1,1,2,35,-1,-1,-1,-1,0,-1,2398,4583,13519,43251,34279,8657,4583,13519,43251,0,8657,10649,0,-2185,-8936,-29732,43251,25622,-1992,-0.00437,-0.017872,-0.059464,0.086502,0.051244,-0.003984,-5
5078,50000,0,3,2,26,1,2,3,2,0,0,48560,52047,50597,20378,18344,19618,4570,0,0,2000,2000,341,0,43990,52047,50597,18378,16344,19277,0.8798,1.04094,1.01194,0.36756,0.32688,0.38554,8
5079,50000,0,2,2,27,2,0,0,0,0,2,41932,38411,30659,30963,30505,28696,1600,1712,1016,2500,0,2848,0,40332,36699,29643,28463,30505,25848,0.80664,0.73398,0.59286,0.56926,0.6101,0.51696,4
5080,120000,0,2,2,29,0,0,0,0,0,0,115698,118277,121004,118774,91369,88015,6000,6513,3740,3215,3300,3405,0,109698,111764,117264,115559,88069,84610,0.91415,0.9313666666666667,0.9772,0.9629916666666667,0.7339083333333334,0.7050833333333333,0
5081,100000,1,2,1,38,1,-1,-1,-2,-2,-1,0,199,0,0,0,150,199,0,0,0,150,550,1,-199,199,0,0,-150,-400,-0.00199,0.00199,0.0,0.0,-0.0015,-0.004,-6
5082,150000,1,1,1,28,0,-1,-1,-1,-1,-1,58322,36865,32311,12791,390,1508,36865,32311,12956,390,1508,2224,1,21457,4554,19355,12401,-1118,-716,0.14304666666666666,0.03036,0.12903333333333333,0.08267333333333333,-0.0074533333333333335,-0.004773333333333333,-5
5083,150000,0,4,1,42,2,0,0,0,0,0,143947,147394,142991,146745,149526,147034,4742,4847,4997,4120,4133,3993,1,139205,142547,137994,142625,145393,143041,0.9280333333333334,0.9503133333333333,0.91996,0.9508333333333333,0.9692866666666666,0.9536066666666667,2
5084,280000,1,1,2,38,1,-2,-1,-1,-1,-1,0,0,3898,1460,18901,0,0,3898,1460,18901,0,0,0,0,-3898,2438,-17441,18901,0,0.0,-0.01392142857142857,0.008707142857142858,-0.062289285714285714,0.06750357142857143,0.0,-5
5085,310000,0,2,2,27,0,0,0,0,0,0,22936,255040,241092,242850,237818,237762,240101,9012,8549,8324,8524,9052,0,-217165,246028,232543,234526,229294,228710,-0.7005322580645161,0.7936387096774193,0.7501387096774194,0.7565354838709677,0.739658064516129,0.7377741935483871,0
5086,20000,1,2,1,25,-1,-1,-1,-1,-1,-1,3454,6875,13936,2816,7419,165,6885,14523,2816,7419,0,16963,1,-3431,-7648,11120,-4603,7419,-16798,-0.17155,-0.3824,0.556,-0.23015,0.37095,-0.8399,-6
5087,50000,0,1,2,42,1,2,2,2,2,2,44350,43360,45892,46886,48037,47551,0,3300,2000,2000,396,1600,0,44350,40060,43892,44886,47641,45951,0.887,0.8012,0.87784,0.89772,0.95282,0.91902,11
5088,70000,1,2,1,31,-1,0,0,0,2,2,6895,16381,18715,22630,22276,13564,10000,3000,4100,0,1000,0,1,-3105,13381,14615,22630,21276,13564,-0.04435714285714286,0.19115714285714286,0.2087857142857143,0.3232857142857143,0.3039428571428571,0.19377142857142857,3
5089,20000,1,2,1,48,0,0,2,2,2,2,11492,15791,15806,29542,15484,15046,4500,550,0,1445,0,400,1,6992,15241,15806,28097,15484,14646,0.3496,0.76205,0.7903,1.40485,0.7742,0.7323,8
5090,50000,0,2,2,33,0,0,0,0,0,0,48355,49715,49736,17599,16753,10582,2140,1161,510,503,500,1000,0,46215,48554,49226,17096,16253,9582,0.9243,0.97108,0.98452,0.34192,0.32506,0.19164,0
5091,390000,1,2,2,28,0,0,0,0,0,0,116720,121588,121854,90634,84353,57677,7000,5000,4000,5000,10000,20000,0,109720,116588,117854,85634,74353,37677,0.2813333333333333,0.29894358974358975,0.3021897435897436,0.21957435897435898,0.19064871794871796,0.09660769230769231,0
5092,180000,1,3,1,61,0,0,0,0,0,0,20554,21560,22587,23599,24069,24573,1353,1380,1392,862,892,1000,1,19201,20180,21195,22737,23177,23573,0.10667222222222222,0.1121111111111111,0.11775,0.12631666666666666,0.1287611111111111,0.1309611111111111,0
5093,20000,1,2,1,49,1,2,0,0,0,0,19127,16943,18359,19000,19600,19600,0,2000,1400,1000,0,0,1,19127,14943,16959,18000,19600,19600,0.95635,0.74715,0.84795,0.9,0.98,0.98,3
5094,50000,0,2,2,29,0,0,0,0,0,0,49276,35100,32563,27823,29130,28309,1602,1400,3000,3130,1062,6318,0,47674,33700,29563,24693,28068,21991,0.95348,0.674,0.59126,0.49386,0.56136,0.43982,0
5095,350000,1,1,2,38,-2,-2,-2,-2,-2,-2,10354,29812,15209,9260,2120,2459,29916,15217,9280,2128,2459,11409,0,-19562,14595,5929,7132,-339,-8950,-0.05589142857142857,0.0417,0.01694,0.020377142857142858,-0.0009685714285714286,-0.02557142857142857,-12
5096,60000,1,2,1,35,1,2,2,2,2,3,5601,5366,6772,6515,7906,7487,0,1500,0,1500,0,0,1,5601,3866,6772,5015,7906,7487,0.09335,0.06443333333333333,0.11286666666666667,0.08358333333333333,0.13176666666666667,0.12478333333333333,12
5097,150000,1,1,1,35,0,0,0,0,0,0,38484,43489,48194,32264,25579,0,8000,5175,3000,10000,0,0,1,30484,38314,45194,22264,25579,0,0.20322666666666667,0.2554266666666667,0.30129333333333336,0.14842666666666668,0.17052666666666666,0.0,0
5098,140000,1,1,2,31,-2,-2,-2,-2,-2,-1,15953,24916,12174,3961,3070,2306,25148,12174,3961,3070,2306,450,0,-9195,12742,8213,891,764,1856,-0.06567857142857143,0.09101428571428571,0.05866428571428572,0.006364285714285715,0.0054571428571428575,0.013257142857142858,-11
5099,170000,1,2,1,40,-1,-1,-1,-1,-1,-1,17914,1253,4427,1459,24511,1163,1253,4427,1459,24511,1163,2821,1,16661,-3174,2968,-23052,23348,-1658,0.09800588235294118,-0.01867058823529412,0.017458823529411766,-0.1356,0.13734117647058824,-0.009752941176470587,-6
5100,200000,0,1,2,31,0,0,0,0,0,0,6618,6777,7957,4667,76187,74900,1900,3008,3500,73000,2700,3800,0,4718,3769,4457,-68333,73487,71100,0.02359,0.018845,0.022285,-0.341665,0.367435,0.3555,0
5101,360000,1,1,1,33,1,-2,-2,-1,0,0,-200,-200,0,13467,17800,0,0,200,13467,5300,0,0,1,-200,-400,-13467,8167,17800,0,-0.0005555555555555556,-0.0011111111111111111,-0.037408333333333335,0.022686111111111112,0.049444444444444444,0.0,-4
5102,430000,1,2,1,32,-2,-2,-1,2,0,0,-15308,-33350,95740,77875,62675,48764,8,145740,7,2500,2021,2000,1,-15316,-179090,95733,75375,60654,46764,-0.03561860465116279,-0.41648837209302325,0.22263488372093024,0.1752906976744186,0.14105581395348837,0.10875348837209302,-3
5103,360000,0,1,2,32,-1,-1,-1,-1,-1,-1,389,389,1955,5316,2265,6594,389,1955,5316,2265,6594,2974,0,0,-1566,-3361,3051,-4329,3620,0.0,-0.00435,-0.009336111111111111,0.008475,-0.012025,0.010055555555555555,-6
5104,30000,1,2,1,38,0,0,0,0,0,0,23819,15367,10159,9859,8360,4101,1553,1033,381,384,404,1297,1,22266,14334,9778,9475,7956,2804,0.7422,0.4778,0.32593333333333335,0.31583333333333335,0.2652,0.09346666666666667,0
5105,200000,0,1,2,30,-1,-1,-2,-1,0,0,8985,247,6015,34314,23403,-1839,805,6144,34418,230,1839,0,0,8180,-5897,-28403,34084,21564,-1839,0.0409,-0.029485,-0.142015,0.17042,0.10782,-0.009195,-5
5106,50000,0,3,2,23,0,0,0,0,0,0,47620,41810,36023,28967,29829,30046,1973,1426,1001,1432,1062,997,0,45647,40384,35022,27535,28767,29049,0.91294,0.80768,0.70044,0.5507,0.57534,0.58098,0
5107,260000,1,3,1,40,-2,-2,-2,-2,-2,-2,-6,-6,1302,2752,1114,2212,0,1308,2765,1119,2218,625,1,-6,-1314,-1463,1633,-1104,1587,-2.3076923076923076e-05,-0.0050538461538461536,-0.005626923076923077,0.00628076923076923,-0.0042461538461538465,0.006103846153846154,-12
5108,30000,0,3,2,42,0,0,0,0,0,0,8185,9395,10928,11445,12108,12753,1500,2000,1000,1000,1000,1243,0,6685,7395,9928,10445,11108,11510,0.22283333333333333,0.2465,0.33093333333333336,0.3481666666666667,0.3702666666666667,0.38366666666666666,0
5109,30000,1,2,2,23,1,2,2,2,2,2,11174,11989,12997,12491,13374,13017,1300,1500,0,1090,0,2000,0,9874,10489,12997,11401,13374,11017,0.32913333333333333,0.34963333333333335,0.43323333333333336,0.38003333333333333,0.4458,0.36723333333333336,11
5110,110000,1,2,2,23,0,0,0,0,0,0,37129,32761,26428,23043,20338,7680,1800,1554,1212,0,0,74458,0,35329,31207,25216,23043,20338,-66778,0.3211727272727273,0.2837,0.22923636363636363,0.20948181818181819,0.18489090909090908,-0.6070727272727273,0
5111,150000,1,2,1,47,-1,-1,-1,-1,-1,2,316,316,316,0,782,316,316,316,0,1098,0,0,1,0,0,316,-1098,782,316,0.0,0.0,0.002106666666666667,-0.00732,0.005213333333333334,0.002106666666666667,-3
5112,430000,1,1,2,33,0,0,0,0,2,2,40984,37873,34499,28300,24237,12860,10000,5000,10000,0,4000,10000,0,30984,32873,24499,28300,20237,2860,0.07205581395348837,0.07644883720930233,0.05697441860465116,0.06581395348837209,0.04706279069767442,0.006651162790697674,4
5113,20000,0,2,2,30,1,2,0,0,2,0,17819,17244,18938,19836,19390,19664,0,2000,1500,0,1000,1500,0,17819,15244,17438,19836,18390,18164,0.89095,0.7622,0.8719,0.9918,0.9195,0.9082,5
5114,100000,0,2,1,33,2,0,0,0,0,0,66393,67827,69202,70153,71468,72930,3100,3100,2700,2600,2650,2800,1,63293,64727,66502,67553,68818,70130,0.63293,0.64727,0.66502,0.67553,0.68818,0.7013,2
5115,210000,1,2,2,25,-1,-1,0,0,-1,-1,648,34601,30853,13774,3988,0,39637,1371,1000,11197,0,3223,0,-38989,33230,29853,2577,3988,-3223,-0.18566190476190475,0.15823809523809523,0.14215714285714287,0.012271428571428572,0.01899047619047619,-0.015347619047619047,-4
5116,230000,0,1,2,27,0,0,0,0,0,0,24874,19500,11717,7540,9941,6113,2000,2000,3540,5000,3113,90417,0,22874,17500,8177,2540,6828,-84304,0.09945217391304348,0.07608695652173914,0.03555217391304348,0.011043478260869564,0.02968695652173913,-0.3665391304347826,0
5117,20000,0,2,3,53,0,0,0,0,0,0,18856,19840,18588,17650,18003,18390,1318,1298,1260,613,645,732,0,17538,18542,17328,17037,17358,17658,0.8769,0.9271,0.8664,0.85185,0.8679,0.8829,0
5118,20000,0,2,3,35,1,-2,-2,-2,-2,-2,0,0,0,0,0,0,0,0,0,0,0,0,0,0,0,0,0,0,0,0.0,0.0,0.0,0.0,0.0,0.0,-9
5119,200000,1,1,2,32,0,0,0,0,0,0,47517,8219,9000,10000,11340,0,1219,1000,1000,1340,0,0,0,46298,7219,8000,8660,11340,0,0.23149,0.036095,0.04,0.0433,0.0567,0.0,0
5120,360000,0,2,1,30,2,2,2,2,2,-2,2500,2500,2500,2500,0,0,0,0,0,0,0,0,1,2500,2500,2500,2500,0,0,0.006944444444444444,0.006944444444444444,0.006944444444444444,0.006944444444444444,0.0,0.0,8
5121,30000,0,3,1,49,2,2,2,2,2,2,26343,27127,26393,29646,30390,29755,1500,0,3712,1363,0,1141,1,24843,27127,22681,28283,30390,28614,0.8281,0.9042333333333333,0.7560333333333333,0.9427666666666666,1.013,0.9538,12
5122,320000,1,1,1,38,1,-2,-2,-2,-2,-2,0,0,0,0,0,0,0,0,0,0,0,0,1,0,0,0,0,0,0,0.0,0.0,0.0,0.0,0.0,0.0,-9
5123,140000,0,3,1,32,0,0,0,0,0,0,140456,125288,117263,77496,79815,77911,5200,5006,5000,5000,3000,5000,1,135256,120282,112263,72496,76815,72911,0.9661142857142857,0.8591571428571428,0.8018785714285714,0.5178285714285714,0.5486785714285715,0.5207928571428572,0
5124,200000,1,2,1,30,1,-2,-1,0,0,0,26223,-137,73284,65428,65820,2859,0,73421,1309,392,2859,1250,1,26223,-73558,71975,65036,62961,1609,0.131115,-0.36779,0.359875,0.32518,0.314805,0.008045,-2
5125,130000,1,1,2,29,0,0,0,0,0,0,41224,45136,48970,52740,56467,60119,4500,4500,4500,4500,4500,4500,0,36724,40636,44470,48240,51967,55619,0.2824923076923077,0.3125846153846154,0.34207692307692306,0.3710769230769231,0.39974615384615386,0.42783846153846156,0
5126,170000,1,1,2,30,1,-2,-1,-1,-2,-2,0,0,550,0,0,0,0,550,0,0,0,0,0,0,-550,550,0,0,0,0.0,-0.003235294117647059,0.003235294117647059,0.0,0.0,0.0,-7
5127,190000,1,1,2,26,0,0,0,0,0,2,31061,32129,33142,33726,35758,35171,1750,1720,1300,2600,0,1400,0,29311,30409,31842,31126,35758,33771,0.15426842105263158,0.16004736842105263,0.16758947368421054,0.16382105263157895,0.1882,0.1777421052631579,2
5128,240000,0,1,1,47,1,2,2,2,2,2,138103,134976,137251,144457,147604,145071,500,6000,11000,5600,0,11077,1,137603,128976,126251,138857,147604,133994,0.5733458333333333,0.5374,0.5260458333333333,0.5785708333333334,0.6150166666666667,0.5583083333333333,11
5129,20000,1,3,1,38,-1,-1,0,0,0,-1,1118,12776,11417,16449,6989,2021,12783,1000,6782,670,2021,0,1,-11665,11776,4635,15779,4968,2021,-0.58325,0.5888,0.23175,0.78895,0.2484,0.10105,-3
5130,270000,1,2,1,42,-1,-1,2,-1,-1,-1,1138,11899,5794,19857,3681,3188,11921,329,20218,3699,3204,13193,1,-10783,11570,-14424,16158,477,-10005,-0.039937037037037035,0.04285185185185185,-0.053422222222222225,0.05984444444444444,0.0017666666666666666,-0.03705555555555556,-3
5131,180000,0,1,2,32,0,0,0,0,0,0,154374,153018,146396,136531,138502,136665,7500,7000,5000,5000,6000,5137,0,146874,146018,141396,131531,132502,131528,0.8159666666666666,0.8112111111111111,0.7855333333333333,0.7307277777777778,0.7361222222222222,0.7307111111111111,0
5132,10000,1,2,1,51,1,2,0,0,0,0,9151,8855,9828,8637,8808,8995,0,1133,1144,315,329,363,1,9151,7722,8684,8322,8479,8632,0.9151,0.7722,0.8684,0.8322,0.8479,0.8632,3
5133,50000,0,2,1,38,0,0,0,0,0,0,22178,21976,21697,20683,19283,19965,1700,1650,850,700,1000,1000,1,20478,20326,20847,19983,18283,18965,0.40956,0.40652,0.41694,0.39966,0.36566,0.3793,0
5134,240000,1,1,1,36,-1,-1,-1,0,-1,-1,7058,4786,6853,5673,7588,2737,4789,6853,113,7588,2737,0,1,2269,-2067,6740,-1915,4851,2737,0.009454166666666666,-0.0086125,0.02808333333333333,-0.007979166666666667,0.0202125,0.011404166666666667,-5
5135,20000,0,2,2,24,0,0,2,3,2,2,14068,16706,18342,17755,17967,17538,3200,2200,0,800,0,1401,0,10868,14506,18342,16955,17967,16137,0.5434,0.7253,0.9171,0.84775,0.89835,0.80685,9
5136,80000,0,2,2,28,0,0,0,0,2,0,47916,49964,49965,50142,46888,47592,3122,2123,4300,0,2800,3000,0,44794,47841,45665,50142,44088,44592,0.559925,0.5980125,0.5708125,0.626775,0.5511,0.5574,2
5137,290000,0,3,1,47,2,0,0,0,0,-1,255412,217382,250549,31370,-4020,107239,5130,4647,949,4391,146216,60686,1,250282,212735,249600,26979,-150236,46553,0.8630413793103449,0.7335689655172414,0.8606896551724138,0.09303103448275862,-0.5180551724137931,0.16052758620689656,1
5138,300000,1,2,2,29,0,0,0,0,0,0,164437,140536,124802,80088,25283,12358,5100,6001,3500,705,3000,2300,0,159337,134535,121302,79383,22283,10058,0.5311233333333333,0.44845,0.40434,0.26461,0.07427666666666667,0.03352666666666667,0
5139,30000,0,2,3,43,2,2,2,2,2,2,14870,16327,16762,17182,17760,17327,2000,1000,1000,1000,0,1000,0,12870,15327,15762,16182,17760,16327,0.429,0.5109,0.5254,0.5394,0.592,0.5442333333333333,12
5140,90000,0,3,1,35,0,0,0,0,0,0,86821,71263,73515,74100,23500,23500,4000,4000,3000,0,0,0,1,82821,67263,70515,74100,23500,23500,0.9202333333333333,0.7473666666666666,0.7835,0.8233333333333334,0.2611111111111111,0.2611111111111111,0
5141,80000,1,2,2,24,2,2,2,2,2,2,22453,23787,23124,26700,27064,27685,2000,0,4300,1100,1200,0,0,20453,23787,18824,25600,25864,27685,0.2556625,0.2973375,0.2353,0.32,0.3233,0.3460625,12
5142,200000,1,1,1,42,-2,-2,-2,-2,-1,-1,0,0,0,0,1830,0,0,0,0,1830,0,0,1,0,0,0,-1830,1830,0,0.0,0.0,0.0,-0.00915,0.00915,0.0,-10
5143,50000,0,2,2,24,0,0,0,0,0,0,49076,48923,49158,19270,18776,19167,2063,1298,700,800,815,237,0,47013,47625,48458,18470,17961,18930,0.94026,0.9525,0.96916,0.3694,0.35922,0.3786,0
5144,170000,0,1,1,33,1,2,-1,0,0,0,9020,326,7788,104556,141077,138790,0,7788,100000,41077,5200,5600,1,9020,-7462,-92212,63479,135877,133190,0.05305882352941176,-0.043894117647058827,-0.5424235294117647,0.3734058823529412,0.7992764705882353,0.7834705882352941,2
5145,30000,0,1,2,32,0,0,2,0,0,0,29250,30496,29702,28839,29375,32729,3600,0,1500,1300,4000,0,0,25650,30496,28202,27539,25375,32729,0.855,1.0165333333333333,0.9400666666666667,0.9179666666666667,0.8458333333333333,1.0909666666666666,2
5146,100000,1,1,1,37,0,0,0,0,0,0,68760,70113,71567,72410,73846,75556,3095,3181,2628,2640,2897,3600,1,65665,66932,68939,69770,70949,71956,0.65665,0.66932,0.68939,0.6977,0.70949,0.71956,0
5147,300000,0,1,2,43,-1,-1,-1,-1,0,0,163,2508,8534,14378,16245,19047,2508,8534,14378,4000,6550,0,0,-2345,-6026,-5844,10378,9695,19047,-0.007816666666666666,-0.020086666666666666,-0.01948,0.03459333333333333,0.03231666666666667,0.06349,-4
5148,170000,1,3,1,61,1,-2,-2,-2,-1,-1,0,0,0,0,200,0,0,0,0,200,0,0,1,0,0,0,-200,200,0,0.0,0.0,0.0,-0.001176470588235294,0.001176470588235294,0.0,-7
5149,70000,1,1,2,28,0,-1,-1,-1,-1,-1,12018,39270,603,2288,1380,2028,39270,603,2288,1380,2028,390,0,-27252,38667,-1685,908,-648,1638,-0.3893142857142857,0.5523857142857143,-0.02407142857142857,0.012971428571428571,-0.009257142857142858,0.0234,-5
5150,360000,0,1,2,38,-2,-2,-2,-2,-2,-2,0,0,0,0,0,0,0,0,0,0,0,0,0,0,0,0,0,0,0,0.0,0.0,0.0,0.0,0.0,0.0,-12
5151,220000,0,2,2,39,-1,-1,0,0,0,0,3553,15696,17257,21624,26246,30781,15696,5000,5000,5000,5000,5000,0,-12143,10696,12257,16624,21246,25781,-0.05519545454545455,0.04861818181818182,0.05571363636363636,0.07556363636363636,0.09657272727272727,0.11718636363636363,-2
5152,150000,1,2,2,23,0,0,0,0,0,0,167317,166596,165990,161285,156749,151863,10000,10000,6000,6000,5500,5500,0,157317,156596,159990,155285,151249,146363,1.04878,1.0439733333333334,1.0666,1.0352333333333332,1.0083266666666666,0.9757533333333334,0
5153,60000,1,2,1,30,-1,0,0,0,0,0,54379,55029,54422,19843,19095,19495,2269,1385,1000,693,717,661,1,52110,53644,53422,19150,18378,18834,0.8685,0.8940666666666667,0.8903666666666666,0.31916666666666665,0.3063,0.3139,-1
5154,50000,1,2,1,44,0,0,-2,-2,-2,-2,49644,0,0,0,0,0,0,0,0,0,0,0,1,49644,0,0,0,0,0,0.99288,0.0,0.0,0.0,0.0,0.0,-8
5155,540000,1,2,1,50,0,0,0,0,0,0,66637,66665,66513,67149,66880,67667,3100,3070,3100,2320,2796,3500,1,63537,63595,63413,64829,64084,64167,0.1176611111111111,0.11776851851851852,0.11743148148148148,0.1200537037037037,0.11867407407407407,0.11882777777777778,0
5156,20000,0,2,2,26,-1,-1,-1,-1,-2,-1,1438,1261,451,-810,-420,1320,1261,451,0,780,2130,0,0,177,810,451,-1590,-2550,1320,0.00885,0.0405,0.02255,-0.0795,-0.1275,0.066,-7
5157,140000,0,2,2,30,-1,-1,0,0,2,2,188,6229,7936,13194,5692,8410,6229,2000,5600,0,3002,2,0,-6041,4229,2336,13194,2690,8408,-0.04315,0.030207142857142856,0.016685714285714286,0.09424285714285714,0.019214285714285715,0.06005714285714286,2
5158,80000,1,1,2,29,0,0,0,0,0,2,19833,21192,22842,24147,29133,28532,2000,2000,2000,5394,0,5000,0,17833,19192,20842,18753,29133,23532,0.2229125,0.2399,0.260525,0.2344125,0.3641625,0.29415,2
5159,130000,0,2,1,24,0,0,2,0,0,0,46113,49520,47627,47262,46226,390,5000,0,1925,0,0,780,1,41113,49520,45702,47262,46226,-390,0.31625384615384616,0.3809230769230769,0.35155384615384616,0.36355384615384617,0.3555846153846154,-0.003,2
5160,170000,0,1,2,48,2,2,7,7,7,7,2400,2400,2400,2400,2400,2400,0,0,0,0,0,0,0,2400,2400,2400,2400,2400,2400,0.01411764705882353,0.01411764705882353,0.01411764705882353,0.01411764705882353,0.01411764705882353,0.01411764705882353,32
5161,350000,1,1,2,36,-1,-1,-1,-1,0,-1,655,23524,-3626,6531,4440,750,23537,5,10971,0,750,0,0,-22882,23519,-14597,6531,3690,750,-0.06537714285714286,0.06719714285714286,-0.04170571428571428,0.01866,0.010542857142857142,0.002142857142857143,-5
5162,230000,1,3,2,30,-2,-2,-2,-1,2,0,122344,115723,44178,4221,4009,8990,5492,2600,7797,0,5180,4606,0,116852,113123,36381,4221,-1171,4384,0.5080521739130435,0.4918391304347826,0.1581782608695652,0.018352173913043477,-0.005091304347826087,0.01906086956521739,-5
5163,120000,0,1,1,48,2,-1,-1,-1,-1,-1,360,360,360,360,150,870,360,360,360,150,870,510,1,0,0,0,210,-720,360,0.0,0.0,0.0,0.00175,-0.006,0.003,-3
5164,80000,0,2,2,25,0,0,0,0,0,0,63771,62642,60005,53384,55060,54583,2500,2500,1900,2500,2500,2000,0,61271,60142,58105,50884,52560,52583,0.7658875,0.751775,0.7263125,0.63605,0.657,0.6572875,0
5165,50000,0,2,2,23,-1,-1,2,0,0,0,45708,48316,44070,45021,45145,46470,6000,0,2000,2000,3000,3600,0,39708,48316,42070,43021,42145,42870,0.79416,0.96632,0.8414,0.86042,0.8429,0.8574,0
5166,50000,0,2,2,24,0,0,0,0,0,0,44193,44790,29397,29157,29765,29941,1806,1752,1168,1205,1207,1199,0,42387,43038,28229,27952,28558,28742,0.84774,0.86076,0.56458,0.55904,0.57116,0.57484,0
5167,360000,0,2,1,47,-2,-2,-2,-2,-2,-2,1730,2500,0,0,0,0,2500,0,0,0,0,0,1,-770,2500,0,0,0,0,-0.002138888888888889,0.006944444444444444,0.0,0.0,0.0,0.0,-12
5168,200000,1,4,2,27,-2,-2,-2,-2,-2,-2,0,0,0,0,0,0,0,0,0,0,0,0,0,0,0,0,0,0,0,0.0,0.0,0.0,0.0,0.0,0.0,-12
5169,130000,1,3,1,34,0,0,2,0,0,0,124777,133265,129713,129883,122349,101415,12000,0,5100,4820,3844,4500,1,112777,133265,124613,125063,118505,96915,0.8675153846153846,1.0251153846153847,0.9585615384615385,0.9620230769230769,0.9115769230769231,0.7455,2
5170,120000,1,2,1,37,-1,-1,2,0,-1,0,15591,17156,17227,18560,10067,15594,7227,683,8560,10067,10000,7223,1,8364,16473,8667,8493,67,8371,0.0697,0.137275,0.072225,0.070775,0.0005583333333333333,0.06975833333333334,-1
5171,80000,1,3,1,50,0,0,0,0,0,0,6627,9503,11966,14493,20328,23506,3000,3000,3000,8000,3506,3000,1,3627,6503,8966,6493,16822,20506,0.0453375,0.0812875,0.112075,0.0811625,0.210275,0.256325,0
5172,20000,0,2,2,45,0,0,0,2,0,0,17369,28513,27836,23480,19469,16310,15000,3273,0,389,326,813,0,2369,25240,27836,23091,19143,15497,0.11845,1.262,1.3918,1.15455,0.95715,0.77485,2
5173,260000,0,2,1,37,0,0,0,0,0,0,131472,134283,130398,134075,130448,134477,5036,5000,5035,5000,5097,5008,1,126436,129283,125363,129075,125351,129469,0.4862923076923077,0.4972423076923077,0.4821653846153846,0.4964423076923077,0.48211923076923074,0.4979576923076923,0
5174,290000,1,1,1,41,-1,-1,-1,-1,-2,-1,11200,0,970,0,0,2184,0,970,0,0,2184,1140,1,11200,-970,970,0,-2184,1044,0.038620689655172416,-0.0033448275862068967,0.0033448275862068967,0.0,-0.007531034482758621,0.0036,-7
5175,350000,0,1,1,38,-1,-1,-1,-1,-1,-1,17999,38899,24620,22381,13115,5167,38933,24692,22388,13115,5167,11325,1,-20934,14207,2232,9266,7948,-6158,-0.05981142857142857,0.04059142857142857,0.006377142857142857,0.026474285714285714,0.02270857142857143,-0.017594285714285715,-6
5176,50000,1,1,2,23,0,0,0,2,2,2,15252,16885,18500,18864,19807,19407,2200,2200,1000,1500,0,3000,0,13052,14685,17500,17364,19807,16407,0.26104,0.2937,0.35,0.34728,0.39614,0.32814,6
5177,50000,1,2,2,25,0,0,0,0,0,0,50485,50397,49167,45077,36815,38203,2000,3045,1660,1500,2000,10000,0,48485,47352,47507,43577,34815,28203,0.9697,0.94704,0.95014,0.87154,0.6963,0.56406,0
5178,60000,1,1,1,33,-1,0,-1,-1,-1,0,14932,12840,390,390,780,390,5000,10390,390,780,0,390,1,9932,2450,0,-390,780,0,0.16553333333333334,0.04083333333333333,0.0,-0.0065,0.013,0.0,-4
5179,60000,1,2,2,22,0,0,0,0,2,2,60434,60935,56585,77520,29002,30274,2141,3085,3623,0,3158,0,0,58293,57850,52962,77520,25844,30274,0.97155,0.9641666666666666,0.8827,1.292,0.43073333333333336,0.5045666666666667,4
5180,360000,0,2,1,44,-2,-2,-2,-2,-2,-2,1824,1740,0,0,1499,4001,1740,0,0,1499,4001,203,1,84,1740,0,-1499,-2502,3798,0.00023333333333333333,0.004833333333333334,0.0,-0.004163888888888889,-0.00695,0.01055,-12
5181,20000,1,2,2,26,2,2,2,0,0,0,19017,20018,19384,19405,19978,19791,1600,0,600,847,670,483,0,17417,20018,18784,18558,19308,19308,0.87085,1.0009,0.9392,0.9279,0.9654,0.9654,6
5182,70000,1,3,1,34,0,0,-1,0,0,0,5219,6747,19948,20231,20757,18357,3092,19948,3000,3002,1002,2102,1,2127,-13201,16948,17229,19755,16255,0.030385714285714287,-0.18858571428571427,0.24211428571428573,0.24612857142857142,0.2822142857142857,0.2322142857142857,-1
5183,50000,0,2,1,56,1,2,0,0,0,0,32134,30391,10725,10541,10052,10400,0,1159,365,448,600,0,1,32134,29232,10360,10093,9452,10400,0.64268,0.58464,0.2072,0.20186,0.18904,0.208,3
5184,230000,0,1,1,37,-2,-2,-2,-2,-2,-2,1464,1742,3267,800,2458,1880,1742,3267,800,2458,1880,2414,1,-278,-1525,2467,-1658,578,-534,-0.001208695652173913,-0.006630434782608696,0.01072608695652174,-0.007208695652173913,0.0025130434782608697,-0.0023217391304347825,-12
5185,200000,1,2,1,31,3,2,2,2,2,2,5000,5000,5000,5000,5000,5000,0,0,0,0,0,0,1,5000,5000,5000,5000,5000,5000,0.025,0.025,0.025,0.025,0.025,0.025,13
5186,400000,1,1,1,40,-1,-1,-1,-1,-1,-1,6376,4925,4382,1240,167621,3284,5949,4403,1250,168459,3301,11168,1,427,522,3132,-167219,164320,-7884,0.0010675,0.001305,0.00783,-0.4180475,0.4108,-0.01971,-6
5187,230000,1,1,1,32,-2,-2,-2,-2,-2,-2,2774,0,0,0,0,5347,0,0,0,0,5347,0,1,2774,0,0,0,-5347,5347,0.012060869565217392,0.0,0.0,0.0,-0.02324782608695652,0.02324782608695652,-12
5188,50000,1,3,1,47,0,-1,-1,-1,-1,0,1091,390,1554,390,780,390,390,1554,390,780,0,390,1,701,-1164,1164,-390,780,0,0.01402,-0.02328,0.02328,-0.0078,0.0156,0.0,-4
5189,440000,0,1,2,31,0,0,-1,-1,0,0,37547,29349,23713,25427,21187,26486,20016,29748,25448,10015,14501,11501,0,17531,-399,-1735,15412,6686,14985,0.03984318181818182,-0.0009068181818181818,-0.003943181818181818,0.035027272727272726,0.015195454545454545,0.03405681818181818,-2
5190,320000,0,1,2,36,0,0,0,0,0,-1,146201,129311,112151,84218,76058,24068,5465,3137,52,2384,25094,30011,0,140736,126174,112099,81834,50964,-5943,0.4398,0.39429375,0.350309375,0.25573125,0.1592625,-0.018571875,-1
5191,400000,1,3,2,35,-2,-2,-2,-2,-2,-2,1432,8125,7017,10525,13295,11024,8132,7018,10542,13378,11045,6666,0,-6700,1107,-3525,-2853,2250,4358,-0.01675,0.0027675,-0.0088125,-0.0071325,0.005625,0.010895,-12
5192,150000,0,2,1,40,0,0,0,0,0,0,141697,144833,137737,140047,144557,133716,7000,7000,6000,7000,5021,9000,1,134697,137833,131737,133047,139536,124716,0.89798,0.9188866666666666,0.8782466666666666,0.88698,0.93024,0.83144,0
5193,320000,1,1,2,30,-2,-2,-2,-2,-2,-2,1259,5152,4257,-3,-3,670,5177,4278,0,0,673,11288,0,-3918,874,4257,-3,-676,-10618,-0.01224375,0.00273125,0.013303125,-9.375e-06,-0.0021125,-0.03318125,-12
5194,110000,1,2,2,24,2,2,2,2,2,2,107378,109604,111661,112299,113035,109678,5500,5300,4000,4000,0,4540,0,101878,104304,107661,108299,113035,105138,0.9261636363636364,0.9482181818181818,0.9787363636363636,0.9845363636363637,1.027590909090909,0.9558,12
5195,310000,0,2,1,36,0,0,0,0,0,0,32782,33587,39572,44598,50570,64916,11406,10773,10819,15766,20645,5000,1,21376,22814,28753,28832,29925,59916,0.06895483870967742,0.07359354838709678,0.09275161290322581,0.09300645161290323,0.09653225806451612,0.19327741935483872,0
5196,50000,1,2,1,36,2,2,2,0,0,2,2590,4836,4613,5378,5848,5606,2458,0,1000,557,0,2000,1,132,4836,3613,4821,5848,3606,0.00264,0.09672,0.07226,0.09642,0.11696,0.07212,8
5197,20000,1,2,2,22,0,0,0,0,2,2,12932,13940,14654,16712,16149,18112,1532,1246,2304,0,2390,634,0,11400,12694,12350,16712,13759,17478,0.57,0.6347,0.6175,0.8356,0.68795,0.8739,4
5198,160000,1,3,2,25,-1,-1,-1,-1,-1,-1,141,-756,11520,1520,5171,3716,201,13040,0,5171,3716,107,0,-60,-13796,11520,-3651,1455,3609,-0.000375,-0.086225,0.072,-0.02281875,0.00909375,0.02255625,-6
5199,50000,0,2,2,25,0,-1,2,0,0,0,1552,2452,1878,1482,326,-70,2452,0,0,0,0,3000,0,-900,2452,1878,1482,326,-3070,-0.018,0.04904,0.03756,0.02964,0.00652,-0.0614,1
5200,130000,1,2,1,27,2,2,0,0,2,0,60032,54921,55055,54804,52439,52609,0,2000,6844,0,2071,2115,1,60032,52921,48211,54804,50368,50494,0.4617846153846154,0.4070846153846154,0.37085384615384615,0.42156923076923075,0.38744615384615383,0.3884153846153846,6
5201,30000,1,2,2,25,0,0,0,2,2,2,25664,26693,28456,29687,30690,31093,1448,2211,2000,1626,1049,11,0,24216,24482,26456,28061,29641,31082,0.8072,0.8160666666666667,0.8818666666666667,0.9353666666666667,0.9880333333333333,1.0360666666666667,6
5202,50000,0,2,1,39,0,0,0,0,0,0,11665,12405,13355,13622,11550,11713,1232,1182,449,565,504,233,1,10433,11223,12906,13057,11046,11480,0.20866,0.22446,0.25812,0.26114,0.22092,0.2296,0
5203,20000,1,1,2,24,0,0,2,0,0,0,3634,6568,7307,8027,8892,9739,3000,1000,1000,1000,1000,1000,0,634,5568,6307,7027,7892,8739,0.0317,0.2784,0.31535,0.35135,0.3946,0.43695,2
5204,150000,1,4,1,25,2,0,0,0,0,0,156252,121999,28119,100540,88865,88526,3468,1867,92920,3578,3000,2200,1,152784,120132,-64801,96962,85865,86326,1.01856,0.80088,-0.43200666666666665,0.6464133333333333,0.5724333333333333,0.5755066666666667,2
5205,50000,1,3,1,51,0,0,0,0,0,0,50448,34741,21312,17398,17773,17368,2017,2130,500,2000,2000,2000,1,48431,32611,20812,15398,15773,15368,0.96862,0.65222,0.41624,0.30796,0.31546,0.30736,0
5206,240000,0,1,2,33,1,-2,-2,-2,-2,-1,0,0,0,0,0,41300,0,0,0,0,41300,868,0,0,0,0,0,-41300,40432,0.0,0.0,0.0,0.0,-0.17208333333333334,0.16846666666666665,-8
5207,70000,1,2,1,51,2,2,2,2,2,2,43913,44911,45772,46611,47508,48476,2000,1900,1900,1800,1900,1900,1,41913,43011,43872,44811,45608,46576,0.5987571428571429,0.6144428571428572,0.6267428571428572,0.6401571428571429,0.6515428571428571,0.6653714285714286,12
5208,90000,1,3,3,51,0,0,0,0,2,0,11315,12340,13349,14276,13904,14184,1212,1221,1148,0,510,525,0,10103,11119,12201,14276,13394,13659,0.11225555555555555,0.12354444444444444,0.13556666666666667,0.15862222222222222,0.14882222222222222,0.15176666666666666,2
5209,40000,1,2,2,33,0,0,0,0,0,0,34253,34954,36093,36891,37019,40734,1567,2000,2000,1318,4610,0,0,32686,32954,34093,35573,32409,40734,0.81715,0.82385,0.852325,0.889325,0.810225,1.01835,0
5210,300000,0,1,1,45,0,0,0,0,0,0,193462,185703,190060,189912,145909,127078,6835,7542,7930,6534,6153,2815,1,186627,178161,182130,183378,139756,124263,0.62209,0.59387,0.6071,0.61126,0.46585333333333334,0.41421,0
5211,20000,0,1,2,22,0,0,0,0,0,0,14720,15432,16252,14877,9487,-5910,3880,1200,298,5390,4000,9666,0,10840,14232,15954,9487,5487,-15576,0.542,0.7116,0.7977,0.47435,0.27435,-0.7788,0
5212,210000,1,1,1,52,-1,-1,-1,-2,-1,-1,262,738,0,0,1858,45,738,0,0,1858,45,3667,1,-476,738,0,-1858,1813,-3622,-0.002266666666666667,0.003514285714285714,0.0,-0.008847619047619047,0.008633333333333333,-0.017247619047619046,-7
5213,260000,1,1,1,42,-1,-1,-1,-2,-2,-2,78,984,0,0,0,0,984,0,0,0,0,0,1,-906,984,0,0,0,0,-0.0034846153846153846,0.0037846153846153845,0.0,0.0,0.0,0.0,-9
5214,230000,1,2,2,29,0,0,0,0,0,0,24524,24897,22219,23512,12894,15183,3000,4000,3047,3000,3000,3000,0,21524,20897,19172,20512,9894,12183,0.09358260869565217,0.09085652173913043,0.08335652173913044,0.08918260869565217,0.04301739130434783,0.0529695652173913,0
5215,50000,0,2,2,25,0,0,0,0,0,2,29425,30932,32128,33588,38106,37364,2000,2000,2000,5100,0,4000,0,27425,28932,30128,28488,38106,33364,0.5485,0.57864,0.60256,0.56976,0.76212,0.66728,2
5216,190000,1,3,2,46,0,0,0,0,0,0,124245,126722,129376,132016,134632,137470,4536,4696,4791,4811,5000,5033,0,119709,122026,124585,127205,129632,132437,0.6300473684210526,0.642242105263158,0.6557105263157895,0.6695,0.6822736842105264,0.6970368421052632,0
5217,80000,0,2,2,36,0,0,0,0,0,0,79148,52174,44275,42029,33838,29757,2000,2000,1500,1500,2000,1500,0,77148,50174,42775,40529,31838,28257,0.96435,0.627175,0.5346875,0.5066125,0.397975,0.3532125,0
5218,220000,0,2,1,43,0,0,0,0,0,0,84466,84356,84151,83591,83789,83885,4000,4000,3500,3500,3500,3500,1,80466,80356,80651,80091,80289,80385,0.36575454545454544,0.36525454545454544,0.36659545454545456,0.36405,0.36495,0.3653863636363636,0
5219,40000,0,2,3,41,0,0,0,0,0,0,39295,38490,38224,37764,38029,32179,1786,1890,2000,1104,948,337,0,37509,36600,36224,36660,37081,31842,0.937725,0.915,0.9056,0.9165,0.927025,0.79605,0
5220,60000,0,3,2,57,0,0,0,0,0,0,15602,16629,17638,17989,18383,21781,1284,1293,644,684,3721,761,0,14318,15336,16994,17305,14662,21020,0.23863333333333334,0.2556,0.28323333333333334,0.28841666666666665,0.24436666666666668,0.35033333333333333,0
5221,80000,1,1,2,23,0,0,0,0,0,0,80133,74838,62696,27693,25594,29155,3539,3180,818,1018,10006,3616,0,76594,71658,61878,26675,15588,25539,0.957425,0.895725,0.773475,0.3334375,0.19485,0.3192375,0
5222,30000,0,2,1,36,0,0,2,0,0,0,18441,19936,20803,21655,22646,23764,1800,1500,1500,1500,1500,1500,1,16641,18436,19303,20155,21146,22264,0.5547,0.6145333333333334,0.6434333333333333,0.6718333333333333,0.7048666666666666,0.7421333333333333,2
5223,50000,0,1,2,39,0,0,0,0,0,0,47174,47974,48630,50803,30789,15874,1800,2000,3000,2000,2000,2000,0,45374,45974,45630,48803,28789,13874,0.90748,0.91948,0.9126,0.97606,0.57578,0.27748,0
5224,80000,1,2,2,30,0,0,2,0,0,0,80681,84064,79988,79291,53876,49513,6900,0,4382,1822,2000,2000,0,73781,84064,75606,77469,51876,47513,0.9222625,1.0508,0.945075,0.9683625,0.64845,0.5939125,2
5225,120000,0,2,1,34,-1,-1,-1,-1,0,0,6059,1943,2402,18700,9900,0,1943,2500,38098,5000,0,0,1,4116,-557,-35696,13700,9900,0,0.0343,-0.004641666666666666,-0.29746666666666666,0.11416666666666667,0.0825,0.0,-4
5226,20000,0,2,2,25,0,0,0,0,0,-1,10642,11677,13070,12280,1615,1620,1200,1593,601,135,1824,0,0,9442,10084,12469,12145,-209,1620,0.4721,0.5042,0.62345,0.60725,-0.01045,0.081,-1
5227,440000,0,1,2,33,-1,-1,-1,-1,0,-1,2976,16911,5945,17165,1176,18377,16911,5945,17165,0,18377,1759,0,-13935,10966,-11220,17165,-17201,16618,-0.03167045454545454,0.024922727272727273,-0.0255,0.039011363636363636,-0.03909318181818182,0.03776818181818182,-5
5228,50000,1,1,2,32,0,0,0,0,0,0,5458,5175,12950,11188,12167,14873,1500,7956,3188,2200,7000,2810,0,3958,-2781,9762,8988,5167,12063,0.07916,-0.05562,0.19524,0.17976,0.10334,0.24126,0
5229,20000,1,3,1,43,0,0,0,0,0,0,14959,32006,17139,17979,18518,15243,1600,1700,1500,1000,1000,1780,1,13359,30306,15639,16979,17518,13463,0.66795,1.5153,0.78195,0.84895,0.8759,0.67315,0
5230,90000,1,2,1,41,0,0,0,0,0,0,61287,62678,63198,61633,62837,69422,3021,4236,3000,2000,7000,0,1,58266,58442,60198,59633,55837,69422,0.6474,0.6493555555555556,0.6688666666666667,0.6625888888888889,0.6204111111111111,0.7713555555555556,0
5231,90000,1,2,2,42,0,0,0,-1,-1,-1,92837,95413,94460,10031,11243,3343,4500,2000,10061,11277,3808,14741,0,88337,93413,84399,-1246,7435,-11398,0.9815222222222222,1.0379222222222222,0.9377666666666666,-0.013844444444444444,0.08261111111111111,-0.12664444444444445,-3
5232,20000,1,2,2,26,1,2,2,0,0,0,19725,17368,16801,17789,17419,17628,1293,0,1281,771,640,790,0,18432,17368,15520,17018,16779,16838,0.9216,0.8684,0.776,0.8509,0.83895,0.8419,5
5233,30000,1,2,1,49,2,0,0,0,2,2,23778,24507,25892,27366,26798,28321,1415,1800,2200,0,2500,0,1,22363,22707,23692,27366,24298,28321,0.7454333333333333,0.7569,0.7897333333333333,0.9122,0.8099333333333333,0.9440333333333333,6
5234,160000,1,1,1,43,-1,-1,-1,-1,-1,-1,2980,2817,0,450,748,5054,2817,0,450,748,5054,4711,1,163,2817,-450,-298,-4306,343,0.00101875,0.01760625,-0.0028125,-0.0018625,-0.0269125,0.00214375,-6
5235,180000,1,1,2,46,-2,-2,-2,-2,-2,-2,0,0,0,0,0,0,0,0,0,0,0,0,0,0,0,0,0,0,0,0.0,0.0,0.0,0.0,0.0,0.0,-12
5236,230000,0,1,2,39,-1,-1,-1,2,-1,-1,834,-150,517,53,603,10141,0,667,0,700,10200,5200,0,834,-817,517,-647,-9597,4941,0.003626086956521739,-0.003552173913043478,0.002247826086956522,-0.0028130434782608696,-0.04172608695652174,0.021482608695652175,-3
5237,110000,1,2,1,45,0,0,0,0,0,0,36267,37234,37341,38208,39121,39785,1587,1694,1561,1474,1370,1514,1,34680,35540,35780,36734,37751,38271,0.31527272727272726,0.3230909090909091,0.32527272727272727,0.33394545454545455,0.3431909090909091,0.3479181818181818,0
5238,90000,0,3,1,56,2,0,0,2,2,0,48900,37039,36334,34214,30789,28994,2000,4000,1100,0,1050,1034,1,46900,33039,35234,34214,29739,27960,0.5211111111111111,0.3671,0.3914888888888889,0.3801555555555556,0.33043333333333336,0.31066666666666665,6
5239,140000,0,2,2,24,0,0,0,0,0,0,103884,105697,101636,97298,77081,72592,4000,4000,3800,3000,3300,2300,0,99884,101697,97836,94298,73781,70292,0.7134571428571429,0.7264071428571428,0.6988285714285715,0.6735571428571429,0.5270071428571429,0.5020857142857142,0
5240,30000,1,1,1,45,2,0,0,0,0,0,26155,27196,28445,26766,27152,28355,1482,1731,1742,1128,1800,1200,1,24673,25465,26703,25638,25352,27155,0.8224333333333333,0.8488333333333333,0.8901,0.8546,0.8450666666666666,0.9051666666666667,2
5241,20000,1,3,2,36,0,0,2,2,2,2,16754,18873,19862,19245,20532,19953,2400,1600,0,1600,209,0,0,14354,17273,19862,17645,20323,19953,0.7177,0.86365,0.9931,0.88225,1.01615,0.99765,8
5242,300000,0,1,1,58,2,2,2,2,2,2,148265,158230,160242,156171,165556,169250,14000,6000,0,12000,6500,6500,1,134265,152230,160242,144171,159056,162750,0.44755,0.5074333333333333,0.53414,0.48057,0.5301866666666667,0.5425,12
5243,450000,1,1,2,45,1,-2,-2,-2,-1,-1,0,0,0,0,4595,198,0,0,0,4595,198,5095,0,0,0,0,-4595,4397,-4897,0.0,0.0,0.0,-0.010211111111111112,0.00977111111111111,-0.010882222222222222,-7
5244,50000,1,3,1,47,1,2,0,0,0,0,50574,48968,50151,50496,2759,-442,0,2463,2300,55,0,37459,1,50574,46505,47851,50441,2759,-37901,1.01148,0.9301,0.95702,1.00882,0.05518,-0.75802,3
5245,500000,0,1,1,30,0,0,0,0,0,0,74797,75753,78031,78946,76689,77968,2800,3500,2818,2743,3000,10000,1,71997,72253,75213,76203,73689,67968,0.143994,0.144506,0.150426,0.152406,0.147378,0.135936,0
5246,150000,1,3,2,23,0,0,0,0,0,0,6319,8190,6686,7686,4526,65839,2000,1000,1000,0,63300,11632,0,4319,7190,5686,7686,-58774,54207,0.028793333333333334,0.047933333333333335,0.037906666666666665,0.05124,-0.39182666666666666,0.36138,0
5247,190000,0,3,1,44,-1,2,-1,2,-1,0,291,291,582,291,582,291,0,582,0,582,0,291,1,291,-291,582,-291,582,0,0.0015315789473684211,-0.0015315789473684211,0.0030631578947368423,-0.0015315789473684211,0.0030631578947368423,0.0,1
5248,80000,1,3,1,39,-1,-1,-1,-1,-1,-1,715,2012,3550,7529,0,3228,2012,3550,7529,0,3228,0,1,-1297,-1538,-3979,7529,-3228,3228,-0.0162125,-0.019225,-0.0497375,0.0941125,-0.04035,0.04035,-6
5249,20000,1,2,2,34,0,0,0,0,0,0,18649,19727,20330,20199,19609,19957,1700,2000,1200,0,348,0,0,16949,17727,19130,20199,19261,19957,0.84745,0.88635,0.9565,1.00995,0.96305,0.99785,0
5250,330000,0,2,1,42,-1,-1,-1,0,0,-1,118601,4101,133359,138959,102279,106172,4101,133359,6000,2046,106172,63750,1,114500,-129258,127359,136913,-3893,42422,0.346969696969697,-0.3916909090909091,0.38593636363636363,0.4148878787878788,-0.011796969696969696,0.12855151515151514,-4
5251,80000,0,2,1,36,2,2,4,4,3,2,600,600,600,600,300,150,0,0,0,0,0,1000,1,600,600,600,600,300,-850,0.0075,0.0075,0.0075,0.0075,0.00375,-0.010625,17
5252,20000,1,2,1,24,2,2,0,0,0,0,19891,15895,17140,18457,21381,18914,0,1500,1600,1646,678,1000,1,19891,14395,15540,16811,20703,17914,0.99455,0.71975,0.777,0.84055,1.03515,0.8957,4
5253,30000,0,1,2,24,0,0,0,2,0,0,28436,28845,31071,30248,30354,29088,1800,3300,0,1500,1500,1300,0,26636,25545,31071,28748,28854,27788,0.8878666666666667,0.8515,1.0357,0.9582666666666667,0.9618,0.9262666666666667,2
5254,200000,1,1,2,48,-2,-2,-2,-1,2,2,0,0,0,5000,5000,0,0,0,5000,0,0,0,0,0,0,-5000,5000,5000,0,0.0,0.0,-0.025,0.025,0.025,0.0,-3
5255,20000,0,2,1,45,-2,-2,-2,-2,-2,-2,0,0,0,0,0,0,0,0,0,0,0,19409,1,0,0,0,0,0,-19409,0.0,0.0,0.0,0.0,0.0,-0.97045,-12
5256,150000,1,2,1,41,0,0,0,0,0,0,79021,77975,74749,80757,83685,81569,4023,3016,10000,4011,3073,3005,1,74998,74959,64749,76746,80612,78564,0.4999866666666667,0.49972666666666665,0.43166,0.51164,0.5374133333333333,0.52376,0
5257,130000,0,1,2,31,1,-2,-2,-2,-2,-2,0,0,0,0,0,0,0,0,0,0,0,0,0,0,0,0,0,0,0,0.0,0.0,0.0,0.0,0.0,0.0,-9
5258,280000,0,1,2,30,0,0,0,0,0,0,100740,104055,106380,112596,114235,117232,5000,4000,8000,5000,5000,18000,0,95740,100055,98380,107596,109235,99232,0.3419285714285714,0.3573392857142857,0.35135714285714287,0.3842714285714286,0.390125,0.3544,0
5259,310000,1,1,1,41,-1,2,-1,-1,-1,0,3640,1094,9445,5202,14589,11673,0,9453,5206,14589,0,16563,1,3640,-8359,4239,-9387,14589,-4890,0.011741935483870968,-0.026964516129032258,0.013674193548387097,-0.030280645161290323,0.04706129032258065,-0.0157741935483871,-2
5260,80000,1,2,2,31,-1,-1,-1,-1,-1,-1,1068,0,100,0,1050,-150,0,100,0,1050,0,0,0,1068,-100,100,-1050,1050,-150,0.01335,-0.00125,0.00125,-0.013125,0.013125,-0.001875,-6
5261,350000,1,2,1,41,0,0,0,0,0,0,85339,84393,86793,84406,73976,75497,5000,5016,5000,3000,3000,4000,1,80339,79377,81793,81406,70976,71497,0.22954,0.22679142857142856,0.23369428571428572,0.23258857142857142,0.20278857142857143,0.20427714285714285,0
5262,320000,1,1,2,32,-1,-1,-1,0,0,-1,20488,18607,41195,89714,64646,6103,18615,42067,30014,39515,6110,11611,0,1873,-23460,11181,50199,58536,-5508,0.005853125,-0.0733125,0.034940625,0.156871875,0.182925,-0.0172125,-4
5263,20000,1,2,1,43,2,0,0,2,0,0,13139,13915,18667,18072,18120,19329,1300,5000,0,640,1497,0,1,11839,8915,18667,17432,16623,19329,0.59195,0.44575,0.93335,0.8716,0.83115,0.96645,4
5264,240000,0,1,2,35,1,-2,-2,-2,-2,-2,220,0,0,0,0,0,0,0,0,0,0,0,0,220,0,0,0,0,0,0.0009166666666666666,0.0,0.0,0.0,0.0,0.0,-9
5265,110000,1,2,2,32,3,2,0,0,0,0,108087,103307,103749,78961,76180,76353,0,5100,3411,3003,3000,3001,0,108087,98207,100338,75958,73180,73352,0.9826090909090909,0.8927909090909091,0.9121636363636364,0.6905272727272728,0.6652727272727272,0.6668363636363637,5
5266,30000,0,1,2,23,0,0,0,0,0,0,30235,28246,30395,29962,30360,29899,3000,3000,2468,1700,2500,1046,0,27235,25246,27927,28262,27860,28853,0.9078333333333334,0.8415333333333334,0.9309,0.9420666666666667,0.9286666666666666,0.9617666666666667,0
5267,130000,0,2,2,26,2,2,0,0,0,0,134836,128038,126862,97925,100484,54125,0,5000,3500,4055,10000,50000,0,134836,123038,123362,93870,90484,4125,1.0372,0.9464461538461538,0.9489384615384615,0.7220769230769231,0.6960307692307692,0.03173076923076923,4
5268,150000,0,1,2,23,-1,-1,-1,-1,-1,-1,1389,7139,813,3028,5264,208,7139,813,3032,5264,208,3538,0,-5750,6326,-2219,-2236,5056,-3330,-0.03833333333333333,0.042173333333333334,-0.014793333333333334,-0.014906666666666667,0.03370666666666667,-0.0222,-6
5269,100000,1,2,2,25,0,0,0,0,0,0,98349,97473,91096,76371,77162,78084,3600,3000,2700,2800,3000,2800,0,94749,94473,88396,73571,74162,75284,0.94749,0.94473,0.88396,0.73571,0.74162,0.75284,0
5270,80000,1,2,1,22,2,2,2,2,2,-2,79026,81521,83628,152452,0,0,4400,4001,12,0,0,0,1,74626,77520,83616,152452,0,0,0.932825,0.969,1.0452,1.90565,0.0,0.0,8
5271,90000,0,2,1,31,0,0,0,0,0,0,70329,69073,70561,72021,73912,58301,2471,2600,2633,3108,2052,1858,1,67858,66473,67928,68913,71860,56443,0.7539777777777777,0.7385888888888889,0.7547555555555555,0.7657,0.7984444444444444,0.6271444444444444,0
5272,200000,1,2,1,29,0,0,0,0,0,0,70422,67991,56909,56841,51245,42268,3500,2472,1683,1755,1658,3579,1,66922,65519,55226,55086,49587,38689,0.33461,0.327595,0.27613,0.27543,0.247935,0.193445,0
5273,20000,1,3,2,50,2,0,0,0,2,2,11545,12945,13972,15730,15183,16182,1600,1542,2300,0,1400,800,0,9945,11403,11672,15730,13783,15382,0.49725,0.57015,0.5836,0.7865,0.68915,0.7691,6
5274,200000,1,1,1,58,1,2,2,0,0,0,203108,206084,187747,159746,140632,143092,7500,0,6014,5000,6000,5000,1,195608,206084,181733,154746,134632,138092,0.97804,1.03042,0.908665,0.77373,0.67316,0.69046,5
5275,20000,1,2,1,37,0,0,0,0,0,0,19326,20240,17800,18699,17770,48321,1263,1630,1529,1200,2000,742,1,18063,18610,16271,17499,15770,47579,0.90315,0.9305,0.81355,0.87495,0.7885,2.37895,0
5276,150000,1,2,2,27,-1,-1,-1,-1,-1,0,1745,3384,1555,2126,60092,59831,3384,1555,2126,60092,3000,3000,0,-1639,1829,-571,-57966,57092,56831,-0.010926666666666666,0.012193333333333334,-0.0038066666666666665,-0.38644,0.38061333333333336,0.37887333333333334,-5
5277,110000,1,1,2,31,1,-2,-2,-2,-2,-2,0,0,0,0,0,0,0,0,0,0,0,0,0,0,0,0,0,0,0,0.0,0.0,0.0,0.0,0.0,0.0,-9
5278,200000,0,1,2,36,1,-2,-2,-2,-1,-1,0,0,0,0,3774,0,0,0,0,3774,0,686,0,0,0,0,-3774,3774,-686,0.0,0.0,0.0,-0.01887,0.01887,-0.00343,-7
5279,100000,1,3,1,36,-1,-1,-1,-1,-1,-1,1490,0,210,0,90,90,0,210,0,90,0,0,1,1490,-210,210,-90,90,90,0.0149,-0.0021,0.0021,-0.0009,0.0009,0.0009,-6
5280,20000,0,2,2,21,0,0,0,-1,0,0,23675,20297,17054,2333,1300,0,1800,1240,2333,0,0,0,0,21875,19057,14721,2333,1300,0,1.09375,0.95285,0.73605,0.11665,0.065,0.0,-1
5281,50000,1,2,2,44,-1,-1,-1,-1,0,0,390,390,390,18015,17150,17102,390,390,18015,400,342,3334,0,0,0,-17625,17615,16808,13768,0.0,0.0,-0.3525,0.3523,0.33616,0.27536,-4
5282,80000,1,2,2,24,-1,-1,-2,-2,-2,-2,2346,0,0,0,0,0,0,0,0,0,0,0,0,2346,0,0,0,0,0,0.029325,0.0,0.0,0.0,0.0,0.0,-10
5283,80000,1,2,1,35,1,-2,-2,-2,-2,-2,0,0,0,0,0,0,0,0,0,0,0,0,1,0,0,0,0,0,0,0.0,0.0,0.0,0.0,0.0,0.0,-9
5284,60000,1,3,2,44,-1,-1,-2,-2,-2,-2,2802,0,0,0,0,0,0,0,0,0,0,0,0,2802,0,0,0,0,0,0.0467,0.0,0.0,0.0,0.0,0.0,-10
5285,50000,1,2,1,34,0,0,0,0,0,0,10821,11877,13656,14949,16567,16826,1221,2000,1500,2000,2000,4000,1,9600,9877,12156,12949,14567,12826,0.192,0.19754,0.24312,0.25898,0.29134,0.25652,0
5286,150000,1,2,2,29,-1,-1,-1,-2,-1,-1,1739,1984,112,0,3865,5562,1984,112,0,3865,5575,10963,0,-245,1872,112,-3865,-1710,-5401,-0.0016333333333333334,0.01248,0.0007466666666666666,-0.025766666666666667,-0.0114,-0.036006666666666666,-7
5287,50000,0,3,1,36,0,0,0,0,0,0,44917,46230,49319,50401,18919,19469,2061,4150,2232,750,929,611,1,42856,42080,47087,49651,17990,18858,0.85712,0.8416,0.94174,0.99302,0.3598,0.37716,0
5288,20000,1,1,2,24,-1,-1,-2,-2,-2,-2,379,0,0,0,0,0,0,0,0,0,0,0,0,379,0,0,0,0,0,0.01895,0.0,0.0,0.0,0.0,0.0,-10
5289,70000,1,1,1,36,2,0,0,0,0,0,81719,85389,86287,65287,35345,9360,5000,3000,2000,3000,5000,0,1,76719,82389,84287,62287,30345,9360,1.0959857142857143,1.1769857142857143,1.2041,0.8898142857142857,0.4335,0.1337142857142857,2
5290,340000,0,2,1,48,0,0,0,0,0,0,73627,75052,76022,76402,75356,76237,3870,3819,2823,2876,2853,2863,1,69757,71233,73199,73526,72503,73374,0.20516764705882354,0.20950882352941178,0.21529117647058824,0.2162529411764706,0.21324411764705883,0.21580588235294118,0
5291,60000,1,1,2,31,-1,-1,-1,-1,-2,-2,7233,1596,1562,0,0,0,1596,1562,0,0,0,0,0,5637,34,1562,0,0,0,0.09395,0.0005666666666666667,0.026033333333333332,0.0,0.0,0.0,-8
5292,150000,1,1,2,32,2,0,0,0,0,2,35099,35601,36488,35729,38117,37259,1887,2003,2000,3419,13,2088,0,33212,33598,34488,32310,38104,35171,0.22141333333333332,0.22398666666666667,0.22992,0.2154,0.2540266666666667,0.23447333333333334,4
5293,180000,0,1,1,38,0,0,0,0,0,2,153099,150227,138313,137274,147314,129870,7005,6500,5000,12042,32,1300,1,146094,143727,133313,125232,147282,128570,0.8116333333333333,0.7984833333333333,0.7406277777777778,0.6957333333333333,0.8182333333333334,0.7142777777777778,2
5294,30000,1,3,1,35,2,0,0,0,0,0,28852,29777,29478,30290,27803,25762,1700,1700,1500,1500,1500,1500,1,27152,28077,27978,28790,26303,24262,0.9050666666666667,0.9359,0.9326,0.9596666666666667,0.8767666666666667,0.8087333333333333,2
5295,140000,1,2,2,26,0,0,0,0,0,0,101551,105246,104781,105334,107699,106828,5366,5087,3605,3894,3785,3304,0,96185,100159,101176,101440,103914,103524,0.6870357142857143,0.7154214285714285,0.7226857142857143,0.7245714285714285,0.7422428571428571,0.7394571428571428,0
5296,10000,0,1,2,29,0,0,0,0,0,0,10208,8598,7100,9305,9805,5720,1500,1000,4000,500,2500,0,0,8708,7598,3100,8805,7305,5720,0.8708,0.7598,0.31,0.8805,0.7305,0.572,0
5297,30000,1,1,2,26,-1,-1,-1,-1,-1,2,2635,807,11428,2462,3605,1559,1270,11500,2462,1559,0,3192,0,1365,-10693,8966,903,3605,-1633,0.0455,-0.3564333333333333,0.29886666666666667,0.0301,0.12016666666666667,-0.054433333333333334,-3
5298,440000,1,3,1,50,0,0,0,0,0,0,250825,167091,144804,67729,66077,60074,10043,8608,25031,25030,22053,20030,1,240782,158483,119773,42699,44024,40044,0.5472318181818182,0.36018863636363635,0.2722113636363636,0.09704318181818182,0.10005454545454545,0.09100909090909091,0
5299,30000,0,2,2,22,0,0,0,0,0,0,30455,30403,30454,29227,28929,29484,1515,1455,1028,1044,1420,1111,0,28940,28948,29426,28183,27509,28373,0.9646666666666667,0.9649333333333333,0.9808666666666667,0.9394333333333333,0.9169666666666667,0.9457666666666666,0
5300,200000,0,2,2,36,-1,-1,-2,-1,-1,-1,2989,0,0,2989,9059,52248,0,0,2989,9059,52546,10380,0,2989,0,-2989,-6070,-43487,41868,0.014945,0.0,-0.014945,-0.03035,-0.217435,0.20934,-7
5301,130000,0,1,2,34,0,0,0,0,0,0,30190,31179,30569,28659,26952,15852,1818,2002,1400,600,1000,0,0,28372,29177,29169,28059,25952,15852,0.21824615384615384,0.22443846153846153,0.22437692307692308,0.21583846153846153,0.19963076923076922,0.12193846153846154,0
5302,310000,0,2,2,35,0,0,0,0,0,0,124617,126982,125072,126416,132772,137519,6015,5006,5006,10004,8007,5017,0,118602,121976,120066,116412,124765,132502,0.38258709677419356,0.39347096774193546,0.38730967741935485,0.3755225806451613,0.40246774193548385,0.4274258064516129,0
5303,30000,1,2,2,23,2,2,2,0,0,2,19674,21050,20414,22008,23480,23777,2000,0,1934,1824,830,0,0,17674,21050,18480,20184,22650,23777,0.5891333333333333,0.7016666666666667,0.616,0.6728,0.755,0.7925666666666666,8
5304,210000,1,1,1,42,1,-2,-1,-1,-2,-2,0,0,2490,0,0,0,0,2490,0,0,0,0,1,0,-2490,2490,0,0,0,0.0,-0.011857142857142858,0.011857142857142858,0.0,0.0,0.0,-7
5305,30000,0,2,1,47,0,0,0,0,2,0,24422,25480,26425,30525,29063,29022,1455,1400,4500,0,1500,2000,1,22967,24080,21925,30525,27563,27022,0.7655666666666666,0.8026666666666666,0.7308333333333333,1.0175,0.9187666666666666,0.9007333333333334,2
5306,180000,1,2,2,48,1,-1,-1,-1,-1,-1,2551,3044,3044,5283,1660,6671,3044,3044,5283,1660,6671,493,0,-493,0,-2239,3623,-5011,6178,-0.002738888888888889,0.0,-0.012438888888888888,0.02012777777777778,-0.02783888888888889,0.03432222222222222,-4
5307,180000,0,2,2,56,0,0,0,0,0,0,89560,90940,92868,94243,94888,95819,3460,4000,3501,2690,3000,2603,0,86100,86940,89367,91553,91888,93216,0.47833333333333333,0.483,0.49648333333333333,0.5086277777777778,0.5104888888888889,0.5178666666666667,0
5308,50000,1,3,1,50,0,0,0,0,0,0,38499,39216,15554,8704,8904,4687,1743,1021,200,200,100,0,1,36756,38195,15354,8504,8804,4687,0.73512,0.7639,0.30708,0.17008,0.17608,0.09374,0
5309,30000,1,3,3,46,1,2,2,2,2,2,20143,19532,22194,21542,24022,25473,0,3000,0,3000,2000,0,0,20143,16532,22194,18542,22022,25473,0.6714333333333333,0.5510666666666667,0.7398,0.6180666666666667,0.7340666666666666,0.8491,11
5310,110000,1,1,3,33,0,0,0,0,0,0,165090,106448,103618,79687,76742,77096,4259,3212,28246,2730,2834,2711,0,160831,103236,75372,76957,73908,74385,1.4621,0.938509090909091,0.6852,0.699609090909091,0.6718909090909091,0.6762272727272727,0
5311,140000,1,1,1,40,1,-1,-1,-1,-1,-1,0,1220,0,584,0,190,1220,0,584,0,190,0,1,-1220,1220,-584,584,-190,190,-0.008714285714285714,0.008714285714285714,-0.004171428571428572,0.004171428571428572,-0.0013571428571428571,0.0013571428571428571,-4
5312,230000,1,1,2,27,0,0,0,0,-1,-1,11406,10097,4600,3234,4696,7062,5097,1060,1000,4696,7062,10898,0,6309,9037,3600,-1462,-2366,-3836,0.027430434782608697,0.039291304347826086,0.01565217391304348,-0.006356521739130435,-0.010286956521739131,-0.01667826086956522,-2
5313,80000,1,2,2,28,2,2,-1,-1,-1,-1,260,130,130,130,130,130,0,130,130,130,130,130,0,260,0,0,0,0,0,0.00325,0.0,0.0,0.0,0.0,0.0,0
5314,80000,1,2,2,23,0,0,0,-1,-1,0,6085,4728,5750,1361,1402,1911,1128,1150,1361,1402,1000,344,0,4957,3578,4389,-41,402,1567,0.0619625,0.044725,0.0548625,-0.0005125,0.005025,0.0195875,-2
5315,130000,1,1,1,36,0,0,0,0,0,0,129689,107070,103942,94623,90556,92394,5000,4400,5000,4000,3500,4000,1,124689,102670,98942,90623,87056,88394,0.9591461538461539,0.7897692307692308,0.7610923076923077,0.6971,0.6696615384615384,0.6799538461538461,0
5316,150000,0,2,2,28,0,0,0,0,0,0,134218,118580,95916,82867,58995,59799,4465,10629,3500,1833,1886,1610,0,129753,107951,92416,81034,57109,58189,0.86502,0.7196733333333334,0.6161066666666667,0.5402266666666666,0.38072666666666666,0.38792666666666664,0
5317,200000,0,1,2,32,0,0,0,-2,-2,-2,42325,32061,0,0,0,0,2000,0,0,0,0,0,0,40325,32061,0,0,0,0,0.201625,0.160305,0.0,0.0,0.0,0.0,-6
5318,60000,1,4,2,23,0,0,0,0,0,0,60876,60606,58227,60538,45018,38086,2523,2155,45088,1722,1523,2000,0,58353,58451,13139,58816,43495,36086,0.97255,0.9741833333333333,0.21898333333333334,0.9802666666666666,0.7249166666666667,0.6014333333333334,0
5319,600000,1,1,2,36,-2,-2,-2,-2,-2,-2,53838,528,1191,11390,8680,38018,530,3000,11500,8680,38020,56700,0,53308,-2472,-10309,2710,-29340,-18682,0.08884666666666667,-0.00412,-0.017181666666666668,0.004516666666666667,-0.0489,-0.031136666666666667,-12
5320,340000,1,2,1,29,0,0,-1,-1,-1,0,20816,11706,600,-470,50813,50271,1005,600,0,51283,1193,5000,1,19811,11106,600,-51753,49620,45271,0.05826764705882353,0.03266470588235294,0.0017647058823529412,-0.15221470588235295,0.14594117647058824,0.13315,-3
5321,200000,1,1,2,33,0,0,0,0,0,0,150573,140844,144245,135946,135736,134500,6550,7200,5300,5400,5240,5260,0,144023,133644,138945,130546,130496,129240,0.720115,0.66822,0.694725,0.65273,0.65248,0.6462,0
5322,280000,1,1,2,34,-2,-2,-2,-2,-2,-2,2793,1356,19497,10164,1089,26218,1356,19497,10173,1089,28217,0,0,1437,-18141,9324,9075,-27128,26218,0.005132142857142857,-0.06478928571428572,0.0333,0.032410714285714286,-0.09688571428571428,0.09363571428571428,-12
5323,20000,0,1,1,36,0,0,0,2,0,0,16736,17834,20025,28806,14463,18668,1700,4000,300,10000,5000,1000,1,15036,13834,19725,18806,9463,17668,0.7518,0.6917,0.98625,0.9403,0.47315,0.8834,2
5324,100000,1,2,2,38,0,0,0,0,0,0,89842,82669,70018,57847,43618,38715,4025,2511,1523,1292,1236,627,0,85817,80158,68495,56555,42382,38088,0.85817,0.80158,0.68495,0.56555,0.42382,0.38088,0
5325,20000,0,3,2,38,1,-1,0,0,0,0,-2086,16116,17151,18161,18521,18911,18451,1300,1302,662,688,800,0,-20537,14816,15849,17499,17833,18111,-1.02685,0.7408,0.79245,0.87495,0.89165,0.90555,0
5326,100000,0,3,2,42,0,0,0,0,0,0,70542,72400,74192,75660,77444,79154,3000,3000,2703,2998,3000,6100,0,67542,69400,71489,72662,74444,73054,0.67542,0.694,0.71489,0.72662,0.74444,0.73054,0
5327,60000,0,2,2,25,2,2,2,0,0,0,36090,22083,15444,13695,17598,17472,2017,5,1000,5000,1000,603,0,34073,22078,14444,8695,16598,16869,0.5678833333333333,0.36796666666666666,0.24073333333333333,0.14491666666666667,0.27663333333333334,0.28115,6
5328,60000,0,4,2,32,0,0,0,0,0,0,57505,51934,40855,37742,29450,8850,1800,2000,2000,1400,200,600,0,55705,49934,38855,36342,29250,8250,0.9284166666666667,0.8322333333333334,0.6475833333333333,0.6057,0.4875,0.1375,0
5329,200000,1,1,1,40,1,-1,-1,-1,-1,-1,0,114558,1898,849,-171,14686,114558,3796,849,0,14857,0,1,-114558,110762,1049,849,-15028,14686,-0.57279,0.55381,0.005245,0.004245,-0.07514,0.07343,-4
5330,40000,0,1,2,31,0,0,0,0,0,0,33075,34221,35866,36691,31672,27945,2000,2500,2014,250,2000,500,0,31075,31721,33852,36441,29672,27445,0.776875,0.793025,0.8463,0.911025,0.7418,0.686125,0
5331,140000,1,2,1,34,0,0,0,0,0,0,141066,129173,116858,105786,93273,91207,4873,4691,4000,4000,4000,4000,1,136193,124482,112858,101786,89273,87207,0.9728071428571429,0.8891571428571429,0.8061285714285714,0.7270428571428571,0.6376642857142857,0.6229071428571429,0
5332,240000,0,3,1,48,0,0,0,0,0,0,111990,125109,129014,131864,134744,138504,15000,6000,5000,5000,6000,6000,1,96990,119109,124014,126864,128744,132504,0.404125,0.4962875,0.516725,0.5286,0.5364333333333333,0.5521,0
5333,550000,0,1,1,44,-2,-2,-2,-2,-2,-2,21788,0,1091,2291,1000,150,0,1091,2309,1000,150,750,1,21788,-1091,-1218,1291,850,-600,0.03961454545454546,-0.0019836363636363636,-0.0022145454545454547,0.0023472727272727274,0.0015454545454545454,-0.001090909090909091,-12
5334,30000,1,3,2,34,-1,-1,-1,-1,-1,-2,9318,10621,15685,5476,0,0,10621,15685,5827,0,0,0,0,-1303,-5064,9858,5476,0,0,-0.04343333333333333,-0.1688,0.3286,0.18253333333333333,0.0,0.0,-7
5335,250000,1,1,1,38,-1,-1,0,-1,-1,0,6352,6790,10418,7720,37543,31337,6790,5418,7720,37604,0,0,1,-438,1372,2698,-29884,37543,31337,-0.001752,0.005488,0.010792,-0.119536,0.150172,0.125348,-4
5336,200000,1,3,2,34,0,0,2,0,0,-1,11073,9787,5535,2513,1828,3731,2306,12,50,300,3738,66,0,8767,9775,5485,2213,-1910,3665,0.043835,0.048875,0.027425,0.011065,-0.00955,0.018325,1
5337,270000,1,1,1,33,0,0,0,-2,-1,0,22604,26906,0,0,4448,5667,5000,0,0,4448,1300,2443,1,17604,26906,0,-4448,3148,3224,0.0652,0.09965185185185185,0.0,-0.016474074074074075,0.01165925925925926,0.011940740740740741,-3
5338,150000,0,4,1,36,0,0,0,0,0,0,216482,220889,133616,136378,139219,142172,5500,3800,3900,4000,4100,4100,1,210982,217089,129716,132378,135119,138072,1.4065466666666666,1.44726,0.8647733333333333,0.88252,0.9007933333333333,0.92048,0
5339,500000,1,3,2,53,-2,-2,-2,-2,-2,-2,0,0,0,0,0,1150,0,0,0,0,1150,0,0,0,0,0,0,-1150,1150,0.0,0.0,0.0,0.0,-0.0023,0.0023,-12
5340,110000,1,2,2,28,0,0,0,-1,-1,-1,10048,8311,3404,407,1250,88628,2000,3000,410,1250,89035,3491,0,8048,5311,2994,-843,-87785,85137,0.07316363636363636,0.04828181818181818,0.02721818181818182,-0.007663636363636364,-0.7980454545454545,0.7739727272727273,-3
5341,180000,1,2,1,42,-2,-2,-2,-2,-2,-2,390,1260,598,2056,4300,1802,1260,598,2056,4300,1802,3691,1,-870,662,-1458,-2244,2498,-1889,-0.004833333333333334,0.0036777777777777776,-0.0081,-0.012466666666666666,0.013877777777777777,-0.010494444444444445,-12
5342,50000,0,2,2,52,0,0,0,-1,0,0,45840,47595,28491,3642,12291,16674,8000,8080,15012,10000,8000,2000,0,37840,39515,13479,-6358,4291,14674,0.7568,0.7903,0.26958,-0.12716,0.08582,0.29348,-1
5343,120000,1,1,2,32,1,-2,-2,-2,-1,-1,0,0,0,0,9310,0,0,0,0,9310,0,0,0,0,0,0,-9310,9310,0,0.0,0.0,0.0,-0.07758333333333334,0.07758333333333334,0.0,-7
5344,60000,1,2,2,27,0,0,0,0,0,0,57697,48934,44653,44056,42210,41796,2200,5000,2000,1500,2000,1600,0,55497,43934,42653,42556,40210,40196,0.92495,0.7322333333333333,0.7108833333333333,0.7092666666666667,0.6701666666666667,0.6699333333333334,0
5345,100000,1,1,1,34,0,0,0,0,0,0,101620,101747,100750,98953,99114,101501,4000,3838,3563,3563,4000,3475,1,97620,97909,97187,95390,95114,98026,0.9762,0.97909,0.97187,0.9539,0.95114,0.98026,0
5346,230000,0,3,1,61,2,2,-2,-2,-2,-2,2500,0,0,0,0,0,0,0,0,0,0,0,1,2500,0,0,0,0,0,0.010869565217391304,0.0,0.0,0.0,0.0,0.0,-4
5347,70000,0,2,2,32,0,0,0,0,0,0,71336,70393,131412,63823,52339,40836,3609,2523,2441,3038,2029,70004,0,67727,67870,128971,60785,50310,-29168,0.9675285714285714,0.9695714285714285,1.842442857142857,0.8683571428571428,0.7187142857142857,-0.41668571428571427,0
5348,210000,1,2,2,26,0,0,0,0,0,0,26847,26883,27180,27035,27390,28045,1500,1500,1000,1500,2000,1000,0,25347,25383,26180,25535,25390,27045,0.1207,0.12087142857142857,0.12466666666666666,0.12159523809523809,0.1209047619047619,0.12878571428571428,0
5349,50000,1,2,1,29,0,0,2,2,2,0,40117,45598,44570,47133,46249,47179,6138,0,3618,0,1850,1862,1,33979,45598,40952,47133,44399,45317,0.67958,0.91196,0.81904,0.94266,0.88798,0.90634,6
5350,50000,1,2,1,23,0,0,0,0,0,0,5215,6232,7251,8326,9184,10031,1106,1125,1200,1000,1000,1000,1,4109,5107,6051,7326,8184,9031,0.08218,0.10214,0.12102,0.14652,0.16368,0.18062,0
5351,160000,1,2,1,30,2,2,0,0,0,0,164082,157663,159094,132809,100693,97181,17,7342,3675,2910,3904,2900,1,164065,150321,155419,129899,96789,94281,1.02540625,0.93950625,0.97136875,0.81186875,0.60493125,0.58925625,4
5352,240000,1,1,1,34,-2,-1,-1,-2,-2,-2,597,6449,626,626,626,626,6507,626,626,626,626,626,1,-5910,5823,0,0,0,0,-0.024625,0.0242625,0.0,0.0,0.0,0.0,-10
5353,170000,0,1,1,44,-1,-1,-1,-1,-1,-1,6569,29039,1716,2442,14605,2895,29069,1721,2442,14605,2895,9608,1,-22500,27318,-726,-12163,11710,-6713,-0.1323529411764706,0.16069411764705882,-0.004270588235294118,-0.07154705882352941,0.06888235294117646,-0.03948823529411765,-6
5354,220000,0,1,1,39,0,0,0,0,0,0,38647,27796,12372,4610,3668,-809,2017,3000,1000,0,0,3000,1,36630,24796,11372,4610,3668,-3809,0.1665,0.11270909090909091,0.05169090909090909,0.020954545454545455,0.016672727272727273,-0.017313636363636364,0
5355,170000,1,3,1,44,0,0,0,0,0,-1,150692,152861,156393,147611,28697,107142,6936,8266,5792,662,108927,4154,1,143756,144595,150601,146949,-80230,102988,0.8456235294117647,0.8505588235294118,0.8858882352941176,0.8644058823529411,-0.47194117647058825,0.6058117647058824,-1
5356,220000,0,1,2,48,0,0,0,0,2,0,113061,115294,117945,130365,126780,129570,5600,6000,16000,0,5000,6300,0,107461,109294,101945,130365,121780,123270,0.4884590909090909,0.4967909090909091,0.46338636363636365,0.5925681818181818,0.5535454545454546,0.5603181818181818,2
5357,20000,1,3,2,40,0,0,0,0,0,-1,19088,13828,9290,6636,2941,642,1248,1200,1156,1000,700,4600,0,17840,12628,8134,5636,2241,-3958,0.892,0.6314,0.4067,0.2818,0.11205,-0.1979,-1
5358,20000,1,3,1,35,0,0,0,0,0,0,19792,19995,20269,18268,19478,19885,1339,1500,1290,1500,704,882,1,18453,18495,18979,16768,18774,19003,0.92265,0.92475,0.94895,0.8384,0.9387,0.95015,0
5359,10000,1,2,3,46,3,2,2,2,2,4,5997,5753,9629,9328,11411,10652,0,4000,0,2395,0,0,0,5997,1753,9629,6933,11411,10652,0.5997,0.1753,0.9629,0.6933,1.1411,1.0652,15
5360,60000,1,2,2,23,0,0,0,0,0,0,57097,58134,58647,59619,57068,57668,2659,2190,2078,2002,2062,2072,0,54438,55944,56569,57617,55006,55596,0.9073,0.9324,0.9428166666666666,0.9602833333333334,0.9167666666666666,0.9266,0
5361,80000,1,2,1,25,0,0,0,0,0,2,78639,80188,80711,59119,62019,60955,3200,2500,2182,4700,0,2000,1,75439,77688,78529,54419,62019,58955,0.9429875,0.9711,0.9816125,0.6802375,0.7752375,0.7369375,2
5362,300000,0,2,1,35,0,0,0,2,0,0,142378,146621,153217,154879,156692,154911,8000,10800,6000,6000,6000,6000,1,134378,135821,147217,148879,150692,148911,0.44792666666666664,0.4527366666666667,0.49072333333333334,0.49626333333333333,0.5023066666666667,0.49637,2
5363,180000,0,2,1,42,0,0,0,0,0,0,27884,28958,29864,30632,31274,32144,1526,1432,1200,1072,1326,704,1,26358,27526,28664,29560,29948,31440,0.14643333333333333,0.1529222222222222,0.15924444444444444,0.16422222222222221,0.1663777777777778,0.17466666666666666,0
5364,270000,1,2,1,39,0,0,0,0,0,0,161039,164354,167788,339599,174797,180313,6000,6079,6213,12840,8500,8205,1,155039,158275,161575,326759,166297,172108,0.5742185185185186,0.5862037037037037,0.5984259259259259,1.2102185185185186,0.6159148148148148,0.637437037037037,0
5365,340000,0,2,1,37,0,0,0,0,0,0,71934,78695,80831,81589,83546,85362,8000,4000,3000,3300,3300,4000,1,63934,74695,77831,78289,80246,81362,0.18804117647058824,0.21969117647058822,0.22891470588235294,0.23026176470588236,0.23601764705882353,0.2393,0
5366,70000,0,1,2,31,0,0,0,0,0,0,47873,52440,55961,63341,64694,67905,6000,5000,10000,3000,5000,3000,0,41873,47440,45961,60341,59694,64905,0.5981857142857143,0.6777142857142857,0.6565857142857143,0.8620142857142857,0.8527714285714286,0.9272142857142858,0
5367,100000,1,2,2,27,0,0,0,0,0,2,96191,96908,97565,98561,103039,95803,3504,3500,3800,7500,0,3600,0,92687,93408,93765,91061,103039,92203,0.92687,0.93408,0.93765,0.91061,1.03039,0.92203,2
5368,180000,0,2,1,40,-1,-1,-1,-1,-1,-1,3071,5630,9040,1288,1419,2385,5639,9044,1290,1421,2386,1964,1,-2568,-3414,7750,-133,-967,421,-0.014266666666666667,-0.018966666666666666,0.043055555555555555,-0.0007388888888888889,-0.005372222222222222,0.002338888888888889,-6
5369,10000,1,3,1,49,0,0,0,0,0,0,6904,7841,9635,17622,8991,0,1206,2000,176,360,0,0,1,5698,5841,9459,17262,8991,0,0.5698,0.5841,0.9459,1.7262,0.8991,0.0,0
5370,200000,1,3,3,37,1,-1,-1,-1,-1,-1,0,35000,5000,4000,22800,5716,35000,5000,4000,22800,5716,0,0,-35000,30000,1000,-18800,17084,5716,-0.175,0.15,0.005,-0.094,0.08542,0.02858,-4
5371,290000,0,2,2,38,-1,-1,-1,-1,-1,-1,72607,1995,2791,4644,2936,2245,2003,2803,4680,2956,2254,1811,0,70604,-808,-1889,1688,682,434,0.24346206896551725,-0.002786206896551724,-0.0065137931034482755,0.005820689655172414,0.0023517241379310346,0.001496551724137931,-6
5372,160000,1,1,2,27,1,-2,-2,-2,-2,-2,0,0,0,1900,0,2018,0,0,1900,0,2018,0,0,0,0,-1900,1900,-2018,2018,0.0,0.0,-0.011875,0.011875,-0.0126125,0.0126125,-9
5373,360000,1,1,1,30,1,2,-1,0,-1,-1,18886,14249,3821,2404,319,0,0,3828,2000,319,0,0,1,18886,10421,1821,2085,319,0,0.05246111111111111,0.02894722222222222,0.005058333333333333,0.005791666666666666,0.0008861111111111111,0.0,0
5374,20000,1,3,1,51,0,0,0,-2,-2,-2,19255,20650,0,0,0,0,2000,0,0,0,0,0,1,17255,20650,0,0,0,0,0.86275,1.0325,0.0,0.0,0.0,0.0,-6
5375,30000,1,3,1,44,2,0,0,0,0,0,26627,27631,29179,30146,26371,27567,1452,2000,1500,933,2000,3000,1,25175,25631,27679,29213,24371,24567,0.8391666666666666,0.8543666666666667,0.9226333333333333,0.9737666666666667,0.8123666666666667,0.8189,2
5376,30000,1,1,2,43,0,0,0,0,0,0,29327,30487,29417,30379,30452,0,1659,1589,1551,1124,0,0,0,27668,28898,27866,29255,30452,0,0.9222666666666667,0.9632666666666667,0.9288666666666666,0.9751666666666666,1.0150666666666666,0.0,0
5377,250000,1,2,1,36,0,0,0,0,0,0,107476,87000,48162,48803,41207,34792,5143,10025,10074,10049,10076,10012,1,102333,76975,38088,38754,31131,24780,0.409332,0.3079,0.152352,0.155016,0.124524,0.09912,0
5378,50000,1,2,2,27,2,2,2,2,2,0,48407,47760,45064,45744,43123,42343,2100,0,3400,0,1528,3038,0,46307,47760,41664,45744,41595,39305,0.92614,0.9552,0.83328,0.91488,0.8319,0.7861,10
5379,80000,1,3,1,55,0,0,0,2,0,0,67671,61346,59100,53133,48598,48882,2141,6433,0,2000,2000,2000,1,65530,54913,59100,51133,46598,46882,0.819125,0.6864125,0.73875,0.6391625,0.582475,0.586025,2
5380,50000,1,2,2,25,0,0,0,0,0,0,47431,48306,35150,25104,20560,8614,2000,1542,1475,1000,350,386,0,45431,46764,33675,24104,20210,8228,0.90862,0.93528,0.6735,0.48208,0.4042,0.16456,0
5381,50000,1,1,2,25,-1,-1,2,-1,-1,-2,13572,17983,15590,10610,0,0,5000,200,10610,0,0,0,0,8572,17783,4980,10610,0,0,0.17144,0.35566,0.0996,0.2122,0.0,0.0,-4
5382,500000,1,2,1,41,-1,-1,-1,-1,-1,-1,24433,187206,10894,29161,28238,33272,187206,10909,29161,28238,33272,175357,1,-162773,176297,-18267,923,-5034,-142085,-0.325546,0.352594,-0.036534,0.001846,-0.010068,-0.28417,-6
5383,140000,0,2,1,32,0,0,0,0,0,0,134236,134663,137485,137450,135638,136375,6300,6500,6300,6000,5200,5000,1,127936,128163,131185,131450,130438,131375,0.9138285714285714,0.91545,0.9370357142857143,0.9389285714285714,0.9317,0.9383928571428571,0
5384,420000,1,3,2,35,0,0,0,0,0,0,65958,63715,62201,56125,49114,47563,3500,3002,2200,1700,1800,1700,0,62458,60713,60001,54425,47314,45863,0.14870952380952382,0.1445547619047619,0.1428595238095238,0.12958333333333333,0.11265238095238095,0.10919761904761904,0
5385,500000,0,1,2,58,0,0,0,0,0,0,201013,197982,137786,129575,135483,118851,8366,12063,8031,16114,10091,15123,0,192647,185919,129755,113461,125392,103728,0.385294,0.371838,0.25951,0.226922,0.250784,0.207456,0
5386,430000,0,3,2,26,0,0,0,0,0,0,438795,438691,437284,435832,345499,228818,18000,18000,16570,11803,10563,10000,0,420795,420691,420714,424029,334936,218818,0.978593023255814,0.9783511627906977,0.9784046511627907,0.986113953488372,0.7789209302325582,0.5088790697674419,0
5387,190000,1,1,2,27,0,0,0,0,0,0,72656,38054,39410,38288,39276,36885,2000,2000,1500,1500,1300,1302,0,70656,36054,37910,36788,37976,35583,0.3718736842105263,0.1897578947368421,0.1995263157894737,0.19362105263157894,0.19987368421052631,0.18727894736842104,0
5388,200000,0,1,2,37,-2,-2,-2,-2,-2,-2,4279,3774,706,5177,3792,12035,3856,706,5192,3808,12035,33436,0,423,3068,-4486,1369,-8243,-21401,0.002115,0.01534,-0.02243,0.006845,-0.041215,-0.107005,-12
5389,680000,0,1,2,37,0,0,0,0,0,0,18314,16088,17806,15498,13810,164969,2700,2400,600,400,161000,5800,0,15614,13688,17206,15098,-147190,159169,0.02296176470588235,0.020129411764705882,0.025302941176470587,0.02220294117647059,-0.21645588235294116,0.2340720588235294,0
5390,110000,0,2,2,26,0,0,0,0,0,2,34949,35686,37086,37967,40551,39749,1600,2000,1500,3200,0,1500,0,33349,33686,35586,34767,40551,38249,0.30317272727272726,0.30623636363636364,0.3235090909090909,0.3160636363636364,0.36864545454545455,0.3477181818181818,2
5391,150000,0,2,1,39,0,0,0,2,2,2,76415,78836,87265,85084,93323,91783,4150,10575,0,9717,0,3300,1,72265,68261,87265,75367,93323,88483,0.4817666666666667,0.45507333333333333,0.5817666666666667,0.5024466666666667,0.6221533333333333,0.5898866666666667,6
5392,470000,0,2,2,31,0,0,0,0,0,0,78833,80562,82718,85334,87948,90479,3000,3500,4000,4000,4000,4200,0,75833,77062,78718,81334,83948,86279,0.1613468085106383,0.16396170212765956,0.16748510638297873,0.17305106382978724,0.1786127659574468,0.18357234042553192,0
5393,160000,0,3,2,31,0,0,0,0,0,0,50901,53859,55814,59726,61615,65939,4000,3000,5000,3000,5000,2000,0,46901,50859,50814,56726,56615,63939,0.29313125,0.31786875,0.3175875,0.3545375,0.35384375,0.39961875,0
5394,20000,0,2,1,32,0,0,0,0,0,0,16849,17618,18194,17759,18759,5340,1434,1400,355,1000,126,450,1,15415,16218,17839,16759,18633,4890,0.77075,0.8109,0.89195,0.83795,0.93165,0.2445,0
5395,290000,1,2,1,37,-2,-2,-2,-2,-2,-2,1961,3144,500,0,0,0,3148,501,0,0,0,0,1,-1187,2643,500,0,0,0,-0.0040931034482758625,0.009113793103448276,0.0017241379310344827,0.0,0.0,0.0,-12
5396,80000,0,2,2,36,0,0,2,2,0,0,79673,79353,80107,78323,45985,45434,7100,2600,371,1904,1801,1801,0,72573,76753,79736,76419,44184,43633,0.9071625,0.9594125,0.9967,0.9552375,0.5523,0.5454125,4
5397,20000,0,3,3,46,0,0,0,0,0,0,14075,15523,17264,18325,15680,0,2000,2000,1500,500,0,0,0,12075,13523,15764,17825,15680,0,0.60375,0.67615,0.7882,0.89125,0.784,0.0,0
5398,210000,1,2,1,25,0,0,0,0,0,0,7788,8801,9825,10838,12652,13060,1149,1173,1186,2000,1000,1000,1,6639,7628,8639,8838,11652,12060,0.03161428571428571,0.03632380952380952,0.04113809523809524,0.04208571428571429,0.055485714285714284,0.057428571428571426,0
5399,300000,1,3,2,34,-1,-1,2,0,0,-1,2344,7929,7667,26900,31500,33920,8000,0,20000,5000,33920,0,0,-5656,7929,-12333,21900,-2420,33920,-0.018853333333333333,0.02643,-0.04111,0.073,-0.008066666666666666,0.11306666666666666,-1
5400,50000,1,3,1,52,0,0,0,0,0,0,11463,12763,14149,15162,15463,15788,1500,1600,1252,553,574,747,1,9963,11163,12897,14609,14889,15041,0.19926,0.22326,0.25794,0.29218,0.29778,0.30082,0
5401,460000,1,2,1,33,0,0,0,0,0,0,128302,59254,52099,45512,39041,33571,2371,2008,1560,1457,1299,769,1,125931,57246,50539,44055,37742,32802,0.27376304347826086,0.12444782608695652,0.10986739130434782,0.09577173913043478,0.08204782608695652,0.07130869565217392,0
5402,230000,1,2,2,29,-1,-1,-1,-1,-1,-1,2624,1149,2140,3313,3750,2491,1149,2140,3313,3750,2491,9785,0,1475,-991,-1173,-437,1259,-7294,0.0064130434782608695,-0.004308695652173913,-0.0051,-0.0019,0.0054739130434782604,-0.03171304347826087,-6
5403,50000,0,2,2,23,0,0,0,0,-2,-2,35176,30250,12625,0,0,0,2007,5000,0,0,0,0,0,33169,25250,12625,0,0,0,0.66338,0.505,0.2525,0.0,0.0,0.0,-4
5404,300000,0,3,1,31,-1,-1,-1,-1,-1,-1,1877,2466,0,462,0,3069,2500,0,462,0,3069,280,1,-623,2466,-462,462,-3069,2789,-0.0020766666666666668,0.00822,-0.00154,0.00154,-0.01023,0.009296666666666667,-6
5405,60000,1,2,1,49,2,0,0,0,2,0,61093,57227,32091,32792,31277,29512,1739,1791,2378,0,1092,3554,1,59354,55436,29713,32792,30185,25958,0.9892333333333333,0.9239333333333334,0.4952166666666667,0.5465333333333333,0.5030833333333333,0.4326333333333333,4
5406,300000,0,1,1,38,-2,-2,-2,-2,-2,-2,0,0,0,0,0,0,0,0,0,0,0,0,1,0,0,0,0,0,0,0.0,0.0,0.0,0.0,0.0,0.0,-12
5407,220000,0,2,1,47,4,3,2,2,2,2,216591,197022,198088,187000,179703,174571,0,6000,0,14004,0,7000,1,216591,191022,198088,172996,179703,167571,0.9845045454545455,0.8682818181818182,0.9004,0.7863454545454546,0.8168318181818182,0.7616863636363637,15
5408,190000,1,2,1,45,0,0,0,0,0,0,143701,126337,121378,75252,79028,81548,4664,4222,2705,5000,4000,5000,1,139037,122115,118673,70252,75028,76548,0.7317736842105264,0.6427105263157895,0.6245947368421053,0.36974736842105266,0.3948842105263158,0.4028842105263158,0
5409,350000,1,2,1,44,0,-1,-1,-1,-1,-1,110472,100849,5800,369718,2000,5910,100957,5800,371718,2180,5910,6000,1,9515,95049,-365918,367538,-3910,-90,0.027185714285714285,0.27156857142857144,-1.04548,1.0501085714285714,-0.011171428571428572,-0.00025714285714285715,-5
5410,430000,1,1,2,34,0,0,0,0,0,0,35792,36894,44848,39219,32008,19397,2000,10002,2000,5000,2000,7027,0,33792,26892,42848,34219,30008,12370,0.07858604651162791,0.06253953488372092,0.09964651162790698,0.07957906976744186,0.06978604651162791,0.028767441860465117,0
5411,80000,0,1,1,47,0,-1,-1,0,-1,-1,49735,25144,7905,7905,20616,7727,25144,8000,0,20616,7727,6191,1,24591,17144,7905,-12711,12889,1536,0.3073875,0.2143,0.0988125,-0.1588875,0.1611125,0.0192,-4
5412,220000,0,1,2,48,0,0,0,2,0,0,115294,117945,130365,126780,129570,133553,6000,16000,0,5000,6300,3000,0,109294,101945,130365,121780,123270,130553,0.4967909090909091,0.46338636363636365,0.5925681818181818,0.5535454545454546,0.5603181818181818,0.5934227272727273,2
5413,160000,1,1,1,41,0,0,0,0,0,0,120528,100050,102324,104697,103202,94360,7000,4000,4000,4115,4000,3690,1,113528,96050,98324,100582,99202,90670,0.70955,0.6003125,0.614525,0.6286375,0.6200125,0.5666875,0
5414,50000,0,1,2,27,0,0,0,0,0,0,49114,49907,38376,19595,19851,20256,2005,1323,840,713,727,701,0,47109,48584,37536,18882,19124,19555,0.94218,0.97168,0.75072,0.37764,0.38248,0.3911,0
5415,240000,1,2,1,41,1,2,0,0,0,0,137327,133724,136539,137487,141291,20143,0,6702,5000,6019,6099,14762,1,137327,127022,131539,131468,135192,5381,0.5721958333333333,0.5292583333333334,0.5480791666666667,0.5477833333333333,0.5633,0.022420833333333334,3
5416,220000,1,1,2,33,-1,2,-1,-1,-1,-1,652,326,1070,1163,2044,204,0,1070,1163,2049,204,4953,0,652,-744,-93,-886,1840,-4749,0.0029636363636363636,-0.003381818181818182,-0.00042272727272727275,-0.004027272727272727,0.008363636363636363,-0.021586363636363636,-3
5417,500000,1,1,2,28,0,-1,-1,-1,-1,0,6618,8984,9558,7426,11130,15382,8984,9570,7432,11130,10000,22212,0,-2366,-586,2126,-3704,1130,-6830,-0.004732,-0.001172,0.004252,-0.007408,0.00226,-0.01366,-4
5418,110000,0,2,2,26,0,0,0,0,0,0,36770,7611,9275,5751,10592,9701,2000,2000,2000,5000,3470,0,0,34770,5611,7275,751,7122,9701,0.3160909090909091,0.05100909090909091,0.06613636363636363,0.006827272727272727,0.06474545454545455,0.0881909090909091,0
5419,280000,1,2,2,24,-1,-1,-1,-1,-1,0,316,316,3861,316,10800,9099,316,3861,316,10800,382,5000,0,0,-3545,3545,-10484,10418,4099,0.0,-0.012660714285714286,0.012660714285714286,-0.037442857142857146,0.037207142857142855,0.014639285714285714,-5
5420,80000,1,2,2,22,0,0,0,0,0,0,77408,78363,72602,72525,56951,21952,2677,3341,1850,1499,933,32000,0,74731,75022,70752,71026,56018,-10048,0.9341375,0.937775,0.8844,0.887825,0.700225,-0.1256,0
5421,230000,0,1,1,48,0,0,0,0,0,0,160879,161797,165107,105508,108101,110094,7000,6607,3773,4290,4164,2000,1,153879,155190,161334,101218,103937,108094,0.6690391304347826,0.6747391304347826,0.7014521739130435,0.4400782608695652,0.4519,0.46997391304347824,0
5422,120000,1,1,2,26,-1,-1,2,-1,-1,-1,942,780,390,390,390,150,780,0,390,390,150,780,0,162,780,0,0,240,-630,0.00135,0.0065,0.0,0.0,0.002,-0.00525,-3
5423,50000,0,2,2,40,0,0,0,0,0,0,48331,49163,49754,19169,19480,19569,2300,2200,1000,1000,800,700,0,46031,46963,48754,18169,18680,18869,0.92062,0.93926,0.97508,0.36338,0.3736,0.37738,0
5424,150000,0,4,1,40,-1,-1,-1,-1,0,-1,291,291,291,432,441,882,291,291,432,300,882,0,1,0,0,-141,132,-441,882,0.0,0.0,-0.00094,0.00088,-0.00294,0.00588,-5
5425,160000,1,3,1,41,-1,-1,-1,-1,-1,-1,2392,316,416,416,416,2606,316,416,416,416,2606,316,1,2076,-100,0,0,-2190,2290,0.012975,-0.000625,0.0,0.0,-0.0136875,0.0143125,-6
5426,150000,1,2,1,41,0,0,-1,-1,-1,-1,4474,3881,1207,1617,0,620,3000,2306,2610,0,620,0,1,1474,1575,-1403,1617,-620,620,0.009826666666666666,0.0105,-0.009353333333333333,0.01078,-0.0041333333333333335,0.0041333333333333335,-4
5427,300000,1,2,2,43,0,0,0,0,0,2,36062,37055,38354,39634,21597,481,1897,2196,2476,3439,0,1248,0,34165,34859,35878,36195,21597,-767,0.11388333333333334,0.11619666666666667,0.11959333333333333,0.12065,0.07199,-0.0025566666666666667,2
5428,50000,0,2,2,31,0,0,0,0,-1,-1,48640,49483,40850,0,800,400,2000,3000,0,400,20000,10000,0,46640,46483,40850,-400,-19200,-9600,0.9328,0.92966,0.817,-0.008,-0.384,-0.192,-2
5429,180000,1,4,1,28,2,0,0,0,0,0,117328,115140,73730,64600,2500,0,4117,3504,3000,0,0,0,1,113211,111636,70730,64600,2500,0,0.62895,0.6202,0.39294444444444443,0.35888888888888887,0.013888888888888888,0.0,2
5430,200000,0,1,2,36,2,2,2,0,0,0,89082,91055,89064,90019,92850,98666,4000,0,3000,4000,7000,4000,0,85082,91055,86064,86019,85850,94666,0.42541,0.455275,0.43032,0.430095,0.42925,0.47333,6
5431,70000,1,2,1,30,0,0,0,0,0,0,8432,9596,10637,11965,12178,13962,1300,1200,1507,1000,2000,1000,1,7132,8396,9130,10965,10178,12962,0.10188571428571429,0.11994285714285714,0.13042857142857142,0.15664285714285714,0.1454,0.18517142857142857,0
5432,20000,0,2,2,22,0,0,-2,-2,-1,-1,13540,397,998,734,1698,500,406,1101,736,1799,601,0,0,13134,-704,262,-1065,1097,500,0.6567,-0.0352,0.0131,-0.05325,0.05485,0.025,-6
5433,250000,1,1,1,50,-2,-2,-1,-1,-1,-2,18381,2749,5285,9138,1187,1235,2749,5674,9527,1187,1235,2678,1,15632,-2925,-4242,7951,-48,-1443,0.062528,-0.0117,-0.016968,0.031804,-0.000192,-0.005772,-9
5434,30000,1,2,2,25,0,0,0,0,0,0,30523,30554,30593,30619,29146,29823,2000,2000,1700,1200,1300,1300,0,28523,28554,28893,29419,27846,28523,0.9507666666666666,0.9518,0.9631,0.9806333333333334,0.9282,0.9507666666666666,0
5435,100000,0,1,2,38,0,0,0,0,0,0,40810,42653,42351,43011,43011,28947,2502,1200,860,0,579,0,0,38308,41453,41491,43011,42432,28947,0.38308,0.41453,0.41491,0.43011,0.42432,0.28947,0
5436,70000,0,1,2,25,-1,2,2,2,2,0,3635,4529,4308,4859,4638,4911,1100,0,624,0,500,1000,0,2535,4529,3684,4859,4138,3911,0.03621428571428571,0.0647,0.05262857142857143,0.06941428571428572,0.059114285714285716,0.05587142857142857,7
5437,30000,0,2,2,49,1,2,2,0,0,-1,24597,26852,23117,24800,29410,23905,3000,0,3000,5000,23905,23771,0,21597,26852,20117,19800,5505,134,0.7199,0.8950666666666667,0.6705666666666666,0.66,0.1835,0.0044666666666666665,4
5438,130000,1,3,1,47,-1,2,2,-1,0,-1,5027,4151,1622,5032,1749,3645,1622,16,5377,829,3645,4213,1,3405,4135,-3755,4203,-1896,-568,0.026192307692307692,0.03180769230769231,-0.028884615384615384,0.03233076923076923,-0.014584615384615385,-0.004369230769230769,1
5439,90000,1,1,2,28,-1,0,0,0,0,0,23940,92233,91308,53991,56032,51010,75000,5000,4300,2800,2800,3600,0,-51060,87233,87008,51191,53232,47410,-0.5673333333333334,0.9692555555555555,0.9667555555555556,0.5687888888888889,0.5914666666666667,0.5267777777777778,-1
5440,30000,1,2,1,30,-2,-1,-1,-2,-1,-1,3165,13538,390,1050,1251,962,13538,390,1050,1851,962,0,1,-10373,13148,-660,-801,289,962,-0.34576666666666667,0.4382666666666667,-0.022,-0.0267,0.009633333333333334,0.03206666666666667,-8
5441,70000,1,2,1,36,0,0,0,0,0,0,59331,57786,58608,28105,30656,32674,3500,3000,3000,3000,3000,3000,1,55831,54786,55608,25105,27656,29674,0.7975857142857142,0.7826571428571428,0.7944,0.35864285714285715,0.39508571428571426,0.4239142857142857,0
5442,240000,0,2,2,25,0,0,0,0,0,0,62946,61940,61412,62771,65038,67266,2212,2237,5000,5000,5000,3413,0,60734,59703,56412,57771,60038,63853,0.25305833333333333,0.2487625,0.23505,0.2407125,0.2501583333333333,0.26605416666666665,0
5443,110000,0,1,1,52,0,0,0,0,0,0,82390,84024,84485,81057,43113,40805,4000,4015,4012,3000,2164,2000,1,78390,80009,80473,78057,40949,38805,0.7126363636363636,0.7273545454545455,0.7315727272727273,0.7096090909090909,0.37226363636363635,0.3527727272727273,0
5444,150000,1,2,2,38,-1,-1,-1,0,0,0,5219,0,5200,1561,1633,230,0,5200,0,72,460,4487,0,5219,-5200,5200,1489,1173,-4257,0.034793333333333336,-0.034666666666666665,0.034666666666666665,0.009926666666666667,0.00782,-0.02838,-3
5445,350000,0,1,2,41,1,-1,-1,-1,-1,-2,208,2906,1000,630,0,0,2906,1000,630,0,0,0,0,-2698,1906,370,630,0,0,-0.007708571428571428,0.0054457142857142855,0.0010571428571428572,0.0018,0.0,0.0,-5
5446,150000,1,1,2,31,-2,-2,-2,-2,-2,-2,4847,4268,0,1193,-127,-127,4268,0,1193,0,0,1956,0,579,4268,-1193,1193,-127,-2083,0.00386,0.028453333333333334,-0.007953333333333333,0.007953333333333333,-0.0008466666666666667,-0.013886666666666667,-12
5447,30000,0,1,1,42,0,0,-1,-1,-1,-1,28033,17085,200,323,29525,0,1525,200,323,29525,0,0,1,26508,16885,-123,-29202,29525,0,0.8836,0.5628333333333333,-0.0041,-0.9734,0.9841666666666666,0.0,-4
5448,100000,1,2,2,23,0,0,0,0,0,0,42409,43404,44446,45704,54916,56063,1700,1742,2000,10000,2025,2150,0,40709,41662,42446,35704,52891,53913,0.40709,0.41662,0.42446,0.35704,0.52891,0.53913,0
5449,90000,1,3,2,35,0,0,0,0,0,0,101106,96216,89964,29802,29174,26111,4208,4022,686,753,740,5034,0,96898,92194,89278,29049,28434,21077,1.0766444444444445,1.0243777777777778,0.9919777777777777,0.32276666666666665,0.31593333333333334,0.2341888888888889,0
5450,360000,1,3,1,47,-2,-2,-2,-2,-2,-2,1458,-4,3994,0,0,7429,0,3998,0,0,7429,490,1,1458,-4002,3994,0,-7429,6939,0.00405,-0.011116666666666667,0.011094444444444445,0.0,-0.020636111111111112,0.019275,-12
5451,30000,1,3,2,45,0,0,0,0,-1,-1,28611,23312,19590,18447,15525,0,1352,1290,4150,15525,0,0,0,27259,22022,15440,2922,15525,0,0.9086333333333333,0.7340666666666666,0.5146666666666667,0.0974,0.5175,0.0,-2
5452,20000,1,2,1,23,0,0,-1,-1,-1,0,14313,4256,200,0,18844,12052,1000,200,0,18844,241,0,1,13313,4056,200,-18844,18603,12052,0.66565,0.2028,0.01,-0.9422,0.93015,0.6026,-3
5453,80000,1,2,2,24,0,0,0,0,0,0,77139,78690,57259,56939,59066,60008,3010,2100,2000,3000,2500,2100,0,74129,76590,55259,53939,56566,57908,0.9266125,0.957375,0.6907375,0.6742375,0.707075,0.72385,0
5454,50000,1,2,2,24,0,0,0,0,-2,-2,30344,47000,33034,0,0,0,20002,1000,0,0,0,0,0,10342,46000,33034,0,0,0,0.20684,0.92,0.66068,0.0,0.0,0.0,-4
5455,150000,1,2,1,44,0,0,0,0,0,0,61951,55504,22050,17360,17360,12000,15000,1200,0,0,0,0,1,46951,54304,22050,17360,17360,12000,0.31300666666666666,0.36202666666666666,0.147,0.11573333333333333,0.11573333333333333,0.08,0
5456,140000,1,1,2,40,1,2,0,0,0,0,143478,135633,128285,123074,97382,99364,0,6601,5522,3200,3300,3500,0,143478,129032,122763,119874,94082,95864,1.0248428571428572,0.9216571428571428,0.8768785714285714,0.8562428571428572,0.6720142857142857,0.6847428571428571,3
5457,90000,1,3,1,37,0,0,0,0,0,0,78159,82779,86905,88310,79842,81235,8000,7500,4000,3000,2700,17000,1,70159,75279,82905,85310,77142,64235,0.7795444444444445,0.8364333333333334,0.9211666666666667,0.9478888888888889,0.8571333333333333,0.7137222222222223,0
5458,50000,1,1,2,26,0,0,0,0,0,0,16785,17801,18911,20090,20334,20856,1600,1700,1800,875,1000,4700,0,15185,16101,17111,19215,19334,16156,0.3037,0.32202,0.34222,0.3843,0.38668,0.32312,0
5459,100000,1,2,1,35,1,-2,-2,-2,-1,-1,0,0,0,0,4323,2000,0,0,0,4323,2000,0,1,0,0,0,-4323,2323,2000,0.0,0.0,0.0,-0.04323,0.02323,0.02,-7
5460,100000,0,2,2,25,0,0,0,0,0,0,86098,85014,86735,87321,82289,83850,3200,3155,3504,3001,3301,2839,0,82898,81859,83231,84320,78988,81011,0.82898,0.81859,0.83231,0.8432,0.78988,0.81011,0
5461,150000,1,4,1,35,0,0,0,0,0,0,39708,37441,36143,33567,32447,32592,1608,1510,1170,1183,1140,1141,1,38100,35931,34973,32384,31307,31451,0.254,0.23954,0.23315333333333332,0.21589333333333333,0.20871333333333333,0.20967333333333332,0
5462,280000,0,2,1,35,0,0,0,0,0,0,278948,278433,277620,275495,270350,260554,10609,10470,10002,9948,9475,9239,1,268339,267963,267618,265547,260875,251315,0.9583535714285715,0.9570107142857143,0.9557785714285715,0.9483821428571428,0.9316964285714285,0.8975535714285714,0
5463,120000,1,2,1,35,0,0,0,0,-2,-2,22148,21120,4746,0,0,0,1550,1000,0,0,0,0,1,20598,20120,4746,0,0,0,0.17165,0.16766666666666666,0.03955,0.0,0.0,0.0,-4
5464,150000,0,1,1,41,1,-2,-1,-1,-1,-2,-200,-200,1600,5431,0,0,0,1800,5431,0,0,0,1,-200,-2000,-3831,5431,0,0,-0.0013333333333333333,-0.013333333333333334,-0.02554,0.036206666666666665,0.0,0.0,-6
5465,100000,0,1,1,31,0,0,0,0,0,0,30505,31509,32597,33520,28930,30478,1509,1597,1520,1500,2000,26715,1,28996,29912,31077,32020,26930,3763,0.28996,0.29912,0.31077,0.3202,0.2693,0.03763,0
5466,30000,1,1,2,21,2,2,0,0,0,-2,30769,29559,29197,29488,0,0,0,1000,590,0,0,0,0,30769,28559,28607,29488,0,0,1.0256333333333334,0.9519666666666666,0.9535666666666667,0.9829333333333333,0.0,0.0,2
5467,10000,1,2,1,31,3,2,0,0,0,0,10243,9920,8894,8136,8449,8493,0,1281,1135,448,329,287,1,10243,8639,7759,7688,8120,8206,1.0243,0.8639,0.7759,0.7688,0.812,0.8206,5
5468,110000,0,2,2,32,0,0,0,0,0,0,97510,92152,94503,95571,91794,80365,3300,3838,3056,8000,3000,3200,0,94210,88314,91447,87571,88794,77165,0.8564545454545455,0.8028545454545455,0.8313363636363637,0.7961,0.8072181818181818,0.7015,0
5469,130000,1,2,1,35,0,0,0,0,0,0,63281,56889,60955,62038,62393,65439,10000,5000,2142,5000,4000,9500,1,53281,51889,58813,57038,58393,55939,0.4098538461538462,0.3991461538461539,0.4524076923076923,0.43875384615384616,0.4491769230769231,0.4303,0
5470,50000,1,2,2,43,-1,0,0,0,0,0,26342,27457,27381,17930,18128,18490,1547,1251,1200,600,627,759,0,24795,26206,26181,17330,17501,17731,0.4959,0.52412,0.52362,0.3466,0.35002,0.35462,-1
5471,120000,1,2,1,39,-2,-2,-2,-2,-2,-2,280,6192,2134,0,0,0,6192,2142,0,0,0,0,1,-5912,4050,2134,0,0,0,-0.04926666666666667,0.03375,0.017783333333333335,0.0,0.0,0.0,-12
5472,360000,1,1,2,29,-1,-1,-1,0,-1,-1,1766,4500,14697,10687,1968,1272,4534,14697,0,2141,1272,24078,0,-2768,-10197,14697,8546,696,-22806,-0.007688888888888889,-0.028325,0.040825,0.02373888888888889,0.0019333333333333333,-0.06335,-5
5473,500000,1,1,1,39,-2,-2,-1,2,2,-2,3625,0,501,501,902,544,398,501,0,544,544,0,1,3227,-501,501,-43,358,544,0.006454,-0.001002,0.001002,-8.6e-05,0.000716,0.001088,-3
5474,370000,0,2,2,39,2,0,0,0,0,0,334394,337272,340152,345904,322168,272461,14005,12004,12362,12006,9555,11005,0,320389,325268,327790,333898,312613,261456,0.8659162162162162,0.8791027027027027,0.8859189189189189,0.902427027027027,0.8449,0.7066378378378378,2
5475,10000,1,2,2,55,1,2,0,0,0,0,9193,7653,8337,8356,8527,4694,0,1201,1000,171,94,80,0,9193,6452,7337,8185,8433,4614,0.9193,0.6452,0.7337,0.8185,0.8433,0.4614,3
5476,390000,0,1,1,38,-1,-1,-1,0,0,-1,9610,6090,18119,15220,7658,7547,6090,18119,304,416,7547,897,1,3520,-12029,17815,14804,111,6650,0.009025641025641025,-0.030843589743589743,0.04567948717948718,0.03795897435897436,0.0002846153846153846,0.017051282051282052,-4
5477,230000,1,2,2,28,0,0,0,0,0,-1,7865,12377,12543,13713,17960,650,5000,2000,1500,5000,650,0,0,2865,10377,11043,8713,17310,650,0.012456521739130436,0.045117391304347824,0.04801304347826087,0.03788260869565217,0.0752608695652174,0.002826086956521739,-1
5478,140000,1,2,2,33,0,0,0,0,0,2,59097,59655,60992,62253,69594,68262,2137,2300,2278,9300,0,3000,0,56960,57355,58714,52953,69594,65262,0.40685714285714286,0.40967857142857145,0.4193857142857143,0.3782357142857143,0.4971,0.4661571428571429,2
5479,80000,1,2,2,24,2,2,5,5,4,3,1200,1200,1200,1200,600,300,0,0,0,0,0,0,0,1200,1200,1200,1200,600,300,0.015,0.015,0.015,0.015,0.0075,0.00375,21
5480,80000,1,2,1,26,0,0,0,0,0,0,78872,80301,74349,75443,57735,58139,2800,2800,2400,2100,2100,2100,1,76072,77501,71949,73343,55635,56039,0.9509,0.9687625,0.8993625,0.9167875,0.6954375,0.7004875,0
5481,260000,1,2,1,41,0,0,0,0,2,0,195465,199338,203651,223837,218383,222960,8400,8800,25000,0,8000,21000,1,187065,190538,178651,223837,210383,201960,0.7194807692307692,0.7328384615384615,0.6871192307692308,0.8609115384615385,0.8091653846153846,0.7767692307692308,2
5482,20000,0,3,1,53,0,0,2,0,0,0,17614,19323,19694,20004,20159,20059,2000,1000,1000,1000,1000,800,1,15614,18323,18694,19004,19159,19259,0.7807,0.91615,0.9347,0.9502,0.95795,0.96295,2
5483,210000,1,2,1,47,-1,-1,-1,-1,-1,-1,2295,561,2607,3586,3676,4095,566,2617,3591,3680,4095,8699,1,1729,-2056,-984,-94,-419,-4604,0.008233333333333334,-0.00979047619047619,-0.004685714285714286,-0.0004476190476190476,-0.001995238095238095,-0.021923809523809522,-6
5484,200000,0,2,1,45,0,0,0,0,0,0,197600,200378,162374,154234,143953,147834,10265,6061,7048,5016,10294,5136,1,187335,194317,155326,149218,133659,142698,0.936675,0.971585,0.77663,0.74609,0.668295,0.71349,0
5485,30000,0,3,1,48,0,0,2,2,3,2,20817,23860,24372,25776,25088,24537,3400,1200,2100,0,0,2200,1,17417,22660,22272,25776,25088,22337,0.5805666666666667,0.7553333333333333,0.7424,0.8592,0.8362666666666667,0.7445666666666667,9
5486,20000,0,3,2,25,2,2,4,4,4,4,1650,1650,1650,1650,1650,1650,0,0,0,0,0,0,0,1650,1650,1650,1650,1650,1650,0.0825,0.0825,0.0825,0.0825,0.0825,0.0825,20
5487,70000,1,4,1,23,0,0,0,0,0,0,30847,31849,33333,34344,35032,35807,1516,2000,1600,1215,1300,1500,1,29331,29849,31733,33129,33732,34307,0.41901428571428573,0.4264142857142857,0.4533285714285714,0.47327142857142857,0.4818857142857143,0.4901,0
5488,210000,0,2,1,48,0,0,0,0,0,0,186004,169351,163576,115854,111606,120885,8100,7000,4000,5000,105015,4100,1,177904,162351,159576,110854,6591,116785,0.8471619047619048,0.7731,0.7598857142857143,0.5278761904761905,0.03138571428571429,0.5561190476190476,0
5489,230000,0,1,2,36,0,0,0,0,0,0,218637,223208,159930,141834,213408,222681,10034,5600,10753,100000,12823,8910,0,208603,217608,149177,41834,200585,213771,0.9069695652173912,0.9461217391304347,0.648595652173913,0.18188695652173914,0.8721086956521739,0.9294391304347827,0
5490,20000,1,2,1,39,1,2,0,0,0,0,19565,18968,19612,16213,16812,18382,0,1300,717,1000,2000,1000,1,19565,17668,18895,15213,14812,17382,0.97825,0.8834,0.94475,0.76065,0.7406,0.8691,3
5491,10000,0,3,2,41,0,0,0,0,0,0,4520,3483,6862,8727,8148,8640,2000,4946,2000,1000,1000,1000,0,2520,-1463,4862,7727,7148,7640,0.252,-0.1463,0.4862,0.7727,0.7148,0.764,0
5492,90000,1,2,1,41,1,1,-2,-2,-2,-2,28636,-2364,-2364,-2364,-2364,-2364,0,0,0,0,0,0,1,28636,-2364,-2364,-2364,-2364,-2364,0.3181777777777778,-0.026266666666666667,-0.026266666666666667,-0.026266666666666667,-0.026266666666666667,-0.026266666666666667,-6
5493,240000,1,1,2,29,-1,0,0,0,0,0,30380,15579,20496,15296,24332,23896,10023,10000,5000,15000,15000,5000,0,20357,5579,15496,296,9332,18896,0.08482083333333333,0.023245833333333334,0.06456666666666666,0.0012333333333333332,0.03888333333333333,0.07873333333333334,-1
5494,200000,0,3,1,37,0,0,0,0,0,0,65927,59688,53084,46363,39843,33004,2700,2200,1700,1489,1200,1100,1,63227,57488,51384,44874,38643,31904,0.316135,0.28744,0.25692,0.22437,0.193215,0.15952,0
5495,100000,0,2,2,35,2,0,0,0,0,0,92590,93354,69674,71097,72913,74738,3251,2600,2582,3000,3000,3000,0,89339,90754,67092,68097,69913,71738,0.89339,0.90754,0.67092,0.68097,0.69913,0.71738,2
5496,150000,1,2,1,31,1,-2,-1,-1,-1,-2,6526,779,8927,8660,692,0,783,9098,8660,698,0,0,1,5743,-8319,267,7962,692,0,0.03828666666666666,-0.05546,0.00178,0.05308,0.004613333333333333,0.0,-6
5497,80000,0,3,2,32,0,0,0,0,0,0,71375,18353,94675,90470,85449,80309,1414,83402,4000,3058,2903,2626,0,69961,-65049,90675,87412,82546,77683,0.8745125,-0.8131125,1.1334375,1.09265,1.031825,0.9710375,0
5498,450000,0,2,1,46,-1,-1,-1,-1,-1,-1,130,1926,15671,18552,24222,32867,1926,15671,18574,24231,32885,9343,1,-1796,-13745,-2903,-5679,-8663,23524,-0.003991111111111111,-0.030544444444444444,-0.0064511111111111115,-0.01262,-0.01925111111111111,0.052275555555555554,-6
5499,240000,0,1,1,39,0,0,0,0,0,0,236229,222103,221963,181559,173023,156115,8019,7218,10060,5893,7008,25043,1,228210,214885,211903,175666,166015,131072,0.950875,0.8953541666666667,0.8829291666666667,0.7319416666666667,0.6917291666666666,0.5461333333333334,0
5500,500000,1,1,1,46,-2,-2,-2,-2,-2,-2,3982,3700,12953,9019,4236,-31,3718,13023,9070,4257,0,0,1,264,-9323,3883,4762,4236,-31,0.000528,-0.018646,0.007766,0.009524,0.008472,-6.2e-05,-12
5501,160000,0,1,2,27,1,-2,-2,-1,-1,-1,-1860,-2790,-4650,930,930,2010,0,0,5580,930,2010,0,0,-1860,-2790,-10230,0,-1080,2010,-0.011625,-0.0174375,-0.0639375,0.0,-0.00675,0.0125625,-6
5502,80000,1,3,1,65,0,0,0,0,0,0,82074,80260,82116,80299,81416,81617,3470,3750,3520,3069,3271,3262,1,78604,76510,78596,77230,78145,78355,0.98255,0.956375,0.98245,0.965375,0.9768125,0.9794375,0
5503,210000,0,1,1,34,0,0,0,0,0,-1,42617,67734,66612,65799,-41,8208,30020,4043,10329,0,8249,2572,1,12597,63691,56283,65799,-8290,5636,0.05998571428571429,0.30329047619047617,0.2680142857142857,0.31332857142857146,-0.03947619047619048,0.026838095238095237,-1
5504,50000,0,2,2,39,3,2,0,0,0,0,51998,50821,46892,33936,9225,9264,0,2343,1548,476,336,348,0,51998,48478,45344,33460,8889,8916,1.03996,0.96956,0.90688,0.6692,0.17778,0.17832,5
5505,70000,1,1,2,24,0,0,0,0,0,0,10916,12386,9864,5201,6950,7256,2000,2063,2000,2000,421,2000,0,8916,10323,7864,3201,6529,5256,0.12737142857142858,0.14747142857142856,0.11234285714285715,0.04572857142857143,0.09327142857142857,0.07508571428571428,0
5506,200000,0,3,1,36,0,0,0,2,2,2,25469,26663,28509,27381,29054,28052,2000,3000,0,2500,0,1500,1,23469,23663,28509,24881,29054,26552,0.117345,0.118315,0.142545,0.124405,0.14527,0.13276,6
5507,100000,1,3,1,28,-2,-2,-2,-2,-2,-2,3166,6896,416,416,416,412,6896,416,416,416,412,1223,1,-3730,6480,0,0,4,-811,-0.0373,0.0648,0.0,0.0,4e-05,-0.00811,-12
5508,210000,1,1,2,33,-1,-1,-1,-1,-1,-1,591,1053,2989,2046,17239,3680,1053,2992,2046,17239,3680,0,0,-462,-1939,943,-15193,13559,3680,-0.0022,-0.009233333333333333,0.0044904761904761906,-0.07234761904761905,0.06456666666666666,0.017523809523809525,-6
5509,260000,0,2,2,30,0,0,0,2,0,0,4640,5891,8840,8464,10068,10977,1500,4000,0,2000,1500,1000,0,3140,1891,8840,6464,8568,9977,0.012076923076923077,0.007273076923076923,0.034,0.024861538461538463,0.03295384615384615,0.038373076923076926,2
5510,570000,0,1,2,33,0,0,0,0,0,-2,388897,253793,261176,266800,0,0,9083,11472,12000,0,0,0,0,379814,242321,249176,266800,0,0,0.666340350877193,0.4251245614035088,0.43715087719298246,0.46807017543859647,0.0,0.0,-2
5511,200000,1,4,2,42,-1,0,0,-2,-1,-1,5433,7328,0,0,2621,-72,2000,0,0,2621,0,0,0,3433,7328,0,-2621,2621,-72,0.017165,0.03664,0.0,-0.013105,0.013105,-0.00036,-5
5512,150000,0,2,2,36,-1,-1,-2,-2,-2,-2,5382,0,0,0,0,0,0,0,0,0,0,0,0,5382,0,0,0,0,0,0.03588,0.0,0.0,0.0,0.0,0.0,-10
5513,210000,1,1,2,37,-1,-1,-1,-1,0,-1,349,10128,19631,23906,373,3073,10152,19631,23906,0,3073,7418,0,-9803,-9503,-4275,23906,-2700,-4345,-0.04668095238095238,-0.045252380952380954,-0.02035714285714286,0.11383809523809524,-0.012857142857142857,-0.02069047619047619,-5
5514,390000,0,1,1,41,-2,-2,-2,-2,-2,-2,7015,500,321,4411,1069,448,500,321,4412,1069,448,2661,1,6515,179,-4091,3342,621,-2213,0.016705128205128206,0.000458974358974359,-0.01048974358974359,0.00856923076923077,0.0015923076923076923,-0.005674358974358975,-12
5515,30000,0,1,2,41,2,2,2,2,2,0,24357,27453,26718,28168,27579,28321,3500,0,2200,0,1200,1250,0,20857,27453,24518,28168,26379,27071,0.6952333333333334,0.9151,0.8172666666666667,0.9389333333333333,0.8793,0.9023666666666667,10
5516,210000,1,4,2,29,0,0,0,0,0,0,67931,65289,64778,65861,63794,65069,12411,13000,12340,14000,12364,13000,0,55520,52289,52438,51861,51430,52069,0.2643809523809524,0.2489952380952381,0.2497047619047619,0.24695714285714285,0.2449047619047619,0.24794761904761906,0
5517,360000,0,3,1,49,0,0,0,0,0,0,170792,153458,136109,114908,111274,110141,5729,5365,4664,3890,3899,4724,1,165063,148093,131445,111018,107375,105417,0.45850833333333335,0.41136944444444445,0.365125,0.30838333333333334,0.2982638888888889,0.292825,0
5518,100000,1,3,1,50,0,0,0,0,0,0,49032,48477,46605,48795,48968,49752,1736,1810,3000,1734,1944,2420,1,47296,46667,43605,47061,47024,47332,0.47296,0.46667,0.43605,0.47061,0.47024,0.47332,0
5519,20000,1,2,2,39,0,0,0,0,0,0,20885,20373,19391,20085,19938,0,2157,1660,1300,541,0,0,0,18728,18713,18091,19544,19938,0,0.9364,0.93565,0.90455,0.9772,0.9969,0.0,0
5520,500000,1,1,2,36,-1,-1,-1,-1,-1,-1,10935,4079,3943,3338,1224,31022,4081,4283,3338,1224,31022,1088,0,6854,-204,605,2114,-29798,29934,0.013708,-0.000408,0.00121,0.004228,-0.059596,0.059868,-6
5521,130000,1,1,2,26,0,0,0,0,0,0,7852,8871,9883,10079,10289,10495,1152,1164,360,372,376,540,0,6700,7707,9523,9707,9913,9955,0.05153846153846154,0.05928461538461539,0.07325384615384616,0.07466923076923077,0.07625384615384616,0.07657692307692307,0
5522,80000,0,1,1,41,-1,-1,-1,-1,-1,-1,11688,8739,10926,3355,6127,25675,8739,10926,3362,6127,25675,7606,1,2949,-2187,7564,-2772,-19548,18069,0.0368625,-0.0273375,0.09455,-0.03465,-0.24435,0.2258625,-6
5523,120000,0,1,2,41,1,-2,-2,-1,0,0,-8,-208,-408,57392,58805,60200,0,0,58000,2000,2000,0,0,-8,-208,-58408,55392,56805,60200,-6.666666666666667e-05,-0.0017333333333333333,-0.48673333333333335,0.4616,0.473375,0.5016666666666667,-4
5524,60000,1,2,2,28,2,0,0,0,2,-1,5669,6328,8460,10146,9413,15997,2000,3000,2500,0,15997,3000,0,3669,3328,5960,10146,-6584,12997,0.06115,0.055466666666666664,0.09933333333333333,0.1691,-0.10973333333333334,0.21661666666666668,3
5525,60000,1,1,2,27,1,-2,-2,-1,-1,-1,0,0,0,150,1179,778,0,0,150,1179,778,496,0,0,0,-150,-1029,401,282,0.0,0.0,-0.0025,-0.01715,0.006683333333333334,0.0047,-6
5526,360000,1,1,1,42,-1,-1,-1,-1,-1,-1,5658,4164,2469,0,5724,7334,4164,2469,0,5724,7334,5221,1,1494,1695,2469,-5724,-1610,2113,0.00415,0.0047083333333333335,0.0068583333333333335,-0.0159,-0.004472222222222222,0.0058694444444444445,-6
5527,30000,0,2,2,32,2,0,0,2,2,2,7851,9065,11595,11112,12923,12566,1500,3000,0,2000,0,1000,0,6351,6065,11595,9112,12923,11566,0.2117,0.20216666666666666,0.3865,0.30373333333333336,0.4307666666666667,0.38553333333333334,8
5528,250000,1,2,1,43,-1,-1,-2,-1,-1,0,399,508,-3,-3,51169,51482,508,3,24,51800,1826,1787,1,-109,505,-27,-51803,49343,49695,-0.000436,0.00202,-0.000108,-0.207212,0.197372,0.19878,-6
5529,360000,0,3,2,49,-2,-2,-2,-2,-2,-2,348,7963,198840,390,390,390,8047,200222,1044,390,390,343,0,-7699,-192259,197796,0,0,47,-0.021386111111111113,-0.5340527777777778,0.5494333333333333,0.0,0.0,0.00013055555555555555,-12
5530,240000,1,1,1,38,2,2,2,2,2,2,107425,109678,111948,112626,113988,116315,5500,5500,4000,4700,4300,4500,1,101925,104178,107948,107926,109688,111815,0.4246875,0.434075,0.4497833333333333,0.44969166666666666,0.45703333333333335,0.46589583333333334,12
5531,130000,0,2,1,43,0,0,0,-1,-1,-1,59762,61877,60390,390,390,390,3496,1208,390,390,390,390,1,56266,60669,60000,0,0,0,0.4328153846153846,0.46668461538461536,0.46153846153846156,0.0,0.0,0.0,-3
5532,80000,0,2,2,28,3,2,0,0,0,0,79425,77223,75075,76348,77798,79843,107,2563,2356,2296,2800,910,0,79318,74660,72719,74052,74998,78933,0.991475,0.93325,0.9089875,0.92565,0.937475,0.9866625,5
5533,280000,1,2,1,27,0,0,0,0,0,0,280913,283222,273160,257689,193231,191143,11052,9563,15017,5374,5420,6021,1,269861,273659,258143,252315,187811,185122,0.9637892857142857,0.9773535714285714,0.9219392857142857,0.901125,0.6707535714285714,0.66115,0
5534,250000,1,2,2,31,0,0,0,0,0,0,171006,167192,46332,40974,26683,26887,5004,3330,2000,2000,2000,3000,0,166002,163862,44332,38974,24683,23887,0.664008,0.655448,0.177328,0.155896,0.098732,0.095548,0
5535,330000,0,2,2,33,0,0,0,0,0,0,50999,50055,47398,40334,34443,33898,2000,2007,2000,2000,2000,2000,0,48999,48048,45398,38334,32443,31898,0.1484818181818182,0.1456,0.13756969696969698,0.11616363636363636,0.09831212121212121,0.09666060606060606,0
5536,50000,1,2,2,29,0,0,0,0,0,0,45013,43995,39478,19865,19388,19792,2007,1358,680,845,871,1000,0,43006,42637,38798,19020,18517,18792,0.86012,0.85274,0.77596,0.3804,0.37034,0.37584,0
5537,280000,1,1,1,41,0,0,0,0,0,0,99755,81244,81193,82470,49630,46517,3000,3007,5000,2000,1700,2000,1,96755,78237,76193,80470,47930,44517,0.3455535714285714,0.27941785714285716,0.27211785714285713,0.2873928571428571,0.17117857142857143,0.15898928571428572,0
5538,290000,1,1,1,36,0,0,0,0,0,0,97733,91270,79396,69925,71794,73597,3500,3000,3000,3000,3000,3000,1,94233,88270,76396,66925,68794,70597,0.32494137931034484,0.30437931034482757,0.2634344827586207,0.23077586206896553,0.2372206896551724,0.24343793103448275,0
5539,80000,0,4,2,23,1,-1,-1,-1,0,0,-24,3032,3318,1278,2541,15452,3056,3324,1278,2003,15000,13004,0,-3080,-292,2040,-725,-12459,2448,-0.0385,-0.00365,0.0255,-0.0090625,-0.1557375,0.0306,-2
5540,150000,1,2,2,22,0,0,0,-1,0,0,7600,8749,10652,32330,15681,6173,1300,3652,33866,410,200,776,0,6300,5097,-23214,31920,15481,5397,0.042,0.03398,-0.15476,0.2128,0.10320666666666667,0.03598,-1
5541,300000,1,1,2,25,1,5,4,3,2,3,315632,309330,302869,306395,311256,305413,0,0,10000,10000,0,0,0,315632,309330,292869,296395,311256,305413,1.0521066666666667,1.0311,0.97623,0.9879833333333333,1.03752,1.0180433333333334,18
5542,180000,1,2,2,29,-1,-1,-2,-2,-1,2,13936,0,0,0,1030,440,0,0,0,1030,0,0,0,13936,0,0,-1030,1030,440,0.07742222222222223,0.0,0.0,-0.005722222222222222,0.005722222222222222,0.0024444444444444444,-5
5543,250000,1,1,2,33,2,0,0,0,0,2,243262,238599,198588,203286,215882,214320,7991,9000,8000,16000,2000,6200,0,235271,229599,190588,187286,213882,208120,0.941084,0.918396,0.762352,0.749144,0.855528,0.83248,4
5544,500000,1,1,2,33,0,-1,-1,-1,0,-1,30267,14773,18129,18934,21687,16438,14773,18129,18941,16687,16438,415,0,15494,-3356,-812,2247,5249,16023,0.030988,-0.006712,-0.001624,0.004494,0.010498,0.032046,-4
5545,420000,0,2,1,32,0,0,2,2,-2,-2,203843,21400,800,0,0,0,3200,0,0,0,0,0,1,200643,21400,800,0,0,0,0.4777214285714286,0.05095238095238095,0.0019047619047619048,0.0,0.0,0.0,0
5546,230000,0,3,2,29,1,-1,-1,-1,-1,-1,-4,1496,4872,0,1241,-383,1500,5000,0,1241,0,2000,0,-1504,-3504,4872,-1241,1241,-2383,-0.006539130434782609,-0.015234782608695652,0.021182608695652173,-0.005395652173913044,0.005395652173913044,-0.010360869565217392,-4
5547,360000,1,1,2,29,-1,0,0,0,0,-1,8805,10768,16659,25302,15147,5281,5001,6688,16251,394,5307,5389,0,3804,4080,408,24908,9840,-108,0.010566666666666667,0.011333333333333334,0.0011333333333333334,0.06918888888888888,0.027333333333333334,-0.0003,-2
5548,50000,1,3,1,33,0,0,0,0,0,0,40757,39847,37561,36725,35346,33810,2000,1719,1783,1200,1200,1500,1,38757,38128,35778,35525,34146,32310,0.77514,0.76256,0.71556,0.7105,0.68292,0.6462,0
5549,20000,0,2,2,26,-1,-1,-2,-2,-2,-2,70,-620,-620,-1400,0,0,0,0,0,1400,0,0,0,70,-620,-620,-2800,0,0,0.0035,-0.031,-0.031,-0.14,0.0,0.0,-10
5550,50000,0,1,2,29,0,0,0,0,0,0,27179,27878,28908,29922,30517,31164,1454,1484,1498,1093,1139,2039,0,25725,26394,27410,28829,29378,29125,0.5145,0.52788,0.5482,0.57658,0.58756,0.5825,0
5551,200000,1,1,2,44,0,0,0,0,0,0,35210,34606,34800,33275,33435,32778,1858,2100,2000,3435,3000,3277,0,33352,32506,32800,29840,30435,29501,0.16676,0.16253,0.164,0.1492,0.152175,0.147505,0
5552,50000,1,2,2,26,0,0,2,2,2,2,44883,47349,47475,46730,27204,9662,3189,1500,101,1590,0,194,0,41694,45849,47374,45140,27204,9468,0.83388,0.91698,0.94748,0.9028,0.54408,0.18936,8
5553,150000,1,2,2,44,2,2,0,0,0,0,168179,159008,157164,155109,153033,156636,0,5684,5538,5410,11000,0,0,168179,153324,151626,149699,142033,156636,1.1211933333333333,1.02216,1.01084,0.9979933333333333,0.9468866666666667,1.04424,4
5554,50000,0,1,2,31,0,0,0,0,0,0,4560,7302,9011,11540,14180,15307,3000,2000,3000,3000,2000,5000,0,1560,5302,6011,8540,12180,10307,0.0312,0.10604,0.12022,0.1708,0.2436,0.20614,0
5555,150000,0,1,1,41,-2,-2,-1,2,-1,-1,0,0,6785,6572,1800,0,0,6785,0,1808,0,0,1,0,-6785,6785,4764,1800,0,0.0,-0.045233333333333334,0.045233333333333334,0.03176,0.012,0.0,-5
5556,200000,1,2,1,30,-2,-1,2,-1,-1,-2,0,1541,811,2754,17557,1144,1541,4,3071,17557,1144,1252,1,-1541,1537,-2260,-14803,16413,-108,-0.007705,0.007685,-0.0113,-0.074015,0.082065,-0.00054,-5
5557,20000,0,1,2,23,0,0,0,0,0,-1,18055,2059,2576,1834,1092,942,1100,1500,200,200,942,19840,0,16955,559,2376,1634,150,-18898,0.84775,0.02795,0.1188,0.0817,0.0075,-0.9449,-1
5558,240000,1,1,1,43,0,-1,-1,-2,-2,-2,8862,3220,0,0,0,0,3220,0,0,0,0,0,1,5642,3220,0,0,0,0,0.023508333333333332,0.013416666666666667,0.0,0.0,0.0,0.0,-8
5559,300000,1,2,1,31,0,0,0,0,0,0,89240,92016,92971,94817,96756,98325,4214,3377,3395,3468,3133,3307,1,85026,88639,89576,91349,93623,95018,0.28342,0.29546333333333336,0.29858666666666667,0.3044966666666667,0.31207666666666667,0.31672666666666666,0
5560,250000,1,2,1,33,-1,-1,-1,-1,-1,-1,484,0,242,28932,0,100000,0,242,28932,0,100000,0,1,484,-242,-28690,28932,-100000,100000,0.001936,-0.000968,-0.11476,0.115728,-0.4,0.4,-6
5561,50000,1,2,2,26,2,0,0,2,2,0,26023,27054,29458,29737,29123,29854,1453,2857,1058,0,1216,1097,0,24570,24197,28400,29737,27907,28757,0.4914,0.48394,0.568,0.59474,0.55814,0.57514,6
5562,120000,1,2,1,28,1,2,0,0,0,0,60188,58467,59760,60990,61960,65233,0,3000,3000,3000,5000,0,1,60188,55467,56760,57990,56960,65233,0.5015666666666667,0.462225,0.473,0.48325,0.4746666666666667,0.5436083333333334,3
5563,190000,0,2,1,35,1,-2,-1,-1,-2,-2,0,0,100104,0,0,0,0,100104,0,0,0,0,1,0,-100104,100104,0,0,0,0.0,-0.5268631578947368,0.5268631578947368,0.0,0.0,0.0,-7
5564,100000,1,3,1,53,1,-2,-2,-2,-2,-2,0,0,0,0,0,0,0,0,0,0,0,0,1,0,0,0,0,0,0,0.0,0.0,0.0,0.0,0.0,0.0,-9
5565,50000,1,2,2,38,0,0,0,0,0,0,38945,39498,38272,29810,18674,19391,2511,2000,3000,4000,1000,1000,0,36434,37498,35272,25810,17674,18391,0.72868,0.74996,0.70544,0.5162,0.35348,0.36782,0
5566,350000,1,1,2,32,0,-1,-1,-1,0,0,10830,2749,3229,3096,6373,10531,2749,3229,3500,4000,5000,4000,0,8081,-480,-271,-904,1373,6531,0.023088571428571427,-0.0013714285714285714,-0.0007742857142857143,-0.002582857142857143,0.003922857142857143,0.01866,-3
5567,200000,1,2,1,39,1,-2,-1,-1,-1,-2,0,0,12888,2075,0,0,0,12888,2075,0,0,5051,1,0,-12888,10813,2075,0,-5051,0.0,-0.06444,0.054065,0.010375,0.0,-0.025255,-6
5568,50000,1,3,2,40,0,0,0,0,0,0,19824,29311,30862,26614,15571,14971,15000,10000,5000,1500,800,2000,0,4824,19311,25862,25114,14771,12971,0.09648,0.38622,0.51724,0.50228,0.29542,0.25942,0
5569,60000,0,2,2,25,0,0,0,0,0,0,15614,16231,17074,17684,20003,21040,1267,1500,1291,3000,2000,390,0,14347,14731,15783,14684,18003,20650,0.23911666666666667,0.24551666666666666,0.26305,0.24473333333333333,0.30005,0.3441666666666667,0
5570,180000,0,2,2,38,2,2,0,0,0,-2,21564,20939,22182,12382,-18,-18,0,2100,200,0,0,0,0,21564,18839,21982,12382,-18,-18,0.1198,0.10466111111111111,0.12212222222222222,0.06878888888888889,-0.0001,-0.0001,2
5571,160000,1,2,2,52,0,0,0,0,0,0,38695,40757,42769,44448,46269,48036,3000,2700,2700,2700,2700,2700,0,35695,38057,40069,41748,43569,45336,0.22309375,0.23785625,0.25043125,0.260925,0.27230625,0.28335,0
5572,130000,0,2,1,39,0,-1,-1,-1,-1,-1,10896,390,390,390,390,390,390,390,390,390,390,390,1,10506,0,0,0,0,0,0.08081538461538462,0.0,0.0,0.0,0.0,0.0,-5
5573,230000,1,4,1,32,-1,-1,-1,-1,-2,-2,11000,0,8100,-2900,-2900,-2900,0,8100,0,0,0,110256,1,11000,-8100,8100,-2900,-2900,-113156,0.04782608695652174,-0.035217391304347825,0.035217391304347825,-0.012608695652173913,-0.012608695652173913,-0.4919826086956522,-8
5574,100000,1,1,2,22,2,0,0,0,0,0,72222,73859,75427,76587,78711,80510,3400,3400,3000,3500,3200,2000,0,68822,70459,72427,73087,75511,78510,0.68822,0.70459,0.72427,0.73087,0.75511,0.7851,2
5575,110000,1,2,2,25,2,2,2,2,2,0,111483,114125,114087,113879,112268,107423,5900,3500,3400,0,4000,4000,0,105583,110625,110687,113879,108268,103423,0.9598454545454546,1.0056818181818181,1.0062454545454544,1.0352636363636363,0.9842545454545455,0.9402090909090909,10
5576,400000,0,2,1,34,-1,-1,-1,-1,-1,-1,19660,9666,11867,7839,14837,7959,9677,11867,7839,14837,7959,5712,1,9983,-2201,4028,-6998,6878,2247,0.0249575,-0.0055025,0.01007,-0.017495,0.017195,0.0056175,-6
5577,10000,0,2,1,58,2,2,2,2,2,0,8857,9964,9654,10348,10044,10009,1400,0,1000,0,515,344,1,7457,9964,8654,10348,9529,9665,0.7457,0.9964,0.8654,1.0348,0.9529,0.9665,10
5578,30000,1,2,1,45,0,0,0,0,0,0,30488,30900,30480,31124,29333,30177,1600,1500,1100,1053,1320,967,1,28888,29400,29380,30071,28013,29210,0.9629333333333333,0.98,0.9793333333333333,1.0023666666666666,0.9337666666666666,0.9736666666666667,0
5579,280000,1,1,2,29,-1,-1,-1,-1,-1,0,33210,526,9252,21254,1608,407,726,9298,21360,1614,2,4069,0,32484,-8772,-12108,19640,1606,-3662,0.11601428571428571,-0.03132857142857143,-0.043242857142857145,0.07014285714285715,0.005735714285714286,-0.013078571428571429,-5
5580,90000,1,1,1,29,0,0,0,0,0,0,4034,11387,4387,35670,41995,35912,10400,3400,36139,618,3200,8500,1,-6366,7987,-31752,35052,38795,27412,-0.07073333333333333,0.08874444444444445,-0.3528,0.3894666666666667,0.4310555555555556,0.3045777777777778,0
5581,230000,1,1,2,33,0,0,0,0,0,0,19518,21735,22599,20600,24132,38793,3735,3599,3600,4132,15000,5865,0,15783,18136,18999,16468,9132,32928,0.06862173913043479,0.07885217391304347,0.08260434782608696,0.0716,0.03970434782608696,0.14316521739130436,0
5582,50000,0,2,2,26,1,2,0,0,2,2,16412,15851,16889,19909,19291,20675,0,1294,3314,0,1700,0,0,16412,14557,13575,19909,17591,20675,0.32824,0.29114,0.2715,0.39818,0.35182,0.4135,7
5583,220000,1,3,2,46,0,0,0,0,0,0,214274,214207,211733,80965,78992,77537,11000,10000,10000,6000,6000,5000,0,203274,204207,201733,74965,72992,72537,0.9239727272727273,0.9282136363636364,0.9169681818181818,0.34075,0.3317818181818182,0.3297136363636364,0
5584,120000,1,1,2,24,-2,-2,-1,-1,0,0,14709,8158,3529,11050,15811,14774,9326,3538,11050,5313,516,6202,0,5383,4620,-7521,5737,15295,8572,0.04485833333333333,0.0385,-0.062675,0.047808333333333335,0.12745833333333334,0.07143333333333333,-6
5585,280000,1,2,2,38,0,0,0,0,0,0,94451,96041,98301,74624,75173,77419,4000,4033,3000,3300,3500,6259,0,90451,92008,95301,71324,71673,71160,0.3230392857142857,0.3286,0.3403607142857143,0.2547285714285714,0.255975,0.25414285714285717,0
5586,100000,0,3,2,33,1,-2,-1,2,-1,0,0,0,1991,1991,93536,95373,0,1991,0,93536,3500,8000,0,0,-1991,1991,-91545,90036,87373,0.0,-0.01991,0.01991,-0.91545,0.90036,0.87373,-1
5587,30000,0,2,2,24,0,0,0,-1,-1,2,25063,22275,0,517,25420,24863,1545,0,1517,25420,0,980,0,23518,22275,-1517,-24903,25420,23883,0.7839333333333334,0.7425,-0.05056666666666667,-0.8301,0.8473333333333334,0.7961,0
5588,380000,1,2,1,36,0,0,0,0,0,0,52956,63002,71599,80377,84113,86612,25000,11000,10000,5000,7000,11000,1,27956,52002,61599,75377,77113,75612,0.07356842105263157,0.13684736842105263,0.16210263157894736,0.1983605263157895,0.20292894736842104,0.19897894736842106,0
5589,50000,0,2,1,45,-1,-1,-1,-1,-1,-1,942,942,942,390,390,390,942,942,390,390,390,0,1,0,0,552,0,0,390,0.0,0.0,0.01104,0.0,0.0,0.0078,-6
5590,70000,1,2,1,29,0,0,0,0,0,-2,11502,11009,13997,6832,0,0,2000,4037,2000,0,0,0,1,9502,6972,11997,6832,0,0,0.13574285714285714,0.0996,0.17138571428571428,0.0976,0.0,0.0,-2
5591,100000,1,3,2,48,-2,-2,-2,-2,-2,-2,2422,894,0,0,1639,923,894,0,0,1639,923,0,0,1528,894,0,-1639,716,923,0.01528,0.00894,0.0,-0.01639,0.00716,0.00923,-12
5592,400000,1,1,2,30,0,0,0,0,0,0,153655,156309,137701,191514,121092,166173,26876,10134,85450,10140,88097,10086,0,126779,146175,52251,181374,32995,156087,0.3169475,0.3654375,0.1306275,0.453435,0.0824875,0.3902175,0
5593,140000,1,2,1,35,1,2,0,0,2,2,130215,126720,128116,136956,134665,142199,0,5000,11000,0,10000,0,1,130215,121720,117116,136956,124665,142199,0.9301071428571429,0.8694285714285714,0.8365428571428571,0.9782571428571428,0.8904642857142857,1.015707142857143,7
5594,150000,1,2,1,32,1,-1,0,0,0,0,-1474,137049,145900,146168,149712,-288,140916,10000,3119,3744,0,57916,1,-142390,127049,142781,142424,149712,-58204,-0.9492666666666667,0.8469933333333334,0.9518733333333333,0.9494933333333333,0.99808,-0.3880266666666667,0
5595,70000,1,1,2,29,0,0,0,0,0,0,75040,75705,69514,69312,69412,68692,3000,3000,3100,3000,3000,2700,0,72040,72705,66414,66312,66412,65992,1.0291428571428571,1.0386428571428572,0.9487714285714286,0.9473142857142857,0.9487428571428571,0.9427428571428571,0
5596,320000,1,1,1,35,-1,2,-1,-1,-1,-1,6793,3659,232702,3529,14212,1166,5,232702,3529,14212,1200,8200,1,6788,-229043,229173,-10683,13012,-7034,0.0212125,-0.715759375,0.716165625,-0.033384375,0.0406625,-0.02198125,-3
5597,80000,1,2,2,35,0,0,0,0,0,0,28590,27635,26808,27680,26658,27324,1500,1600,3400,1300,3000,2000,0,27090,26035,23408,26380,23658,25324,0.338625,0.3254375,0.2926,0.32975,0.295725,0.31655,0
5598,70000,1,1,2,22,3,2,2,0,0,0,71501,71769,68530,29959,29315,28805,1966,49,1168,1032,1200,1200,0,69535,71720,67362,28927,28115,27605,0.9933571428571428,1.0245714285714285,0.9623142857142857,0.41324285714285713,0.40164285714285713,0.39435714285714285,7
5599,70000,0,2,2,24,1,2,0,0,0,2,32536,26351,45870,46918,53153,52174,0,20000,1807,7042,0,1925,0,32536,6351,44063,39876,53153,50249,0.4648,0.09072857142857142,0.6294714285714286,0.5696571428571429,0.7593285714285715,0.7178428571428571,5
5600,120000,1,3,1,52,0,0,0,0,0,0,117029,118439,118437,116456,116957,119366,5800,4500,4120,4388,4500,4350,1,111229,113939,114317,112068,112457,115016,0.9269083333333333,0.9494916666666666,0.9526416666666667,0.9339,0.9371416666666667,0.9584666666666667,0
5601,130000,1,1,2,27,1,-2,-1,0,0,0,-24,-350,30656,29426,29100,-1410,326,32100,0,0,0,0,0,-350,-32450,30656,29426,29100,-1410,-0.002692307692307692,-0.24961538461538463,0.23581538461538462,0.22635384615384616,0.22384615384615383,-0.010846153846153846,-2
5602,20000,0,2,2,25,4,5,4,3,2,0,20014,19432,18840,18248,17816,18021,0,0,0,0,636,1200,0,20014,19432,18840,18248,17180,16821,1.0007,0.9716,0.942,0.9124,0.859,0.84105,18
5603,300000,1,1,1,54,-1,-1,-1,-1,-1,-1,1080,-18,4190,2539,2590,5440,0,4208,2539,2590,5440,5646,1,1080,-4226,1651,-51,-2850,-206,0.0036,-0.014086666666666667,0.005503333333333333,-0.00017,-0.0095,-0.0006866666666666667,-6
5604,120000,0,2,1,30,1,2,2,2,0,0,80226,81812,82922,80989,82761,84766,3500,3000,0,3120,3500,3100,1,76726,78812,82922,77869,79261,81666,0.6393833333333333,0.6567666666666667,0.6910166666666666,0.6489083333333333,0.6605083333333334,0.68055,7
5605,50000,0,2,3,53,0,0,0,0,0,0,34664,17242,18417,18877,18985,18184,1500,1500,1000,800,2000,1000,0,33164,15742,17417,18077,16985,17184,0.66328,0.31484,0.34834,0.36154,0.3397,0.34368,0
5606,80000,1,2,2,27,0,0,0,0,2,2,72991,75134,76083,81183,79906,75294,3320,2800,6400,2870,0,3150,0,69671,72334,69683,78313,79906,72144,0.8708875,0.904175,0.8710375,0.9789125,0.998825,0.9018,4
5607,520000,1,1,1,37,-2,-2,-2,-2,-2,-2,4439,3487,7491,2310,12000,0,3913,7494,2310,12000,0,0,1,526,-4007,5181,-9690,12000,0,0.0010115384615384615,-0.0077057692307692304,0.009963461538461539,-0.018634615384615385,0.023076923076923078,0.0,-12
5608,70000,0,3,1,45,2,0,0,0,0,0,67505,61595,46920,47184,48058,48888,2600,2056,1700,2000,2000,2000,1,64905,59539,45220,45184,46058,46888,0.9272142857142858,0.8505571428571429,0.646,0.6454857142857143,0.6579714285714285,0.6698285714285714,2
5609,130000,1,2,1,34,0,0,0,0,0,0,99891,101032,104705,105478,107725,109994,3700,5300,4000,4000,4000,6100,1,96191,95732,100705,101478,103725,103894,0.7399307692307693,0.7364,0.7746538461538461,0.7806,0.7978846153846154,0.7991846153846154,0
5610,150000,0,3,2,32,-1,-1,-1,-1,-1,-1,1437,162,116,162,530,367,162,116,162,530,367,111,0,1275,46,-46,-368,163,256,0.0085,0.0003066666666666667,-0.0003066666666666667,-0.0024533333333333334,0.0010866666666666668,0.0017066666666666667,-6
5611,100000,1,1,2,25,1,-1,-1,-1,-1,-2,0,3473,0,1012,0,0,3473,0,1012,0,0,0,0,-3473,3473,-1012,1012,0,0,-0.03473,0.03473,-0.01012,0.01012,0.0,0.0,-5
5612,220000,0,1,2,31,0,0,0,0,-1,0,5254,5868,8708,4078,5365,4055,5000,3040,3520,5371,20,0,0,254,2828,5188,-1293,5345,4055,0.0011545454545454545,0.012854545454545455,0.023581818181818183,-0.0058772727272727275,0.024295454545454547,0.01843181818181818,-1
5613,50000,1,2,2,22,0,0,0,0,0,2,45675,41712,29756,32418,34983,18175,3630,2000,3500,2713,0,193,0,42045,39712,26256,29705,34983,17982,0.8409,0.79424,0.52512,0.5941,0.69966,0.35964,2
5614,50000,1,3,1,35,1,-2,-2,-2,-2,-2,0,0,0,0,0,0,0,0,0,0,0,0,1,0,0,0,0,0,0,0.0,0.0,0.0,0.0,0.0,0.0,-9
5615,50000,1,1,2,24,0,0,0,0,0,0,35084,35796,30937,19420,10385,1308,2090,2002,1002,238,1011,389,0,32994,33794,29935,19182,9374,919,0.65988,0.67588,0.5987,0.38364,0.18748,0.01838,0
5616,10000,0,2,2,38,0,0,0,0,0,0,7955,7976,8985,9164,9356,9593,1140,1149,328,340,393,192,0,6815,6827,8657,8824,8963,9401,0.6815,0.6827,0.8657,0.8824,0.8963,0.9401,0
5617,230000,1,3,1,37,0,0,0,0,0,0,228342,189966,142377,143828,143698,143342,6100,7000,5356,5400,5200,5500,1,222242,182966,137021,138428,138498,137842,0.9662695652173913,0.7955043478260869,0.5957434782608696,0.6018608695652173,0.6021652173913044,0.5993130434782609,0
5618,210000,1,1,1,44,0,0,0,0,0,0,112817,113349,113725,113779,114594,103205,5000,6000,5000,4000,4000,3500,1,107817,107349,108725,109779,110594,99705,0.5134142857142857,0.5111857142857142,0.5177380952380952,0.5227571428571428,0.5266380952380952,0.4747857142857143,0
5619,110000,1,2,2,25,1,2,2,0,0,0,104871,107422,101930,102111,101521,100240,8000,0,4000,4000,3600,3500,0,96871,107422,97930,98111,97921,96740,0.8806454545454545,0.9765636363636364,0.8902727272727273,0.8919181818181818,0.8901909090909091,0.8794545454545455,5
5620,90000,1,1,2,26,0,0,0,0,0,0,17704,14478,17681,15240,19364,18828,5005,5145,1801,5024,8007,5046,0,12699,9333,15880,10216,11357,13782,0.1411,0.1037,0.17644444444444443,0.1135111111111111,0.12618888888888888,0.15313333333333334,0
5621,500000,1,3,2,49,0,0,0,0,0,0,207406,207479,211508,223660,228014,223940,15000,10000,23660,20000,13940,26542,0,192406,197479,187848,203660,214074,197398,0.384812,0.394958,0.375696,0.40732,0.428148,0.394796,0
5622,160000,1,1,2,42,-1,-1,-2,-2,-2,-2,4980,0,0,0,0,0,0,0,0,0,0,0,0,4980,0,0,0,0,0,0.031125,0.0,0.0,0.0,0.0,0.0,-10
5623,500000,1,1,1,40,-2,-2,-2,-2,-2,-2,2121,0,0,0,0,522,0,0,0,0,522,117,1,2121,0,0,0,-522,405,0.004242,0.0,0.0,0.0,-0.001044,0.00081,-12
5624,500000,1,1,2,28,0,0,2,0,0,0,390393,374105,467911,355531,587067,323821,26085,13566,18975,11096,35204,10121,0,364308,360539,448936,344435,551863,313700,0.728616,0.721078,0.897872,0.68887,1.103726,0.6274,2
5625,60000,1,2,1,33,0,0,0,0,0,0,56379,23161,21106,22345,25720,23467,3000,1386,1625,4000,3000,3000,1,53379,21775,19481,18345,22720,20467,0.88965,0.36291666666666667,0.3246833333333333,0.30575,0.37866666666666665,0.3411166666666667,0
5626,180000,0,2,1,46,-2,-2,-2,-2,-2,-2,390,3182,780,0,0,0,3182,780,0,0,0,0,1,-2792,2402,780,0,0,0,-0.015511111111111111,0.013344444444444445,0.004333333333333333,0.0,0.0,0.0,-12
5627,20000,1,1,2,28,0,0,0,-2,-2,-2,12031,13446,0,0,0,0,5000,0,0,0,0,612,0,7031,13446,0,0,0,-612,0.35155,0.6723,0.0,0.0,0.0,-0.0306,-6
5628,250000,1,2,1,26,1,3,2,2,2,0,631,631,631,1231,1068,6816,0,0,600,0,6000,5000,1,631,631,31,1231,-4932,1816,0.002524,0.002524,0.000124,0.004924,-0.019728,0.007264,10
5629,50000,1,1,2,24,-2,-2,-2,-2,-2,-2,780,0,580,-200,300,0,0,580,0,500,0,0,0,780,-580,580,-700,300,0,0.0156,-0.0116,0.0116,-0.014,0.006,0.0,-12
5630,150000,0,2,1,39,2,2,0,0,0,2,117485,114166,116491,118839,126102,123914,0,4225,4282,9207,0,4679,1,117485,109941,112209,109632,126102,119235,0.7832333333333333,0.73294,0.74806,0.73088,0.84068,0.7949,6
5631,50000,0,1,3,25,1,-1,2,-1,0,-1,6300,3395,3180,1831,1868,3300,9195,0,1831,37,3300,289,0,-2895,3395,1349,1794,-1432,3011,-0.0579,0.0679,0.02698,0.03588,-0.02864,0.06022,0
5632,360000,1,1,2,27,0,0,0,0,0,0,130640,120058,110795,101668,78730,66682,4500,4100,4208,3000,2300,1800,0,126140,115958,106587,98668,76430,64882,0.3503888888888889,0.32210555555555553,0.296075,0.27407777777777775,0.21230555555555555,0.18022777777777776,0
5633,110000,0,2,1,35,0,0,0,0,0,0,48131,73221,74341,50184,51412,49448,32123,3000,1800,2041,2069,3000,1,16008,70221,72541,48143,49343,46448,0.14552727272727273,0.6383727272727273,0.6594636363636364,0.43766363636363637,0.4485727272727273,0.42225454545454544,0
5634,290000,1,2,1,37,0,0,0,0,0,0,277449,271080,280510,198869,222558,134187,52000,40504,20000,30003,15004,4012,1,225449,230576,260510,168866,207554,130175,0.7774103448275862,0.7950896551724138,0.8983103448275862,0.582296551724138,0.7157034482758621,0.4488793103448276,0
5635,300000,1,1,2,29,-2,-2,-2,-2,-2,-2,1049,205,4962,13634,41510,-1087,205,4962,13634,41510,0,3940,0,844,-4757,-8672,-27876,41510,-5027,0.0028133333333333335,-0.015856666666666668,-0.028906666666666667,-0.09292,0.13836666666666667,-0.016756666666666666,-12
5636,200000,0,1,2,28,-1,-1,-1,-1,-1,-1,5838,2256,9552,4215,3400,3286,2256,9588,5135,3487,3295,7791,0,3582,-7332,4417,728,105,-4505,0.01791,-0.03666,0.022085,0.00364,0.000525,-0.022525,-6
5637,100000,1,3,2,27,0,0,0,0,0,0,89312,141034,61119,58535,54224,51204,3000,2208,2700,2000,1844,1709,0,86312,138826,58419,56535,52380,49495,0.86312,1.38826,0.58419,0.56535,0.5238,0.49495,0
5638,60000,1,2,1,53,-1,-1,-1,-1,-1,-1,390,390,390,390,540,390,390,390,390,540,390,390,1,0,0,0,-150,150,0,0.0,0.0,0.0,-0.0025,0.0025,0.0,-6
5639,100000,1,3,2,39,-1,-1,-1,-1,-1,-1,1130,600,0,660,2030,3170,600,0,660,2030,3170,1152,0,530,600,-660,-1370,-1140,2018,0.0053,0.006,-0.0066,-0.0137,-0.0114,0.02018,-6
5640,50000,1,2,2,28,0,0,0,0,0,0,28457,29491,30508,31599,32262,32904,1492,1509,1600,1170,1177,1217,0,26965,27982,28908,30429,31085,31687,0.5393,0.55964,0.57816,0.60858,0.6217,0.63374,0
5641,180000,0,2,1,46,0,0,0,0,0,0,60005,41223,49108,50016,45956,52926,3000,10000,3000,5000,15000,0,1,57005,31223,46108,45016,30956,52926,0.31669444444444445,0.17346111111111112,0.2561555555555556,0.2500888888888889,0.17197777777777778,0.2940333333333333,0
5642,350000,1,1,2,32,-1,-1,-1,-1,-1,0,11942,3236,7241,6800,5163,942,3252,7289,8495,5184,1,2,0,8690,-4053,-1254,1616,5162,940,0.02482857142857143,-0.01158,-0.003582857142857143,0.004617142857142857,0.014748571428571429,0.0026857142857142856,-5
5643,40000,1,3,1,43,-1,-1,-1,2,0,0,780,177,1583,1020,630,240,177,1583,0,0,0,1080,1,603,-1406,1583,1020,630,-840,0.015075,-0.03515,0.039575,0.0255,0.01575,-0.021,-1
5644,200000,1,2,2,43,0,0,0,0,0,0,180680,184436,188181,190775,196449,192085,8155,8302,7225,10153,6987,5262,0,172525,176134,180956,180622,189462,186823,0.862625,0.88067,0.90478,0.90311,0.94731,0.934115,0
5645,200000,1,2,1,27,1,3,2,2,2,2,183994,182427,182657,174547,181454,177141,5200,7000,0,13300,0,6200,1,178794,175427,182657,161247,181454,170941,0.89397,0.877135,0.913285,0.806235,0.90727,0.854705,12
5646,110000,1,2,1,25,-1,4,3,2,3,2,96343,93959,91624,96190,95233,97760,0,0,7000,1500,4200,3500,1,96343,93959,84624,94690,91033,94260,0.8758454545454546,0.8541727272727273,0.7693090909090909,0.8608181818181818,0.8275727272727272,0.856909090909091,13
5647,50000,1,3,1,47,2,0,0,0,0,0,46666,47606,48350,48786,49277,50151,2100,2200,2000,2000,1755,1804,1,44566,45406,46350,46786,47522,48347,0.89132,0.90812,0.927,0.93572,0.95044,0.96694,2
5648,390000,1,1,1,41,0,0,2,0,0,-2,48378,52279,51176,52286,0,0,4705,0,2712,0,0,0,1,43673,52279,48464,52286,0,0,0.11198205128205128,0.13404871794871795,0.12426666666666666,0.13406666666666667,0.0,0.0,0
5649,80000,0,1,1,33,0,0,0,0,0,0,75593,71643,49481,38427,34683,159,2503,1508,1500,1600,279,0,1,73090,70135,47981,36827,34404,159,0.913625,0.8766875,0.5997625,0.4603375,0.43005,0.0019875,0
5650,20000,1,3,2,46,1,2,0,0,0,0,18505,17898,18067,18917,18717,17144,0,1800,1600,400,0,0,0,18505,16098,16467,18517,18717,17144,0.92525,0.8049,0.82335,0.92585,0.93585,0.8572,3
5651,50000,1,2,1,25,0,0,0,-1,-1,-1,9587,6583,3243,1691,-1889,2720,1200,1000,1700,0,5679,1600,1,8387,5583,1543,1691,-7568,1120,0.16774,0.11166,0.03086,0.03382,-0.15136,0.0224,-3
5652,50000,1,3,1,29,0,0,0,0,0,0,46375,47479,49002,39422,15349,15078,1876,2399,1819,472,477,472,1,44499,45080,47183,38950,14872,14606,0.88998,0.9016,0.94366,0.779,0.29744,0.29212,0
5653,350000,1,2,1,49,-2,-2,-2,-2,-2,-2,16173,9122,12228,19850,8800,4260,9122,12228,19850,8800,4260,17660,1,7051,-3106,-7622,11050,4540,-13400,0.020145714285714284,-0.008874285714285715,-0.021777142857142856,0.03157142857142857,0.012971428571428571,-0.038285714285714284,-12
5654,100000,1,2,1,33,0,0,0,0,0,0,92189,88832,89762,77986,71031,66983,3252,3215,2792,1881,1945,2184,1,88937,85617,86970,76105,69086,64799,0.88937,0.85617,0.8697,0.76105,0.69086,0.64799,0
5655,130000,1,2,2,27,1,-1,-1,0,0,0,-191,191,2898,4728,5149,5561,382,2898,1900,500,500,1000,0,-573,-2707,998,4228,4649,4561,-0.004407692307692308,-0.020823076923076923,0.007676923076923077,0.032523076923076925,0.03576153846153846,0.03508461538461539,-1
5656,20000,0,2,2,24,0,0,0,0,0,0,6814,7670,8690,9699,10138,10400,1132,1152,1161,600,600,0,0,5682,6518,7529,9099,9538,10400,0.2841,0.3259,0.37645,0.45495,0.4769,0.52,0
5657,200000,1,1,1,39,-1,-1,-1,-1,0,0,11399,395,5094,9204,9403,4602,400,9500,9250,5000,0,5000,1,10999,-9105,-4156,4204,9403,-398,0.054995,-0.045525,-0.02078,0.02102,0.047015,-0.00199,-4
5658,260000,1,2,1,30,0,0,0,0,0,0,66433,67134,67768,69033,70166,71377,2400,2496,2429,2599,2827,2050,1,64033,64638,65339,66434,67339,69327,0.24628076923076922,0.2486076923076923,0.25130384615384616,0.2555153846153846,0.2589961538461538,0.2666423076923077,0
5659,70000,1,3,1,30,2,2,2,2,2,2,55352,56448,57550,58008,58957,60367,2600,2600,2000,2500,2500,2400,1,52752,53848,55550,55508,56457,57967,0.7536,0.7692571428571429,0.7935714285714286,0.7929714285714285,0.8065285714285715,0.8281,12
5660,270000,1,2,1,42,1,-2,-2,-2,-2,-2,-330,-330,-330,-330,-330,-330,0,0,0,0,0,0,1,-330,-330,-330,-330,-330,-330,-0.0012222222222222222,-0.0012222222222222222,-0.0012222222222222222,-0.0012222222222222222,-0.0012222222222222222,-0.0012222222222222222,-9
5661,250000,1,1,2,34,2,0,0,0,0,0,212681,193296,194659,196481,196256,195370,9917,7350,7231,6603,6797,7557,0,202764,185946,187428,189878,189459,187813,0.811056,0.743784,0.749712,0.759512,0.757836,0.751252,2
5662,20000,0,2,2,25,0,0,0,0,0,0,18193,18804,19324,18692,16035,12262,1800,1200,559,532,424,620,0,16393,17604,18765,18160,15611,11642,0.81965,0.8802,0.93825,0.908,0.78055,0.5821,0
5663,50000,0,2,2,37,0,0,0,0,0,0,50701,50462,50218,20141,20072,19493,2202,2083,697,711,717,674,0,48499,48379,49521,19430,19355,18819,0.96998,0.96758,0.99042,0.3886,0.3871,0.37638,0
5664,210000,0,1,1,40,0,0,2,0,0,2,130868,138909,135322,136339,143681,140425,11760,0,4546,9524,2,4756,1,119108,138909,130776,126815,143679,135669,0.5671809523809523,0.6614714285714286,0.6227428571428572,0.6038809523809524,0.6841857142857143,0.6460428571428571,4
5665,390000,1,3,1,53,-1,-1,-1,-1,-1,0,2820,513,55120,2011,380,380,513,55120,2011,380,0,0,1,2307,-54607,53109,1631,380,380,0.005915384615384616,-0.14001794871794873,0.13617692307692308,0.004182051282051282,0.0009743589743589744,0.0009743589743589744,-5
5666,420000,0,1,1,43,-2,-2,-2,-2,-2,-2,8100,14270,7324,2846,3027,5946,14274,8232,2853,3027,5946,32053,1,-6174,6038,4471,-181,-2919,-26107,-0.0147,0.014376190476190476,0.010645238095238095,-0.00043095238095238093,-0.00695,-0.06215952380952381,-12
5667,260000,0,2,2,32,1,-2,-2,-2,-1,-1,3581,-9,-9,1935,999,0,0,0,1944,999,0,0,0,3581,-9,-1953,936,999,0,0.013773076923076923,-3.461538461538462e-05,-0.007511538461538462,0.0036,0.003842307692307692,0.0,-7
5668,20000,0,1,2,25,0,0,0,0,0,0,15848,16883,17839,18040,18414,16213,1595,1551,752,773,772,354,0,14253,15332,17087,17267,17642,15859,0.71265,0.7666,0.85435,0.86335,0.8821,0.79295,0
5669,300000,1,1,1,29,0,0,0,0,0,0,64437,65905,67344,69268,70647,73044,2000,2000,2500,2100,3000,2000,1,62437,63905,64844,67168,67647,71044,0.20812333333333333,0.21301666666666666,0.21614666666666665,0.22389333333333333,0.22549,0.23681333333333332,0
5670,260000,1,1,2,26,0,0,0,0,0,0,238110,244368,245186,254614,176211,180845,10368,15186,14614,7211,7850,6912,0,227742,229182,230572,247403,168361,173933,0.8759307692307692,0.8814692307692308,0.8868153846153846,0.95155,0.6475423076923077,0.668973076923077,0
5671,50000,1,2,1,42,0,0,0,0,0,0,27901,24898,23702,18327,17996,15938,1770,1194,564,1500,1000,2000,1,26131,23704,23138,16827,16996,13938,0.52262,0.47408,0.46276,0.33654,0.33992,0.27876,0
5672,360000,1,1,2,31,3,2,2,2,2,2,2500,2500,2500,2500,2500,2500,0,0,0,0,0,0,0,2500,2500,2500,2500,2500,2500,0.006944444444444444,0.006944444444444444,0.006944444444444444,0.006944444444444444,0.006944444444444444,0.006944444444444444,13
5673,260000,1,1,1,44,-1,-1,-1,-1,-1,-2,2772,6675,-3098,11377,0,0,6675,20,50000,0,0,0,1,-3903,6655,-53098,11377,0,0,-0.015011538461538462,0.025596153846153845,-0.20422307692307692,0.04375769230769231,0.0,0.0,-7
5674,80000,1,3,2,30,2,0,0,2,2,2,71165,72123,76696,79659,80079,79657,2700,5800,4800,1800,1000,2800,0,68465,66323,71896,77859,79079,76857,0.8558125,0.8290375,0.8987,0.9732375,0.9884875,0.9607125,8
5675,260000,0,3,1,48,0,0,0,0,-1,0,200716,203751,205530,-170000,171696,174151,8812,9158,0,497000,10000,7000,1,191904,194593,205530,-667000,161696,167151,0.7380923076923077,0.7484346153846154,0.7905,-2.5653846153846156,0.6219076923076923,0.6428884615384616,-1
5676,100000,1,2,1,46,1,-1,-1,-1,-2,-2,0,766,305,0,0,0,766,305,0,0,0,0,1,-766,461,305,0,0,0,-0.00766,0.00461,0.00305,0.0,0.0,0.0,-6
5677,50000,0,2,2,23,0,0,0,0,0,0,49283,48570,49362,47907,18145,17495,1781,3264,1400,3000,350,133,0,47502,45306,47962,44907,17795,17362,0.95004,0.90612,0.95924,0.89814,0.3559,0.34724,0
5678,310000,1,2,2,36,0,0,0,0,0,0,298221,303251,270591,252989,225814,231165,10500,9672,8826,8100,9000,8619,0,287721,293579,261765,244889,216814,222546,0.9281322580645162,0.9470290322580646,0.8444032258064517,0.7899645161290323,0.6994,0.7178903225806451,0
5679,20000,0,2,2,27,0,-1,0,-1,-1,-2,1955,2530,1845,3169,240,930,2535,1205,3274,630,1080,0,0,-580,1325,-1429,2539,-840,930,-0.029,0.06625,-0.07145,0.12695,-0.042,0.0465,-5
5680,130000,1,1,1,33,-1,2,0,0,0,-1,10653,7439,15206,12446,7047,5472,13,12454,30,21,5488,1725,1,10640,-5015,15176,12425,1559,3747,0.08184615384615385,-0.03857692307692308,0.11673846153846154,0.09557692307692307,0.011992307692307693,0.028823076923076923,0
5681,420000,1,2,1,37,-2,-2,-2,-2,-2,-2,4904,5248,5344,5058,2019,2443,5332,5348,5065,2019,2443,4697,1,-428,-100,279,3039,-424,-2254,-0.001019047619047619,-0.0002380952380952381,0.0006642857142857143,0.007235714285714285,-0.0010095238095238095,-0.005366666666666666,-12
5682,30000,1,2,2,22,2,0,0,0,0,0,30324,30123,30299,27758,22720,19136,1900,1600,2000,2000,614,924,0,28424,28523,28299,25758,22106,18212,0.9474666666666667,0.9507666666666666,0.9433,0.8586,0.7368666666666667,0.6070666666666666,2
5683,200000,0,2,2,29,-1,0,0,2,0,0,10538,16201,20926,20260,24754,29383,6201,5000,0,5000,5054,5054,0,4337,11201,20926,15260,19700,24329,0.021685,0.056005,0.10463,0.0763,0.0985,0.121645,1
5684,180000,1,2,1,32,-1,2,-1,0,-1,-1,1991,991,7658,1000,1650,1000,0,7667,0,1650,1000,2000,1,1991,-6676,7658,-650,650,-1000,0.011061111111111112,-0.037088888888888887,0.04254444444444445,-0.003611111111111111,0.003611111111111111,-0.005555555555555556,-2
5685,150000,1,1,1,33,2,2,2,2,2,2,105610,106885,108706,105470,111687,113747,4500,5000,0,8000,4000,4700,1,101110,101885,108706,97470,107687,109047,0.6740666666666667,0.6792333333333334,0.7247066666666667,0.6498,0.7179133333333333,0.72698,12
5686,190000,1,2,1,34,0,0,2,2,2,0,86730,93705,91317,96079,94428,100618,9310,0,7200,0,8000,4000,1,77420,93705,84117,96079,86428,96618,0.4074736842105263,0.4931842105263158,0.44272105263157896,0.505678947368421,0.4548842105263158,0.5085157894736843,6
5687,160000,0,2,2,45,0,0,0,0,0,0,131895,132154,129237,90981,92580,77184,5336,4900,2807,2898,2713,2885,0,126559,127254,126430,88083,89867,74299,0.79099375,0.7953375,0.7901875,0.55051875,0.56166875,0.46436875,0
5688,440000,0,1,1,37,-1,-1,-1,-1,-1,-1,4330,8369,16786,396,600,3596,8369,16786,396,600,3596,4095,1,-4039,-8417,16390,-204,-2996,-499,-0.009179545454545454,-0.019129545454545455,0.03725,-0.00046363636363636366,-0.006809090909090909,-0.001134090909090909,-6
5689,90000,1,2,1,49,0,0,0,0,0,0,91263,70251,45385,46331,47494,48433,3100,1800,1700,2000,1746,1941,1,88163,68451,43685,44331,45748,46492,0.9795888888888888,0.7605666666666666,0.48538888888888887,0.49256666666666665,0.5083111111111112,0.5165777777777778,0
5690,500000,1,1,2,29,0,0,0,0,0,0,36051,30912,33740,15272,17015,18740,2065,25099,2000,2000,2000,2000,0,33986,5813,31740,13272,15015,16740,0.067972,0.011626,0.06348,0.026544,0.03003,0.03348,0
5691,190000,0,3,1,64,0,0,0,2,0,0,65666,67379,72878,70731,71285,72403,3800,7600,0,2700,2800,2800,1,61866,59779,72878,68031,68485,69603,0.32561052631578946,0.3146263157894737,0.38356842105263156,0.35805789473684213,0.3604473684210526,0.3663315789473684,2
5692,130000,1,1,1,40,-1,-1,-1,-1,-1,-1,989,989,989,989,990,702,991,991,991,992,703,992,1,-2,-2,-2,-3,287,-290,-1.5384615384615384e-05,-1.5384615384615384e-05,-1.5384615384615384e-05,-2.3076923076923076e-05,0.0022076923076923076,-0.0022307692307692306,-6
5693,80000,1,2,2,31,0,0,0,-1,-1,-1,28788,27620,26352,939,2202,1369,8000,1000,939,2202,1369,4827,0,20788,26620,25413,-1263,833,-3458,0.25985,0.33275,0.3176625,-0.0157875,0.0104125,-0.043225,-3
5694,360000,0,1,2,32,0,0,0,0,-1,-1,304907,309972,315730,113412,2500,0,12557,13738,5053,2500,0,0,0,292350,296234,310677,110912,2500,0,0.8120833333333334,0.8228722222222222,0.8629916666666667,0.3080888888888889,0.006944444444444444,0.0,-2
5695,300000,0,1,1,34,0,0,0,0,0,0,66176,68108,70306,99217,142188,145013,3000,3500,30049,50000,5200,5000,1,63176,64608,40257,49217,136988,140013,0.21058666666666667,0.21536,0.13419,0.16405666666666666,0.4566266666666667,0.46671,0
5696,30000,0,3,3,52,1,2,2,3,2,2,23819,23144,28066,27321,27571,29300,0,5637,0,1000,2332,0,0,23819,17507,28066,26321,25239,29300,0.7939666666666667,0.5835666666666667,0.9355333333333333,0.8773666666666666,0.8413,0.9766666666666667,12
5697,120000,1,1,2,34,1,-2,-2,-2,-2,-2,0,0,0,0,0,0,0,0,0,0,0,0,0,0,0,0,0,0,0,0.0,0.0,0.0,0.0,0.0,0.0,-9
5698,160000,1,1,2,30,0,0,0,0,0,0,78623,65315,52890,50275,51337,53349,3000,4000,2500,2500,3000,2800,0,75623,61315,50390,47775,48337,50549,0.47264375,0.38321875,0.3149375,0.29859375,0.30210625,0.31593125,0
5699,50000,1,2,2,36,0,0,2,0,0,0,23368,27050,27086,28525,30895,33003,4400,761,2200,2862,2770,2200,0,18968,26289,24886,25663,28125,30803,0.37936,0.52578,0.49772,0.51326,0.5625,0.61606,2
5700,80000,1,2,2,22,0,0,0,0,0,0,80491,64868,51936,30165,30145,30085,2327,1687,1052,1076,1121,1237,0,78164,63181,50884,29089,29024,28848,0.97705,0.7897625,0.63605,0.3636125,0.3628,0.3606,0
5701,290000,1,3,2,29,0,0,0,0,0,0,279804,279377,283202,283401,285291,287510,10000,11000,10000,10000,11000,11000,0,269804,268377,273202,273401,274291,276510,0.9303586206896551,0.9254379310344828,0.9420758620689655,0.9427620689655173,0.9458310344827586,0.9534827586206897,0
5702,120000,0,2,2,34,-1,-1,-1,-1,-1,-1,856,856,856,856,856,856,856,856,856,856,856,2664,0,0,0,0,0,0,-1808,0.0,0.0,0.0,0.0,0.0,-0.015066666666666667,-6
5703,130000,1,2,1,28,0,0,0,0,0,0,123943,126857,127706,121939,81506,83234,6500,6600,6000,3100,3200,3300,1,117443,120257,121706,118839,78306,79934,0.9034076923076924,0.9250538461538461,0.9362,0.9141461538461538,0.6023538461538461,0.6148769230769231,0
5704,100000,1,2,2,24,3,2,2,2,2,2,81601,79689,85389,83121,88304,90746,0,7000,0,6600,4000,3200,0,81601,72689,85389,76521,84304,87546,0.81601,0.72689,0.85389,0.76521,0.84304,0.87546,13
5705,70000,1,2,2,23,0,0,0,0,0,0,65026,29549,29705,29012,28355,16579,4000,1595,775,1000,600,2000,0,61026,27954,28930,28012,27755,14579,0.8718,0.39934285714285717,0.4132857142857143,0.40017142857142857,0.3965,0.20827142857142858,0
5706,300000,1,2,1,36,0,0,0,0,0,0,141486,79474,80813,111116,13534,10379,6000,5000,30303,2011,856,1010,1,135486,74474,50510,109105,12678,9369,0.45162,0.24824666666666667,0.16836666666666666,0.36368333333333336,0.04226,0.03123,0
5707,60000,0,3,2,25,0,0,0,0,0,0,59817,47872,38605,28184,28862,29161,3000,2000,1500,1500,1300,2000,0,56817,45872,37105,26684,27562,27161,0.94695,0.7645333333333333,0.6184166666666666,0.4447333333333333,0.45936666666666665,0.4526833333333333,0
5708,230000,0,1,2,27,-1,-1,-1,-1,-1,-1,3257,1816,1816,1806,764,3368,1816,1816,1806,774,3368,1027,0,1441,0,10,1032,-2604,2341,0.0062652173913043474,0.0,4.347826086956522e-05,0.0044869565217391305,-0.011321739130434782,0.010178260869565218,-6
5709,310000,0,1,1,39,-1,-1,-2,-1,-1,2,360,0,91059,155,28100,4544,0,91059,155,28490,0,1041,1,360,-91059,90904,-28335,28100,3503,0.001161290322580645,-0.29373870967741933,0.29323870967741933,-0.09140322580645162,0.09064516129032259,0.0113,-4
5710,120000,1,1,1,34,1,-2,-1,-1,-1,0,0,0,1471,3094,12623,10446,0,1471,3103,12623,0,1446,1,0,-1471,-1632,-9529,12623,9000,0.0,-0.012258333333333333,-0.0136,-0.07940833333333333,0.10519166666666667,0.075,-4
5711,90000,0,2,2,27,0,0,2,2,2,2,20249,44731,43712,52966,51988,56117,25000,0,10000,0,5000,3150,0,-4751,44731,33712,52966,46988,52967,-0.05278888888888889,0.4970111111111111,0.3745777777777778,0.5885111111111111,0.5220888888888889,0.5885222222222222,8
5712,80000,1,3,1,39,0,0,0,0,0,0,83482,80406,71540,68325,65105,62011,2900,2340,2300,2289,2500,1551,1,80582,78066,69240,66036,62605,60460,1.007275,0.975825,0.8655,0.82545,0.7825625,0.75575,0
5713,20000,1,2,1,24,-1,-1,-2,-2,-2,-2,750,0,0,0,0,0,165,0,0,528,0,0,1,585,0,0,-528,0,0,0.02925,0.0,0.0,-0.0264,0.0,0.0,-10
5714,230000,1,2,2,32,1,2,0,0,-1,-1,73757,69748,23266,13565,80,0,0,1200,1027,80,0,0,0,73757,68548,22239,13485,80,0,0.3206826086956522,0.29803478260869565,0.0966913043478261,0.058630434782608695,0.00034782608695652176,0.0,1
5715,230000,1,2,1,43,0,0,0,0,0,0,7075,7806,8392,8967,8729,10816,1279,1295,1300,468,2816,5893,1,5796,6511,7092,8499,5913,4923,0.0252,0.028308695652173914,0.03083478260869565,0.03695217391304348,0.025708695652173912,0.021404347826086956,0
5716,300000,1,1,1,59,-1,-1,2,2,2,2,2500,2500,2500,2500,2500,2500,0,0,0,0,0,0,1,2500,2500,2500,2500,2500,2500,0.008333333333333333,0.008333333333333333,0.008333333333333333,0.008333333333333333,0.008333333333333333,0.008333333333333333,6
5717,150000,0,1,1,42,-1,-1,-1,-1,-1,-1,2716,0,1106,1323,2098,0,0,1106,1323,2098,0,0,1,2716,-1106,-217,-775,2098,0,0.018106666666666667,-0.007373333333333333,-0.0014466666666666666,-0.005166666666666667,0.013986666666666666,0.0,-6
5718,230000,1,2,1,38,-1,-1,-1,0,0,0,4549,0,24962,34372,32630,33334,0,24962,10000,943,1000,1058,1,4549,-24962,14962,33429,31630,32276,0.019778260869565217,-0.1085304347826087,0.06505217391304348,0.14534347826086957,0.13752173913043478,0.1403304347826087,-3
5719,60000,0,3,1,50,0,0,0,0,0,0,59703,59837,48187,42658,40587,40605,2047,2168,1642,1563,1600,1486,1,57656,57669,46545,41095,38987,39119,0.9609333333333333,0.96115,0.77575,0.6849166666666666,0.6497833333333334,0.6519833333333334,0
5720,90000,0,2,1,55,0,0,0,0,0,0,15019,19740,25382,27132,31675,37900,5000,6000,5000,5000,8000,2000,1,10019,13740,20382,22132,23675,35900,0.11132222222222223,0.15266666666666667,0.22646666666666668,0.2459111111111111,0.26305555555555554,0.3988888888888889,0
5721,360000,0,1,1,32,0,0,0,0,0,0,120533,124530,128518,134368,135626,134864,6000,6000,8000,4918,5000,3300,1,114533,118530,120518,129450,130626,131564,0.31814722222222225,0.32925,0.33477222222222225,0.3595833333333333,0.36285,0.36545555555555553,0
5722,80000,0,3,1,47,0,0,0,0,-1,0,78415,80093,74598,34712,40452,39762,3369,1688,694,44492,1455,1365,1,75046,78405,73904,-9780,38997,38397,0.938075,0.9800625,0.9238,-0.12225,0.4874625,0.4799625,-1
5723,100000,0,1,2,38,1,2,2,2,2,2,24796,27085,26352,33871,33192,35637,3000,0,8000,0,3000,0,0,21796,27085,18352,33871,30192,35637,0.21796,0.27085,0.18352,0.33871,0.30192,0.35637,11
5724,60000,1,2,2,24,1,2,3,3,2,2,44238,47076,48871,47669,48135,50056,4000,3000,0,1500,3000,2750,0,40238,44076,48871,46169,45135,47306,0.6706333333333333,0.7346,0.8145166666666667,0.7694833333333333,0.75225,0.7884333333333333,13
5725,30000,1,1,2,26,-1,-1,-1,-1,0,0,125,125,125,4671,25871,15222,125,125,4671,25000,3000,2256,0,0,0,-4546,-20329,22871,12966,0.0,0.0,-0.15153333333333333,-0.6776333333333333,0.7623666666666666,0.4322,-4
5726,70000,1,2,2,22,0,0,0,0,0,0,24817,27424,28406,29013,29625,30404,3018,1500,1000,1001,1191,1000,0,21799,25924,27406,28012,28434,29404,0.3114142857142857,0.37034285714285714,0.3915142857142857,0.40017142857142857,0.4062,0.42005714285714285,0
5727,230000,1,1,2,27,1,2,0,0,-1,-1,46628,45253,10507,6742,4387,1670,0,1000,135,4387,1670,2798,0,46628,44253,10372,2355,2717,-1128,0.2027304347826087,0.19240434782608695,0.045095652173913044,0.010239130434782608,0.011813043478260869,-0.0049043478260869565,1
5728,50000,1,2,2,51,0,0,0,0,0,0,50566,50050,37005,20145,19620,18872,1738,1746,1289,1684,684,702,0,48828,48304,35716,18461,18936,18170,0.97656,0.96608,0.71432,0.36922,0.37872,0.3634,0
5729,330000,0,3,2,48,1,-1,-1,-1,-1,-1,0,571,0,11942,300,-200,571,0,11942,300,0,0,0,-571,571,-11942,11642,300,-200,-0.0017303030303030304,0.0017303030303030304,-0.03618787878787879,0.03527878787878788,0.0009090909090909091,-0.0006060606060606061,-4
5730,20000,0,3,2,49,0,0,0,0,0,0,15237,16030,17948,18647,19193,19721,1600,2500,1000,846,1000,593,0,13637,13530,16948,17801,18193,19128,0.68185,0.6765,0.8474,0.89005,0.90965,0.9564,0
5731,330000,1,2,1,45,0,0,0,0,0,0,123813,127050,135631,138036,141330,144529,5100,10600,5000,5000,5000,5000,1,118713,116450,130631,133036,136330,139529,0.35973636363636363,0.3528787878787879,0.3958515151515152,0.40313939393939396,0.4131212121212121,0.42281515151515153,0
5732,180000,0,2,2,28,1,1,-2,-2,-2,-1,23638,-46,-46,-46,-46,1154,3000,0,0,0,1200,44338,0,20638,-46,-46,-46,-1246,-43184,0.11465555555555555,-0.0002555555555555556,-0.0002555555555555556,-0.0002555555555555556,-0.006922222222222222,-0.2399111111111111,-5
5733,260000,0,1,2,36,0,0,0,0,0,0,97626,99675,59934,61680,65403,66745,5195,2961,3000,5000,2700,2800,0,92431,96714,56934,56680,62703,63945,0.35550384615384617,0.3719769230769231,0.21897692307692307,0.218,0.24116538461538461,0.24594230769230768,0
5734,50000,0,2,1,49,1,2,2,0,0,0,50435,50936,49463,50046,19858,19278,2400,0,2300,1000,1000,1000,1,48035,50936,47163,49046,18858,18278,0.9607,1.01872,0.94326,0.98092,0.37716,0.36556,5
5735,140000,1,2,2,29,0,0,0,0,0,0,116597,55208,47397,45860,46264,41870,3018,3000,1356,2000,2000,1500,0,113579,52208,46041,43860,44264,40370,0.8112785714285714,0.3729142857142857,0.3288642857142857,0.3132857142857143,0.31617142857142855,0.28835714285714287,0
5736,20000,0,3,2,26,2,0,0,0,0,0,14081,15835,16985,19985,9421,9764,2000,2000,3000,1000,500,1000,0,12081,13835,13985,18985,8921,8764,0.60405,0.69175,0.69925,0.94925,0.44605,0.4382,2
5737,50000,0,3,2,40,0,0,0,0,2,2,55397,55877,57335,59595,55949,51225,2000,2356,3494,2000,0,1725,0,53397,53521,53841,57595,55949,49500,1.06794,1.07042,1.07682,1.1519,1.11898,0.99,4
5738,470000,1,1,2,30,-2,-1,-1,-2,-1,-1,1689,499,350,2277,41523,2175,499,350,2277,41523,2175,6351,0,1190,149,-1927,-39246,39348,-4176,0.0025319148936170212,0.0003170212765957447,-0.0041,-0.08350212765957447,0.08371914893617022,-0.008885106382978724,-8
5739,150000,0,2,1,40,0,0,0,0,0,-2,142326,145231,150145,150500,0,0,4500,6114,3500,0,0,0,1,137826,139117,146645,150500,0,0,0.91884,0.9274466666666666,0.9776333333333334,1.0033333333333334,0.0,0.0,-2
5740,200000,0,2,1,35,-1,-1,-1,-1,-1,0,8028,3729,-19,3920,4452,685,3747,0,3939,4470,3,1064,1,4281,3729,-3958,-550,4449,-379,0.021405,0.018645,-0.01979,-0.00275,0.022245,-0.001895,-5
5741,70000,1,2,2,22,0,0,0,0,0,0,57889,33868,33390,26457,27165,27562,1592,1497,947,1134,1000,1021,0,56297,32371,32443,25323,26165,26541,0.8042428571428571,0.46244285714285716,0.4634714285714286,0.36175714285714283,0.3737857142857143,0.37915714285714286,0
5742,100000,0,2,1,56,0,0,0,0,0,0,96392,87986,89230,90745,92774,101275,4424,3600,3000,3200,9800,0,1,91968,84386,86230,87545,82974,101275,0.91968,0.84386,0.8623,0.87545,0.82974,1.01275,0
5743,110000,1,2,2,29,2,0,0,0,0,0,113394,108142,109325,111264,56311,58271,5314,4398,4196,1857,8271,1948,0,108080,103744,105129,109407,48040,56323,0.9825454545454545,0.9431272727272727,0.9557181818181818,0.9946090909090909,0.43672727272727274,0.5120272727272728,2
5744,140000,0,3,1,37,-1,-1,-1,-1,-1,-1,13806,1003,1170,1003,1003,1003,1003,1170,1003,1003,1003,1003,1,12803,-167,167,0,0,0,0.09145,-0.0011928571428571429,0.0011928571428571429,0.0,0.0,0.0,-6
5745,130000,1,3,1,26,0,0,2,2,2,0,121329,128791,127881,133130,127159,131069,11000,2600,9000,0,6000,5000,1,110329,126191,118881,133130,121159,126069,0.8486846153846154,0.9707,0.9144692307692308,1.024076923076923,0.9319923076923077,0.9697615384615385,6
5746,10000,0,2,2,46,0,0,0,0,0,0,8866,9844,9319,18202,9287,0,1143,1218,1000,372,0,0,0,7723,8626,8319,17830,9287,0,0.7723,0.8626,0.8319,1.783,0.9287,0.0,0
5747,60000,0,1,2,29,0,0,0,0,0,0,31235,31462,31499,16773,11568,9727,6050,6037,5084,6000,4000,3832,0,25185,25425,26415,10773,7568,5895,0.41975,0.42375,0.44025,0.17955,0.12613333333333332,0.09825,0
5748,420000,0,1,1,54,-1,-1,-1,-1,-1,-1,12349,6545,6377,18801,22180,13211,6576,6420,18892,22285,13270,10683,1,5773,125,-12515,-3484,8910,2528,0.013745238095238095,0.00029761904761904765,-0.02979761904761905,-0.008295238095238095,0.021214285714285713,0.006019047619047619,-6
5749,50000,1,3,1,61,-1,-1,-2,-2,-2,-2,2020,0,0,0,0,0,0,0,0,0,0,202,1,2020,0,0,0,0,-202,0.0404,0.0,0.0,0.0,0.0,-0.00404,-10
5750,150000,0,1,2,41,-1,2,-1,-1,-1,-1,1980,990,990,990,990,1980,0,990,990,990,1980,0,0,1980,0,0,0,-990,1980,0.0132,0.0,0.0,0.0,-0.0066,0.0132,-3
5751,20000,0,2,2,24,0,0,0,0,0,0,4091,5316,6467,7500,7497,8170,1300,1400,1300,270,795,0,0,2791,3916,5167,7230,6702,8170,0.13955,0.1958,0.25835,0.3615,0.3351,0.4085,0
5752,220000,0,2,2,30,1,2,2,2,2,2,105348,106432,102996,100198,100357,95471,4268,3251,2900,5000,0,105300,0,101080,103181,100096,95198,100357,-9829,0.45945454545454545,0.46900454545454545,0.4549818181818182,0.43271818181818184,0.4561681818181818,-0.044677272727272725,11
5753,280000,1,1,2,29,-1,-1,-1,-1,-1,-1,768,786,1379,1885,143,1250,788,1383,1890,143,1253,316,0,-20,-597,-511,1742,-1110,934,-7.142857142857143e-05,-0.002132142857142857,-0.001825,0.006221428571428571,-0.0039642857142857145,0.0033357142857142856,-6
5754,230000,1,1,1,34,-1,-1,0,0,-1,-1,3394,8338,11744,9359,19002,8443,8338,9359,0,19002,8740,0,1,-4944,-1021,11744,-9643,10262,8443,-0.021495652173913044,-0.004439130434782609,0.05106086956521739,-0.04192608695652174,0.044617391304347824,0.03670869565217391,-4
5755,340000,1,1,2,26,0,0,0,0,0,0,337871,311076,156674,129651,126192,94722,11208,5000,23809,4136,3600,3169,0,326663,306076,132865,125515,122592,91553,0.9607735294117647,0.9002235294117648,0.3907794117647059,0.36916176470588236,0.36056470588235295,0.2692735294117647,0
5756,100000,1,3,1,47,0,0,0,0,0,0,139550,70620,70000,70298,69677,69672,3500,2600,3000,2500,2500,2500,1,136050,68020,67000,67798,67177,67172,1.3605,0.6802,0.67,0.67798,0.67177,0.67172,0
5757,80000,1,1,1,28,0,0,0,0,0,0,8574,9434,10038,10040,10400,10490,1203,1047,248,408,294,276,1,7371,8387,9790,9632,10106,10214,0.0921375,0.1048375,0.122375,0.1204,0.126325,0.127675,0
5758,50000,0,2,2,39,0,0,0,0,0,0,23540,16980,16908,17327,17895,18346,2010,1500,1000,1000,900,1000,0,21530,15480,15908,16327,16995,17346,0.4306,0.3096,0.31816,0.32654,0.3399,0.34692,0
5759,500000,1,1,2,42,-1,-1,-1,2,-1,-1,30439,1844,844,614,2887,3850,1844,1000,0,3000,4000,6000,0,28595,844,844,-2386,-1113,-2150,0.05719,0.001688,0.001688,-0.004772,-0.002226,-0.0043,-3
5760,470000,0,1,2,33,0,0,0,0,0,0,72083,68136,69036,71466,67538,70400,5031,5500,5000,5000,4000,5000,0,67052,62636,64036,66466,63538,65400,0.14266382978723405,0.13326808510638297,0.1362468085106383,0.14141702127659575,0.1351872340425532,0.13914893617021276,0
5761,450000,0,2,1,66,-2,-2,-2,-2,-2,-2,-81,15029,-1318,-9157,-20753,-22680,15110,40,258,9,23,27,1,-15191,14989,-1576,-9166,-20776,-22707,-0.033757777777777775,0.03330888888888889,-0.003502222222222222,-0.020368888888888888,-0.04616888888888889,-0.05046,-12
5762,220000,1,1,1,44,-1,0,0,0,0,0,208858,212640,216062,209288,202578,195567,7611,7484,7109,6969,6661,6426,1,201247,205156,208953,202319,195917,189141,0.9147590909090909,0.9325272727272728,0.9497863636363636,0.9196318181818182,0.8905318181818181,0.8597318181818182,-1
5763,130000,0,2,1,31,-1,-1,-1,-1,-1,2,1261,1261,1261,1411,930,390,1261,1261,1411,930,0,780,1,0,0,-150,481,930,-390,0.0,0.0,-0.001153846153846154,0.0037,0.007153846153846154,-0.003,-3
5764,210000,0,1,1,40,2,2,2,2,2,0,151258,141669,134301,124218,110114,101559,5000,7000,4200,0,4000,6500,1,146258,134669,130101,124218,106114,95059,0.6964666666666667,0.6412809523809524,0.6195285714285714,0.5915142857142857,0.5053047619047619,0.45266190476190477,10
5765,10000,0,3,1,46,-1,2,2,4,3,2,6277,7019,9557,9269,8836,8548,1000,2819,0,0,0,250,1,5277,4200,9557,9269,8836,8298,0.5277,0.42,0.9557,0.9269,0.8836,0.8298,12
5766,50000,0,2,1,64,2,3,2,2,0,0,28433,27682,28403,27648,28202,30008,0,1459,0,1013,2264,0,1,28433,26223,28403,26635,25938,30008,0.56866,0.52446,0.56806,0.5327,0.51876,0.60016,9
5767,150000,1,1,1,58,-1,-1,-1,-1,-1,-1,1657,2277,4049,1665,559,0,2277,4066,1665,559,0,663,1,-620,-1789,2384,1106,559,-663,-0.0041333333333333335,-0.011926666666666667,0.015893333333333332,0.007373333333333333,0.0037266666666666668,-0.00442,-6
5768,20000,0,2,2,39,0,0,0,0,0,0,13231,14306,15370,16411,16839,17267,1300,1300,1300,700,700,700,0,11931,13006,14070,15711,16139,16567,0.59655,0.6503,0.7035,0.78555,0.80695,0.82835,0
5769,280000,0,1,1,41,-1,-1,-1,-1,-1,-1,718,3910,1906,837,360,350,3927,1913,841,360,350,2095,1,-3209,1997,1065,477,10,-1745,-0.011460714285714286,0.007132142857142857,0.0038035714285714287,0.0017035714285714286,3.571428571428572e-05,-0.006232142857142857,-6
5770,100000,0,2,1,49,0,0,0,0,0,0,69896,71360,72820,74264,75821,77410,2588,2644,2656,2752,2850,2965,1,67308,68716,70164,71512,72971,74445,0.67308,0.68716,0.70164,0.71512,0.72971,0.74445,0
5771,320000,1,1,2,28,-1,0,-1,-1,-1,-1,18506,12237,913,5356,58545,7357,1062,1116,5384,58837,7393,5926,0,17444,11121,-4471,-53481,51152,1431,0.0545125,0.034753125,-0.013971875,-0.167128125,0.15985,0.004471875,-5
5772,270000,0,3,2,51,0,0,0,0,0,0,152979,101616,105562,6102,6741,65672,3500,4000,1000,1000,63000,3000,0,149479,97616,104562,5102,-56259,62672,0.553625925925926,0.3615407407407407,0.38726666666666665,0.018896296296296296,-0.20836666666666667,0.23211851851851853,0
5773,180000,1,1,2,29,-1,-1,-1,-2,-1,0,11386,199,0,0,17227,17042,199,0,0,17227,341,5114,0,11187,199,0,-17227,16886,11928,0.06215,0.0011055555555555556,0.0,-0.09570555555555556,0.09381111111111111,0.06626666666666667,-6
5774,210000,1,2,2,28,-2,-2,-2,-2,-2,-2,0,0,0,1577,0,0,0,0,1577,0,0,0,0,0,0,-1577,1577,0,0,0.0,0.0,-0.00750952380952381,0.00750952380952381,0.0,0.0,-12
5775,270000,0,1,2,34,1,2,0,0,2,0,20979,17228,20924,22448,15490,17343,0,4000,2000,0,2000,2000,0,20979,13228,18924,22448,13490,15343,0.0777,0.048992592592592595,0.0700888888888889,0.08314074074074074,0.049962962962962966,0.056825925925925926,5
5776,200000,0,1,1,42,0,-1,0,0,-1,-1,19318,19067,17858,326,326,326,19067,5000,0,326,326,326,1,251,14067,17858,0,0,0,0.001255,0.070335,0.08929,0.0,0.0,0.0,-3
5777,180000,1,1,2,29,-1,-1,-1,-1,-1,-1,326,326,546,546,546,1225,326,546,546,546,1225,2225,0,0,-220,0,0,-679,-1000,0.0,-0.0012222222222222222,0.0,0.0,-0.0037722222222222224,-0.005555555555555556,-6
5778,180000,1,3,2,32,0,0,0,0,0,0,4480,7354,6930,6090,2435,2074,3000,3000,2018,1200,1500,3000,0,1480,4354,4912,4890,935,-926,0.008222222222222223,0.024188888888888888,0.02728888888888889,0.027166666666666665,0.005194444444444444,-0.0051444444444444445,0
5779,70000,1,2,2,34,-1,-1,-1,-1,0,0,2226,1245,-1000,11019,11632,7864,1245,0,12019,1000,157,7851,0,981,1245,-13019,10019,11475,13,0.014014285714285713,0.017785714285714287,-0.18598571428571428,0.14312857142857144,0.16392857142857142,0.00018571428571428572,-4
5780,100000,1,1,2,52,1,2,2,2,2,2,13687,14007,14236,12924,12467,10950,1600,1500,0,700,0,1150,0,12087,12507,14236,12224,12467,9800,0.12087,0.12507,0.14236,0.12224,0.12467,0.098,11
5781,30000,0,1,1,37,1,2,2,0,0,2,20829,22689,22043,23367,24983,25437,2500,0,2000,2000,1000,0,1,18329,22689,20043,21367,23983,25437,0.6109666666666667,0.7563,0.6681,0.7122333333333334,0.7994333333333333,0.8479,7
5782,70000,1,3,1,41,0,0,0,0,0,0,23546,23462,17548,15864,14937,12841,1573,1355,1203,516,500,500,1,21973,22107,16345,15348,14437,12341,0.3139,0.3158142857142857,0.2335,0.21925714285714284,0.20624285714285714,0.1763,0
5783,50000,1,1,1,35,0,0,2,2,2,0,44487,47438,46400,49276,48286,47915,4000,0,3700,0,2000,6000,1,40487,47438,42700,49276,46286,41915,0.80974,0.94876,0.854,0.98552,0.92572,0.8383,6
5784,90000,0,1,2,33,-1,-1,-1,-1,-1,2,498,498,498,498,3482,2793,498,498,498,3482,0,483,0,0,0,0,-2984,3482,2310,0.0,0.0,0.0,-0.033155555555555556,0.03868888888888889,0.025666666666666667,-3
5785,200000,0,3,1,50,0,0,2,2,2,2,119657,127855,128447,115045,117299,105456,11754,4100,0,14000,0,10365,1,107903,123755,128447,101045,117299,95091,0.539515,0.618775,0.642235,0.505225,0.586495,0.475455,8
5786,280000,0,1,2,29,-1,2,-1,-1,-1,0,7712,1171,1599,436,47613,31987,0,2013,436,47613,1472,2275,0,7712,-842,1163,-47177,46141,29712,0.027542857142857143,-0.003007142857142857,0.004153571428571428,-0.1684892857142857,0.16478928571428572,0.10611428571428572,-2
5787,30000,1,2,1,31,1,2,2,0,0,0,28933,30109,29349,29400,30000,0,1949,0,1000,600,0,0,1,26984,30109,28349,28800,30000,0,0.8994666666666666,1.0036333333333334,0.9449666666666666,0.96,1.0,0.0,5
5788,230000,0,2,1,30,-1,-1,-2,-1,-1,-1,5200,0,0,8780,11990,0,0,0,8780,11990,0,0,1,5200,0,-8780,-3210,11990,0,0.022608695652173914,0.0,-0.03817391304347826,-0.013956521739130435,0.052130434782608696,0.0,-7
5789,10000,0,2,1,50,0,0,0,0,0,-1,3664,4526,6880,8830,5550,6195,1300,3000,2509,0,6195,0,1,2364,1526,4371,8830,-645,6195,0.2364,0.1526,0.4371,0.883,-0.0645,0.6195,-1
5790,220000,1,1,2,27,-1,-1,-1,0,0,-1,471,5261,16436,16071,96,480,5272,17571,0,0,549,0,0,-4801,-12310,16436,16071,-453,480,-0.02182272727272727,-0.05595454545454545,0.0747090909090909,0.07305,-0.0020590909090909093,0.002181818181818182,-4
5791,100000,0,1,1,38,2,2,2,2,2,0,72437,74645,76063,77224,75385,78991,4000,3200,3000,0,5000,3200,1,68437,71445,73063,77224,70385,75791,0.68437,0.71445,0.73063,0.77224,0.70385,0.75791,10
5792,130000,1,2,1,42,2,2,2,0,0,0,130623,131926,128380,126792,103497,96991,6400,0,4535,3900,4300,3700,1,124223,131926,123845,122892,99197,93291,0.9555615384615385,1.0148153846153847,0.9526538461538462,0.9453230769230769,0.7630538461538462,0.7176230769230769,6
5793,30000,1,3,1,39,1,2,2,2,2,2,25574,22897,25647,24937,26938,26374,0,3128,0,2419,0,700,1,25574,19769,25647,22518,26938,25674,0.8524666666666667,0.6589666666666667,0.8549,0.7506,0.8979333333333334,0.8558,11
5794,60000,1,1,2,22,0,0,0,0,0,0,57484,59521,59674,56018,36350,18203,3000,3000,1500,790,1000,1000,0,54484,56521,58174,55228,35350,17203,0.9080666666666667,0.9420166666666666,0.9695666666666667,0.9204666666666667,0.5891666666666666,0.2867166666666667,0
5795,10000,0,2,2,26,0,0,0,0,0,0,9861,15147,6641,15318,8610,8790,1099,2234,1135,1086,319,319,0,8762,12913,5506,14232,8291,8471,0.8762,1.2913,0.5506,1.4232,0.8291,0.8471,0
5796,50000,1,1,2,35,0,0,0,0,0,0,4309,10834,15251,12159,9581,15222,7000,8000,9400,1000,6000,3000,0,-2691,2834,5851,11159,3581,12222,-0.05382,0.05668,0.11702,0.22318,0.07162,0.24444,0
5797,380000,1,2,1,48,0,0,0,0,0,0,363191,373421,363343,290371,289600,288256,15504,14000,12500,12000,11000,14000,1,347687,359421,350843,278371,278600,274256,0.9149657894736842,0.9458447368421052,0.9232710526315789,0.7325552631578948,0.7331578947368421,0.7217263157894737,0
5798,170000,1,3,1,37,0,0,0,0,0,0,155379,155990,46870,43584,34760,35467,7000,1900,2014,2500,2000,2000,1,148379,154090,44856,41084,32760,33467,0.8728176470588235,0.9064117647058824,0.26385882352941176,0.2416705882352941,0.19270588235294117,0.19686470588235294,0
5799,280000,1,1,2,32,-2,-2,-2,-2,-2,-2,5855,13645,9127,9656,41434,21732,13713,9171,9705,41641,21838,5659,0,-7858,4474,-578,-31985,19596,16073,-0.028064285714285715,0.01597857142857143,-0.0020642857142857142,-0.11423214285714285,0.06998571428571429,0.05740357142857143,-12
5800,280000,0,2,2,30,2,2,2,2,2,0,110550,113877,115223,116930,112607,95949,6600,4700,5100,0,4200,3000,0,103950,109177,110123,116930,108407,92949,0.37125,0.38991785714285715,0.39329642857142855,0.41760714285714284,0.3871678571428571,0.3319607142857143,10
5801,120000,0,3,1,32,2,2,2,2,2,2,67502,68842,69825,70891,72213,73786,3000,2700,2800,2600,2900,0,1,64502,66142,67025,68291,69313,73786,0.5375166666666666,0.5511833333333334,0.5585416666666667,0.5690916666666667,0.5776083333333333,0.6148833333333333,12
5802,360000,1,1,1,34,-2,-2,-2,-2,-2,-2,0,0,0,0,0,0,0,0,0,0,0,0,1,0,0,0,0,0,0,0.0,0.0,0.0,0.0,0.0,0.0,-12
5803,200000,0,1,1,34,-1,-1,-1,-1,-2,-2,165,165,165,0,0,0,165,165,0,0,0,0,1,0,0,165,0,0,0,0.0,0.0,0.000825,0.0,0.0,0.0,-8
5804,490000,0,1,2,36,-2,-2,-2,-2,-2,-2,5310,2691,3367,-46,9285,-14,2711,3384,0,9331,0,2960,0,2599,-693,3367,-9377,9285,-2974,0.0053040816326530614,-0.0014142857142857143,0.006871428571428572,-0.01913673469387755,0.018948979591836734,-0.006069387755102041,-12
5805,50000,1,2,1,41,2,0,0,0,-1,0,33343,31392,27315,-60,28890,29168,1502,1000,0,30070,1180,1000,1,31841,30392,27315,-30130,27710,28168,0.63682,0.60784,0.5463,-0.6026,0.5542,0.56336,1
5806,310000,0,2,1,31,-1,2,-1,-1,-1,-1,4673,3851,547,3913,670,2489,0,547,3913,670,2489,656,1,4673,3304,-3366,3243,-1819,1833,0.015074193548387098,0.010658064516129032,-0.010858064516129032,0.010461290322580644,-0.005867741935483871,0.005912903225806451,-3
5807,90000,1,1,2,23,0,0,0,0,2,0,60374,57829,59492,68365,66832,69248,3000,2600,10000,0,3500,4000,0,57374,55229,49492,68365,63332,65248,0.6374888888888889,0.6136555555555555,0.5499111111111111,0.7596111111111111,0.7036888888888889,0.7249777777777778,2
5808,210000,1,2,2,31,-1,-1,-1,-1,-1,-1,1154,1368,1080,1567,788,0,1368,1080,1567,788,0,1638,0,-214,288,-487,779,788,-1638,-0.001019047619047619,0.0013714285714285714,-0.002319047619047619,0.0037095238095238097,0.0037523809523809524,-0.0078,-6
5809,220000,1,1,1,41,0,0,0,0,0,0,219198,114930,100749,74457,68604,53333,5068,5000,2000,3000,3000,1000,1,214130,109930,98749,71457,65604,52333,0.9733181818181819,0.49968181818181817,0.44885909090909093,0.32480454545454546,0.2982,0.23787727272727271,0
5810,280000,1,3,2,43,0,0,0,0,0,0,194868,178774,172045,175487,179270,183394,7000,7000,6200,6500,7000,7000,0,187868,171774,165845,168987,172270,176394,0.6709571428571428,0.6134785714285714,0.5923035714285714,0.603525,0.61525,0.6299785714285714,0
5811,90000,1,2,1,31,-1,-1,-2,-2,-2,-2,350,0,0,0,0,0,0,0,0,0,0,0,1,350,0,0,0,0,0,0.0038888888888888888,0.0,0.0,0.0,0.0,0.0,-10
5812,10000,1,2,2,33,0,0,0,0,0,-1,15004,8663,9437,9630,8399,1697,2452,1000,193,168,1734,770,0,12552,7663,9244,9462,6665,927,1.2552,0.7663,0.9244,0.9462,0.6665,0.0927,-1
5813,80000,0,1,2,31,-1,-1,0,0,0,0,17873,65585,64047,48107,48620,45280,65592,2051,2002,2013,2004,2000,0,-47719,63534,62045,46094,46616,43280,-0.5964875,0.794175,0.7755625,0.576175,0.5827,0.541,-2
5814,110000,0,2,1,50,1,-1,0,0,0,0,-10682,50928,54711,55926,18030,18367,62000,5000,3000,2000,1000,2000,1,-72682,45928,51711,53926,17030,16367,-0.6607454545454545,0.41752727272727275,0.4701,0.49023636363636364,0.15481818181818183,0.14879090909090908,0
5815,160000,1,2,1,28,0,0,0,0,0,0,6031,7057,7912,8080,8250,8565,1280,1132,300,300,452,312,1,4751,5925,7612,7780,7798,8253,0.02969375,0.03703125,0.047575,0.048625,0.0487375,0.05158125,0
5816,20000,0,3,1,43,-1,-1,0,0,0,0,227,20351,20237,19339,19450,19337,22359,1305,1258,1459,3457,1700,1,-22132,19046,18979,17880,15993,17637,-1.1066,0.9523,0.94895,0.894,0.79965,0.88185,-2
5817,200000,0,2,2,45,0,0,0,0,0,0,200996,194699,183344,153880,155359,158776,9200,9000,8000,6000,6000,6000,0,191796,185699,175344,147880,149359,152776,0.95898,0.928495,0.87672,0.7394,0.746795,0.76388,0
5818,170000,1,1,2,27,0,0,0,0,-1,0,89909,61785,17848,14000,124208,122955,8941,3848,4000,124208,5000,5000,0,80968,57937,13848,-110208,119208,117955,0.4762823529411765,0.3408058823529412,0.08145882352941176,-0.6482823529411764,0.7012235294117647,0.6938529411764706,-1
5819,300000,1,1,2,31,0,0,-1,-1,0,0,60700,33843,5045,10288,12565,6947,5000,5045,10288,5000,5000,10000,0,55700,28798,-5243,5288,7565,-3053,0.18566666666666667,0.09599333333333333,-0.017476666666666668,0.017626666666666665,0.025216666666666665,-0.010176666666666667,-2
5820,180000,0,2,2,34,1,-2,-2,-2,-2,-2,149172,100466,98458,89384,88315,84320,4600,4207,3500,4000,5000,602,0,144572,96259,94958,85384,83315,83718,0.8031777777777778,0.5347722222222222,0.5275444444444445,0.47435555555555553,0.4628611111111111,0.4651,-9
5821,10000,0,1,2,24,2,2,0,0,0,0,8837,7554,8287,9580,9267,10096,0,1500,2000,700,1500,0,0,8837,6054,6287,8880,7767,10096,0.8837,0.6054,0.6287,0.888,0.7767,1.0096,4
5822,50000,1,3,2,49,0,0,0,0,0,0,39803,37595,23250,26293,21508,20971,5007,1602,10002,5000,2000,2000,0,34796,35993,13248,21293,19508,18971,0.69592,0.71986,0.26496,0.42586,0.39016,0.37942,0
5823,30000,1,3,1,57,0,0,0,0,0,0,17779,19097,19816,18471,16305,0,2000,1500,1000,841,0,1030,1,15779,17597,18816,17630,16305,-1030,0.5259666666666667,0.5865666666666667,0.6272,0.5876666666666667,0.5435,-0.034333333333333334,0
5824,30000,1,2,2,25,0,0,0,0,-2,-2,15767,16083,6115,0,0,0,1488,1000,0,0,0,0,0,14279,15083,6115,0,0,0,0.47596666666666665,0.5027666666666667,0.20383333333333334,0.0,0.0,0.0,-4
5825,180000,0,1,2,29,1,-1,-1,-1,-1,-1,0,100000,0,7632,0,6071,100000,0,7632,0,6071,0,0,-100000,100000,-7632,7632,-6071,6071,-0.5555555555555556,0.5555555555555556,-0.0424,0.0424,-0.03372777777777778,0.03372777777777778,-4
5826,230000,1,1,1,35,0,0,0,0,0,0,165405,168697,172990,177963,77076,78848,6027,7000,8000,3000,3000,3226,1,159378,161697,164990,174963,74076,75622,0.6929478260869565,0.7030304347826087,0.7173478260869566,0.7607086956521739,0.32206956521739133,0.3287913043478261,0
5827,410000,0,2,1,36,0,0,0,0,0,0,421227,416160,419988,359736,358471,360557,15050,16000,13100,12700,13000,13100,1,406177,400160,406888,347036,345471,347457,0.9906756097560976,0.976,0.992409756097561,0.846429268292683,0.8426121951219512,0.8474560975609756,0
5828,60000,1,1,2,28,0,0,0,2,0,0,20217,8376,7139,4254,4855,5355,1116,2420,0,800,1000,0,0,19101,5956,7139,3454,3855,5355,0.31835,0.09926666666666667,0.11898333333333333,0.05756666666666667,0.06425,0.08925,2
5829,70000,0,2,1,45,0,0,0,0,0,0,31218,32321,41713,42233,43288,46001,1608,10000,1511,1735,3600,0,1,29610,22321,40202,40498,39688,46001,0.423,0.3188714285714286,0.5743142857142857,0.5785428571428571,0.5669714285714286,0.6571571428571429,0
5830,360000,0,1,1,44,-2,-2,-2,-2,-2,-2,188,1610,1088,7870,5988,342,1610,1088,7870,5988,342,7159,1,-1422,522,-6782,1882,5646,-6817,-0.00395,0.00145,-0.018838888888888888,0.005227777777777777,0.015683333333333334,-0.018936111111111112,-12
5831,220000,1,1,2,36,-1,-1,-1,-1,-1,-2,4952,1734,819,3750,657,0,1734,827,3750,0,0,0,0,3218,907,-2931,3750,657,0,0.014627272727272727,0.004122727272727273,-0.013322727272727273,0.017045454545454544,0.0029863636363636364,0.0,-7
5832,360000,0,1,1,38,-2,-2,-2,-2,-2,-2,0,0,0,0,0,0,0,0,0,0,0,0,1,0,0,0,0,0,0,0.0,0.0,0.0,0.0,0.0,0.0,-12
5833,20000,1,2,3,46,1,-2,-1,0,0,-1,0,0,390,390,390,150,0,390,0,0,150,390,0,0,-390,390,390,240,-240,0.0,-0.0195,0.0195,0.0195,0.012,-0.012,-3
5834,310000,0,3,2,28,-1,2,-1,-1,-1,0,186,186,3550,653,14353,15932,0,3567,654,14428,15018,20000,0,186,-3381,2896,-13775,-665,-4068,0.0006,-0.010906451612903226,0.009341935483870968,-0.04443548387096774,-0.0021451612903225807,-0.01312258064516129,-2
5835,150000,1,2,2,24,1,2,0,0,0,0,65542,28311,23978,17853,34527,28277,0,2145,10000,22000,3000,5093,0,65542,26166,13978,-4147,31527,23184,0.43694666666666665,0.17444,0.09318666666666667,-0.027646666666666667,0.21018,0.15456,3
5836,50000,0,2,1,56,0,0,0,0,0,0,28358,25278,24713,22379,18943,15464,1416,1471,1147,531,464,451,1,26942,23807,23566,21848,18479,15013,0.53884,0.47614,0.47132,0.43696,0.36958,0.30026,0
5837,160000,1,3,1,41,2,2,2,0,0,2,46017,47188,46134,47063,50034,51063,2200,0,2000,3900,2000,0,1,43817,47188,44134,43163,48034,51063,0.27385625,0.294925,0.2758375,0.26976875,0.3002125,0.31914375,8
5838,130000,1,3,1,38,0,0,0,0,0,0,100443,95794,92765,48481,47779,42362,3516,4112,2007,2516,1119,1016,1,96927,91682,90758,45965,46660,41346,0.7455923076923077,0.7052461538461539,0.6981384615384615,0.35357692307692307,0.3589230769230769,0.31804615384615387,0
5839,390000,1,4,2,45,0,0,0,0,0,0,184547,179819,162571,167832,205750,212634,6645,5782,7782,42393,10414,7422,0,177902,174037,154789,125439,195336,205212,0.45615897435897435,0.44624871794871795,0.3968948717948718,0.32163846153846154,0.5008615384615385,0.5261846153846154,0
5840,50000,0,1,2,26,0,0,0,0,0,0,48924,48593,49459,50160,49244,50531,2200,2200,1890,2000,2000,1800,0,46724,46393,47569,48160,47244,48731,0.93448,0.92786,0.95138,0.9632,0.94488,0.97462,0
5841,230000,1,1,2,43,0,0,0,0,0,0,39677,39261,38228,36542,35989,34347,5000,5000,3000,3459,4000,5000,0,34677,34261,35228,33083,31989,29347,0.1507695652173913,0.1489608695652174,0.15316521739130434,0.1438391304347826,0.13908260869565217,0.12759565217391305,0
5842,450000,0,1,1,42,-1,0,-1,-1,-1,-1,2549,20499,2499,2499,0,11071,20449,2499,2499,0,11071,780,1,-17900,18000,0,2499,-11071,10291,-0.03977777777777778,0.04,0.0,0.005553333333333334,-0.024602222222222223,0.02286888888888889,-5
5843,150000,1,2,1,36,0,0,0,0,0,0,339351,133681,100683,147127,79942,71976,7000,3500,3000,5242,3009,4000,1,332351,130181,97683,141885,76933,67976,2.215673333333333,0.8678733333333334,0.65122,0.9459,0.5128866666666667,0.4531733333333333,0
5844,180000,0,2,2,32,1,2,0,0,0,0,173179,168499,170856,177544,172432,173940,0,7326,10000,7000,8000,10000,0,173179,161173,160856,170544,164432,163940,0.9621055555555555,0.8954055555555556,0.8936444444444445,0.9474666666666667,0.9135111111111112,0.9107777777777778,3
5845,450000,0,2,2,32,-2,-2,-2,-2,-2,-2,-3768,-3938,-5738,-5738,-5738,-5738,179,1800,0,0,0,0,0,-3947,-5738,-5738,-5738,-5738,-5738,-0.008771111111111111,-0.01275111111111111,-0.01275111111111111,-0.01275111111111111,-0.01275111111111111,-0.01275111111111111,-12
5846,50000,0,2,1,53,2,0,0,2,0,0,17946,18946,21904,21243,20225,19850,1306,3264,0,846,856,804,1,16640,15682,21904,20397,19369,19046,0.3328,0.31364,0.43808,0.40794,0.38738,0.38092,4
5847,360000,0,3,1,51,-1,-1,-1,-1,-1,-1,3019,2438,1008,1250,0,860,2444,1008,1250,0,860,0,1,575,1430,-242,1250,-860,860,0.0015972222222222223,0.0039722222222222225,-0.0006722222222222223,0.003472222222222222,-0.0023888888888888887,0.0023888888888888887,-6
5848,20000,0,1,2,27,0,0,0,0,0,0,19483,18956,18742,19738,15627,15753,1258,1404,1400,399,604,2500,0,18225,17552,17342,19339,15023,13253,0.91125,0.8776,0.8671,0.96695,0.75115,0.66265,0
5849,30000,0,2,2,25,0,0,0,0,0,0,6122,7160,8185,9286,9483,9780,1300,1300,1400,500,600,600,0,4822,5860,6785,8786,8883,9180,0.16073333333333334,0.19533333333333333,0.22616666666666665,0.29286666666666666,0.2961,0.306,0
5850,270000,0,1,2,36,-2,-2,-2,-2,-2,-2,15986,16635,15913,14192,10559,7672,2008,1513,1019,515,302,3050,0,13978,15122,14894,13677,10257,4622,0.05177037037037037,0.05600740740740741,0.05516296296296296,0.05065555555555556,0.03798888888888889,0.01711851851851852,-12
5851,180000,1,2,2,31,1,-2,-2,-2,-2,-2,0,0,0,0,0,0,0,0,0,0,0,0,0,0,0,0,0,0,0,0.0,0.0,0.0,0.0,0.0,0.0,-9
5852,160000,1,2,1,33,0,0,0,0,0,0,189935,183501,175363,172417,165800,158671,8113,6395,10000,6160,5772,5854,1,181822,177106,165363,166257,160028,152817,1.1363875,1.1069125,1.03351875,1.03910625,1.000175,0.95510625,0
5853,160000,1,1,2,31,0,0,0,0,0,0,160843,153543,157871,143690,134386,138038,6000,7225,5000,5000,5900,4992,0,154843,146318,152871,138690,128486,133046,0.96776875,0.9144875,0.95544375,0.8668125,0.8030375,0.8315375,0
5854,60000,1,1,2,27,0,0,0,0,0,0,61015,58160,51237,29999,28972,29444,3016,5011,1005,1000,14000,3104,0,57999,53149,50232,28999,14972,26340,0.96665,0.8858166666666667,0.8372,0.48331666666666667,0.24953333333333333,0.439,0
5855,50000,1,4,1,29,0,0,0,0,0,0,85305,86152,56250,57603,19336,18964,4000,2257,2000,2000,700,600,1,81305,83895,54250,55603,18636,18364,1.6261,1.6779,1.085,1.11206,0.37272,0.36728,0
5856,20000,1,3,2,22,3,2,2,4,4,4,1650,1650,1650,1650,1650,1650,0,0,0,0,0,0,0,1650,1650,1650,1650,1650,1650,0.0825,0.0825,0.0825,0.0825,0.0825,0.0825,19
5857,360000,0,1,1,35,-1,-1,-1,-1,-1,-1,11936,21865,3366,5210,13308,7089,21983,4567,5236,13373,7123,5510,1,-10047,17298,-1870,-8163,6185,1579,-0.027908333333333334,0.04805,-0.005194444444444444,-0.022675,0.017180555555555557,0.0043861111111111115,-6
5858,100000,1,2,2,24,0,-1,-1,-1,-1,-1,13391,10577,8905,0,4290,0,10608,8944,200,4290,0,0,0,2783,1633,8705,-4290,4290,0,0.02783,0.01633,0.08705,-0.0429,0.0429,0.0,-5
5859,50000,1,1,2,24,0,0,0,0,0,0,49144,48202,43656,29466,29936,30350,1837,1462,1038,1086,1069,1034,0,47307,46740,42618,28380,28867,29316,0.94614,0.9348,0.85236,0.5676,0.57734,0.58632,0
5860,30000,0,2,1,30,0,0,0,0,0,-2,27836,28998,29480,29500,0,0,2000,1200,1000,0,1500,0,1,25836,27798,28480,29500,-1500,0,0.8612,0.9266,0.9493333333333334,0.9833333333333333,-0.05,0.0,-2
5861,30000,1,2,1,25,2,2,2,2,2,2,28766,27183,30023,29243,31262,30327,0,3600,0,2800,0,1080,1,28766,23583,30023,26443,31262,29247,0.9588666666666666,0.7861,1.0007666666666666,0.8814333333333333,1.0420666666666667,0.9749,12
5862,260000,0,3,1,39,0,0,-1,-1,-1,2,3518,0,2551,-139,2311,47,0,2551,0,2450,0,5800,1,3518,-2551,2551,-2589,2311,-5753,0.013530769230769232,-0.009811538461538462,0.009811538461538462,-0.009957692307692308,0.008888461538461538,-0.022126923076923075,-1
5863,140000,1,3,1,45,-1,-1,-1,-1,-1,-1,1352,381,2281,437,1320,300,381,2290,437,1320,300,0,1,971,-1909,1844,-883,1020,300,0.0069357142857142855,-0.013635714285714286,0.013171428571428572,-0.0063071428571428575,0.007285714285714286,0.002142857142857143,-6
5864,210000,1,1,2,39,-1,-1,-1,-1,0,-1,5119,20927,3702,3673,1883,384,20965,3702,3673,0,384,0,0,-15846,17225,29,3673,1499,384,-0.07545714285714286,0.08202380952380953,0.0001380952380952381,0.01749047619047619,0.0071380952380952385,0.0018285714285714285,-5
5865,450000,1,1,2,31,-1,-1,-2,-2,-1,0,2609,0,0,0,17855,3430,0,0,0,17855,0,2500,0,2609,0,0,-17855,17855,930,0.0057977777777777776,0.0,0.0,-0.03967777777777778,0.03967777777777778,0.0020666666666666667,-7
5866,460000,1,2,2,35,0,0,0,0,0,0,449790,450047,453770,396600,392879,398478,17610,17500,13810,14100,14520,15000,0,432180,432547,439960,382500,378359,383478,0.9395217391304348,0.9403195652173914,0.9564347826086956,0.8315217391304348,0.8225195652173913,0.8336478260869565,0
5867,200000,1,1,2,36,0,0,-2,-2,-2,-2,120869,0,0,0,0,0,0,0,0,0,0,0,0,120869,0,0,0,0,0,0.604345,0.0,0.0,0.0,0.0,0.0,-8
5868,70000,0,1,1,44,1,2,2,2,0,0,14960,11080,12695,11482,8896,10074,0,3116,0,1000,2000,0,1,14960,7964,12695,10482,6896,10074,0.21371428571428572,0.11377142857142857,0.18135714285714286,0.14974285714285715,0.09851428571428572,0.14391428571428572,7
5869,150000,1,1,1,55,-1,-1,-1,-2,-2,-2,2070,7620,0,0,0,0,7620,0,0,0,0,0,1,-5550,7620,0,0,0,0,-0.037,0.0508,0.0,0.0,0.0,0.0,-9
5870,30000,1,1,2,27,0,0,0,0,0,0,3812,5744,8642,11492,14285,17056,2000,3000,3000,3000,3000,1000,0,1812,2744,5642,8492,11285,16056,0.0604,0.09146666666666667,0.18806666666666666,0.2830666666666667,0.37616666666666665,0.5352,0
5871,140000,1,3,2,43,0,0,0,0,0,0,140832,131883,123504,126441,129345,137539,5006,4500,5000,5000,10490,5000,0,135826,127383,118504,121441,118855,132539,0.9701857142857143,0.9098785714285714,0.8464571428571429,0.8674357142857143,0.8489642857142857,0.9467071428571429,0
5872,500000,1,4,1,32,0,0,0,0,-1,-1,139255,52757,24273,9508,23294,2235,2040,1292,9555,23310,2244,2156,1,137215,51465,14718,-13802,21050,79,0.27443,0.10293,0.029436,-0.027604,0.0421,0.000158,-2
5873,210000,1,2,1,34,0,0,0,0,0,0,86792,88106,89419,88758,85239,81723,3319,3892,3184,3128,2944,2870,1,83473,84214,86235,85630,82295,78853,0.39749047619047617,0.4010190476190476,0.41064285714285714,0.40776190476190477,0.3918809523809524,0.3754904761904762,0
5874,500000,1,1,1,50,-1,-1,-1,-1,-1,-1,21794,12574,12608,-134,22466,1969,12610,12694,0,22600,16837,0,1,9184,-120,12608,-22734,5629,1969,0.018368,-0.00024,0.025216,-0.045468,0.011258,0.003938,-6
5875,180000,0,3,1,37,-2,-2,-2,-2,-2,-2,11368,3595,3837,5760,0,925,3595,3842,5760,0,925,2755,1,7773,-247,-1923,5760,-925,-1830,0.04318333333333333,-0.0013722222222222222,-0.010683333333333333,0.032,-0.005138888888888889,-0.010166666666666666,-12
5876,70000,0,2,2,62,1,2,0,0,0,2,24635,23020,22496,22070,22101,20724,1100,1703,1000,1800,0,900,0,23535,21317,21496,20270,22101,19824,0.3362142857142857,0.3045285714285714,0.3070857142857143,0.2895714285714286,0.3157285714285714,0.2832,5
5877,50000,0,1,2,22,0,0,0,0,0,0,13444,14819,15967,16599,17329,17888,1600,1700,1200,1000,1000,1000,0,11844,13119,14767,15599,16329,16888,0.23688,0.26238,0.29534,0.31198,0.32658,0.33776,0
5878,20000,0,3,2,55,-1,3,2,0,0,-1,3413,3206,2250,1500,750,1650,0,0,0,0,1650,0,0,3413,3206,2250,1500,-900,1650,0.17065,0.1603,0.1125,0.075,-0.045,0.0825,3
5879,230000,1,2,2,38,0,0,0,0,0,0,104364,106549,108719,111039,113365,115625,3867,3941,4123,4267,4300,4084,0,100497,102608,104596,106772,109065,111541,0.43694347826086954,0.4461217391304348,0.4547652173913043,0.46422608695652173,0.474195652173913,0.4849608695652174,0
5880,20000,0,2,1,34,0,0,2,0,0,0,12619,14896,14360,14921,15328,16474,2800,0,800,800,1400,1000,1,9819,14896,13560,14121,13928,15474,0.49095,0.7448,0.678,0.70605,0.6964,0.7737,2
5881,180000,0,2,1,47,0,0,0,0,0,0,179253,95170,97338,99694,65977,67415,3700,3700,4100,2360,2500,2618,1,175553,91470,93238,97334,63477,64797,0.9752944444444445,0.5081666666666667,0.5179888888888889,0.5407444444444445,0.35265,0.3599833333333333,0
5882,200000,0,1,1,44,-2,-2,-2,-2,-2,-2,1640,0,0,0,0,0,0,0,0,0,0,0,1,1640,0,0,0,0,0,0.0082,0.0,0.0,0.0,0.0,0.0,-12
5883,50000,1,2,1,40,0,0,0,0,0,0,31934,32711,34061,32672,32479,33431,2000,3000,3000,3000,2000,1000,1,29934,29711,31061,29672,30479,32431,0.59868,0.59422,0.62122,0.59344,0.60958,0.64862,0
5884,100000,1,1,1,34,1,2,2,2,2,2,46092,45074,48287,49091,50149,51176,0,3978,1900,2000,2000,0,1,46092,41096,46387,47091,48149,51176,0.46092,0.41096,0.46387,0.47091,0.48149,0.51176,11
5885,90000,0,1,2,31,2,0,0,0,0,0,90226,90378,27831,28790,29087,28941,2500,1500,1443,1100,1042,2000,0,87726,88878,26388,27690,28045,26941,0.9747333333333333,0.9875333333333334,0.2932,0.30766666666666664,0.3116111111111111,0.29934444444444447,2
5886,220000,0,1,2,29,0,0,0,0,0,0,216096,189566,183838,157898,164860,168294,10110,12000,5852,10000,6610,5836,0,205986,177566,177986,147898,158250,162458,0.9363,0.8071181818181818,0.8090272727272727,0.6722636363636364,0.7193181818181819,0.7384454545454545,0
5887,150000,0,2,2,34,-1,0,0,0,-1,-1,204187,222314,5051,4408,1731,1960,20000,1093,1000,1731,2169,1408,0,184187,221221,4051,2677,-438,552,1.2279133333333334,1.4748066666666666,0.027006666666666665,0.017846666666666667,-0.00292,0.00368,-3
5888,150000,1,2,1,44,-2,-2,-2,-2,-2,-2,0,0,0,0,0,0,0,0,0,0,0,0,1,0,0,0,0,0,0,0.0,0.0,0.0,0.0,0.0,0.0,-12
5889,240000,1,1,2,39,0,0,0,0,0,0,123704,125133,128856,131620,134413,137188,4905,5800,4900,4900,5000,4515,0,118799,119333,123956,126720,129413,132673,0.49499583333333336,0.49722083333333333,0.5164833333333333,0.528,0.5392208333333334,0.5528041666666667,0
5890,160000,0,3,1,57,-1,-1,-1,-1,-1,-1,390,390,390,390,390,390,390,390,390,390,390,390,1,0,0,0,0,0,0,0.0,0.0,0.0,0.0,0.0,0.0,-6
5891,330000,0,1,2,39,0,0,0,0,0,0,365672,346014,334826,265256,264516,264079,12350,12780,9400,20000,9610,10200,0,353322,333234,325426,245256,254906,253879,1.0706727272727272,1.0098,0.986139393939394,0.7432,0.7724424242424243,0.769330303030303,0
5892,20000,1,2,1,32,1,2,0,0,0,0,18931,18329,19441,20113,19864,15424,0,1414,1146,729,970,0,1,18931,16915,18295,19384,18894,15424,0.94655,0.84575,0.91475,0.9692,0.9447,0.7712,3
5893,100000,0,1,2,27,0,0,0,0,0,0,14712,19142,37882,40882,45683,5765,5000,20000,3000,5000,2000,2000,0,9712,-858,34882,35882,43683,3765,0.09712,-0.00858,0.34882,0.35882,0.43683,0.03765,0
5894,270000,1,1,2,27,0,0,0,0,0,0,200750,204418,197854,173743,149095,145068,9500,8929,7265,5400,5300,5100,0,191250,195489,190589,168343,143795,139968,0.7083333333333334,0.7240333333333333,0.7058851851851852,0.6234925925925926,0.5325740740740741,0.5184,0
5895,300000,1,2,1,49,-1,-1,-1,0,0,0,300,97,6497,5897,6005,0,97,6500,0,408,0,30000,1,203,-6403,6497,5489,6005,-30000,0.0006766666666666667,-0.021343333333333332,0.021656666666666668,0.018296666666666666,0.020016666666666665,-0.1,-3
5896,200000,0,1,2,27,1,-1,-1,-1,-1,-1,-36,7203,5360,4481,10330,5599,7239,5395,4503,10381,5627,4935,0,-7275,1808,857,-5900,4703,664,-0.036375,0.00904,0.004285,-0.0295,0.023515,0.00332,-4
5897,270000,0,2,1,51,0,0,0,0,0,-1,32108,32784,29891,24531,19391,8850,15000,10000,10000,10000,8850,22123,1,17108,22784,19891,14531,10541,-13273,0.06336296296296297,0.08438518518518519,0.07367037037037037,0.053818518518518516,0.039040740740740744,-0.04915925925925926,-1
5898,50000,1,2,1,52,-1,-1,-2,-2,-2,-1,600,972,0,0,0,6500,972,0,0,0,6500,1863,1,-372,972,0,0,-6500,4637,-0.00744,0.01944,0.0,0.0,-0.13,0.09274,-9
5899,90000,0,2,1,41,0,0,0,0,0,0,45431,46338,45129,45640,46175,46716,2749,2206,1113,1135,1153,1134,1,42682,44132,44016,44505,45022,45582,0.47424444444444447,0.49035555555555554,0.48906666666666665,0.4945,0.5002444444444445,0.5064666666666666,0
5900,100000,0,1,1,31,0,0,0,0,0,0,91176,95664,99226,99838,21435,0,6000,6000,4000,5000,0,0,1,85176,89664,95226,94838,21435,0,0.85176,0.89664,0.95226,0.94838,0.21435,0.0,0
5901,200000,0,1,1,29,-1,-1,-1,0,0,-1,295,1130,12791,40341,9238,1017,1130,12791,28000,1000,2000,74179,1,-835,-11661,-15209,39341,7238,-73162,-0.004175,-0.058305,-0.076045,0.196705,0.03619,-0.36581,-4
5902,470000,1,1,1,37,0,0,0,0,0,0,163000,160298,135683,128719,116173,104283,10047,5001,6010,4512,4012,3522,1,152953,155297,129673,124207,112161,100761,0.325431914893617,0.3304191489361702,0.2759,0.26427021276595747,0.2386404255319149,0.21438510638297872,0
5903,180000,1,3,1,31,-2,-2,-2,-2,-2,-2,247,1562,1548,768,0,0,1562,1548,768,0,0,0,1,-1315,14,780,768,0,0,-0.007305555555555556,7.777777777777778e-05,0.004333333333333333,0.004266666666666667,0.0,0.0,-12
5904,500000,1,1,1,35,-1,-1,-1,-1,-1,-1,2153,9869,4055,3000,3000,8063,9869,4065,3000,3000,8063,6000,1,-7716,5804,1055,0,-5063,2063,-0.015432,0.011608,0.00211,0.0,-0.010126,0.004126,-6
5905,130000,0,1,2,30,0,0,0,0,0,0,77939,78524,63421,60269,59984,27126,3916,3000,3000,3000,1000,2000,0,74023,75524,60421,57269,58984,25126,0.5694076923076923,0.5809538461538462,0.4647769230769231,0.4405307692307692,0.4537230769230769,0.19327692307692307,0
5906,10000,1,3,2,22,0,0,0,0,-2,-2,8109,9778,8259,0,0,0,2000,1036,0,0,0,0,0,6109,8742,8259,0,0,0,0.6109,0.8742,0.8259,0.0,0.0,0.0,-4
5907,290000,1,1,1,30,0,0,0,0,0,0,216328,218435,218783,158215,69234,71560,8000,8600,6700,2600,3500,0,1,208328,209835,212083,155615,65734,71560,0.7183724137931035,0.7235689655172414,0.7313206896551724,0.536603448275862,0.2266689655172414,0.24675862068965518,0
5908,140000,0,2,1,34,0,0,0,0,0,0,70649,72069,74140,76421,82223,84296,3100,3140,3421,7000,3296,3283,1,67549,68929,70719,69421,78927,81013,0.48249285714285717,0.49235,0.5051357142857142,0.4958642857142857,0.5637642857142857,0.5786642857142857,0
5909,30000,1,3,2,44,1,2,2,-2,-2,-2,3213,3000,0,0,0,0,0,0,0,0,0,0,0,3213,3000,0,0,0,0,0.1071,0.1,0.0,0.0,0.0,0.0,-1
5910,360000,1,3,2,45,-2,-2,-2,-2,-2,-2,0,700,0,0,1526,0,700,0,0,1526,0,0,0,-700,700,0,-1526,1526,0,-0.0019444444444444444,0.0019444444444444444,0.0,-0.004238888888888889,0.004238888888888889,0.0,-12
5911,150000,1,2,2,28,0,0,0,0,0,0,22943,18989,19961,16549,14227,15380,1335,1307,1178,1500,1500,1000,0,21608,17682,18783,15049,12727,14380,0.14405333333333334,0.11788,0.12522,0.10032666666666666,0.08484666666666667,0.09586666666666667,0
5912,300000,0,1,2,27,-2,-2,-2,-2,-2,-2,0,0,0,0,0,0,0,0,0,0,0,0,0,0,0,0,0,0,0,0.0,0.0,0.0,0.0,0.0,0.0,-12
5913,80000,1,2,1,38,1,2,0,0,0,0,84372,77773,78499,79943,77354,78655,0,2900,3102,3000,3010,3400,1,84372,74873,75397,76943,74344,75255,1.05465,0.9359125,0.9424625,0.9617875,0.9293,0.9406875,3
5914,50000,1,3,1,40,0,0,0,0,0,0,49941,51213,12104,12898,13687,14458,2400,1206,1000,1000,1000,1000,1,47541,50007,11104,11898,12687,13458,0.95082,1.00014,0.22208,0.23796,0.25374,0.26916,0
5915,400000,1,2,2,26,0,0,0,0,0,0,74465,68544,60763,53184,45776,38432,3600,2200,1700,1500,1315,800,0,70865,66344,59063,51684,44461,37632,0.1771625,0.16586,0.1476575,0.12921,0.1111525,0.09408,0
5916,70000,1,2,1,27,0,0,2,2,2,2,68425,71783,72616,68201,50995,48822,6800,3100,15,3850,0,1800,1,61625,68683,72601,64351,50995,47022,0.8803571428571428,0.9811857142857143,1.0371571428571429,0.9193,0.7285,0.6717428571428572,8
5917,50000,1,2,2,28,-1,-1,-1,-1,-1,-1,780,0,390,390,885,885,0,390,390,885,885,885,0,780,-390,0,-495,0,0,0.0156,-0.0078,0.0,-0.0099,0.0,0.0,-6
5918,170000,0,2,1,38,-1,0,-1,-1,-1,0,16480,21770,11507,715,3282,715,15067,11572,3282,3282,0,3122,1,1413,10198,8225,-2567,3282,-2407,0.008311764705882354,0.05998823529411765,0.048382352941176474,-0.0151,0.019305882352941176,-0.014158823529411765,-4
5919,30000,1,2,1,52,0,0,2,0,0,0,27101,30360,28002,23879,4178,0,4110,94,1879,84,0,0,1,22991,30266,26123,23795,4178,0,0.7663666666666666,1.0088666666666666,0.8707666666666667,0.7931666666666667,0.13926666666666668,0.0,2
5920,50000,1,2,2,25,0,0,0,0,0,0,24408,25169,13368,14142,14911,15660,1300,1500,1000,1000,1000,1000,0,23108,23669,12368,13142,13911,14660,0.46216,0.47338,0.24736,0.26284,0.27822,0.2932,0
5921,100000,0,1,1,63,0,0,0,0,0,0,61228,59936,59038,52735,46667,49009,2810,2954,2307,1756,3181,0,1,58418,56982,56731,50979,43486,49009,0.58418,0.56982,0.56731,0.50979,0.43486,0.49009,0
5922,50000,0,1,1,47,0,0,2,2,2,2,45717,47974,49837,50807,49947,50424,3000,3000,2000,0,5000,0,1,42717,44974,47837,50807,44947,50424,0.85434,0.89948,0.95674,1.01614,0.89894,1.00848,8
5923,70000,0,2,1,41,1,2,2,2,0,0,34779,35921,36536,35651,36427,37169,2000,1500,0,1500,1500,3000,1,32779,34421,36536,34151,34927,34169,0.46827142857142856,0.4917285714285714,0.5219428571428572,0.48787142857142857,0.4989571428571429,0.4881285714285714,7
5924,150000,1,2,2,32,0,0,0,2,2,2,9545,14350,17118,16546,20052,20385,5000,3000,0,3800,800,0,0,4545,11350,17118,12746,19252,20385,0.0303,0.07566666666666666,0.11412,0.08497333333333333,0.12834666666666666,0.1359,6
5925,80000,1,2,1,32,0,0,0,0,0,0,77808,77180,79147,81159,69573,70306,3000,4000,4000,5000,8000,2800,1,74808,73180,75147,76159,61573,67506,0.9351,0.91475,0.9393375,0.9519875,0.7696625,0.843825,0
5926,130000,1,4,1,27,0,0,0,0,0,0,131041,133792,127622,129795,122416,124653,6500,5000,5000,5000,5000,5000,1,124541,128792,122622,124795,117416,119653,0.9580076923076923,0.9907076923076923,0.9432461538461538,0.9599615384615384,0.9032,0.9204076923076923,0
5927,300000,0,2,1,55,0,0,0,0,0,0,69994,71388,72886,74371,75854,77440,2552,2645,2696,2716,2809,2826,1,67442,68743,70190,71655,73045,74614,0.22480666666666665,0.22914333333333334,0.23396666666666666,0.23885,0.24348333333333333,0.24871333333333334,0
5928,10000,0,2,2,23,0,0,0,0,0,-2,2068,6000,6457,6177,0,0,4400,1000,500,0,0,0,0,-2332,5000,5957,6177,0,0,-0.2332,0.5,0.5957,0.6177,0.0,0.0,-2
5929,200000,1,1,2,28,2,2,2,2,0,0,68398,73564,73548,44234,42599,46192,6900,1966,12,1604,5164,1104,0,61498,71598,73536,42630,37435,45088,0.30749,0.35799,0.36768,0.21315,0.187175,0.22544,8
5930,80000,0,3,2,25,0,0,0,-1,0,0,78230,76277,36232,30200,30326,30290,2289,1005,31063,1094,1109,1013,0,75941,75272,5169,29106,29217,29277,0.9492625,0.9409,0.0646125,0.363825,0.3652125,0.3659625,-1
5931,160000,1,2,2,29,2,2,-1,-1,-1,-1,1989,-8,866,0,892,0,0,874,0,892,0,594,0,1989,-882,866,-892,892,-594,0.01243125,-0.0055125,0.0054125,-0.005575,0.005575,-0.0037125,0
5932,190000,1,1,2,26,2,0,0,0,0,0,204297,106428,109736,111487,114878,118541,6355,6500,5000,5117,5644,4767,0,197942,99928,104736,106370,109234,113774,1.0418,0.5259368421052631,0.5512421052631579,0.5598421052631579,0.5749157894736842,0.5988105263157895,2
5933,20000,0,2,2,55,0,0,0,0,0,2,7357,8270,9301,10440,11193,10575,1290,1321,1460,1213,1,357,0,6067,6949,7841,9227,11192,10218,0.30335,0.34745,0.39205,0.46135,0.5596,0.5109,2
5934,160000,1,1,2,25,-1,0,-1,-1,0,0,6087,1934,11376,2199,10856,0,1000,11426,2199,10000,0,9867,0,5087,-9492,9177,-7801,10856,-9867,0.03179375,-0.059325,0.05735625,-0.04875625,0.06785,-0.06166875,-3
5935,180000,0,3,2,40,0,0,0,0,0,-1,66218,15155,11052,8541,37951,57757,1811,5008,5000,30000,62010,50077,0,64407,10147,6052,-21459,-24059,7680,0.35781666666666667,0.05637222222222222,0.03362222222222222,-0.11921666666666667,-0.13366111111111112,0.042666666666666665,-1
5936,130000,0,3,2,39,1,2,2,2,2,2,71034,69329,74175,72383,77217,75820,0,6000,0,6000,0,6000,0,71034,63329,74175,66383,77217,69820,0.5464153846153846,0.48714615384615384,0.5705769230769231,0.5106384615384615,0.5939769230769231,0.5370769230769231,11
5937,110000,0,2,2,38,3,2,2,0,0,0,78480,80604,78326,44890,41394,42727,4000,0,2000,1500,2000,2000,0,74480,80604,76326,43390,39394,40727,0.6770909090909091,0.7327636363636364,0.6938727272727273,0.39445454545454545,0.35812727272727274,0.37024545454545454,7
5938,200000,1,1,2,47,-2,-1,-1,-1,0,-1,23905,10163,20426,15592,12541,8667,12020,21008,16026,60,8667,18500,0,11885,-10845,4400,15532,3874,-9833,0.059425,-0.054225,0.022,0.07766,0.01937,-0.049165,-6
5939,120000,1,2,2,40,1,-2,-2,-2,-2,-2,-200,-200,-200,-200,0,8360,0,0,0,200,8360,0,0,-200,-200,-200,-400,-8360,8360,-0.0016666666666666668,-0.0016666666666666668,-0.0016666666666666668,-0.0033333333333333335,-0.06966666666666667,0.06966666666666667,-9
5940,50000,1,3,1,37,-1,-1,0,0,0,0,389,25352,25998,26579,26710,26871,25742,1435,1406,927,952,966,1,-25353,23917,24592,25652,25758,25905,-0.50706,0.47834,0.49184,0.51304,0.51516,0.5181,-2
5941,20000,1,2,2,27,0,0,0,0,0,0,15703,17140,18127,18605,16351,16928,2000,1600,1030,1000,1000,1000,0,13703,15540,17097,17605,15351,15928,0.68515,0.777,0.85485,0.88025,0.76755,0.7964,0
5942,20000,0,2,1,37,0,0,0,0,-1,-1,6372,2818,3734,3826,2110,2054,1100,1000,500,2110,2054,2505,1,5272,1818,3234,1716,56,-451,0.2636,0.0909,0.1617,0.0858,0.0028,-0.02255,-2
5943,230000,1,1,2,37,-2,-2,-2,-2,-2,-2,2283,50815,0,0,299,338,51315,0,0,299,338,0,0,-49032,50815,0,-299,-39,338,-0.21318260869565217,0.22093478260869565,0.0,-0.0013,-0.00016956521739130436,0.0014695652173913043,-12
5944,200000,0,1,1,40,-2,-2,-2,-2,-2,-2,15596,1470,7289,0,0,2376,1470,7289,0,0,2376,0,1,14126,-5819,7289,0,-2376,2376,0.07063,-0.029095,0.036445,0.0,-0.01188,0.01188,-12
5945,400000,1,1,2,47,-2,-2,-2,-2,-2,-2,6573,8155,11724,10570,15120,11453,8195,11755,10617,15189,11495,18506,0,-1622,-3600,1107,-4619,3625,-7053,-0.004055,-0.009,0.0027675,-0.0115475,0.0090625,-0.0176325,-12
5946,30000,1,2,2,38,1,-2,-2,-1,2,2,0,0,0,239,89,589,0,0,239,0,500,0,0,0,0,-239,239,-411,589,0.0,0.0,-0.007966666666666667,0.007966666666666667,-0.0137,0.019633333333333332,0
5947,140000,1,2,1,42,0,0,0,0,0,0,158495,160681,144194,144802,147311,150207,5530,6600,5100,5460,5460,5100,1,152965,154081,139094,139342,141851,145107,1.0926071428571429,1.1005785714285714,0.9935285714285714,0.9953,1.0132214285714285,1.0364785714285714,0
5948,400000,0,1,2,29,0,-1,0,0,0,0,1123,82556,67823,61918,61884,61911,82694,1939,1720,1712,1766,1907,0,-81571,80617,66103,60206,60118,60004,-0.2039275,0.2015425,0.1652575,0.150515,0.150295,0.15001,-1
5949,340000,1,1,2,35,-1,-1,-1,-1,-1,-1,317,3074,3002,2613,1806,1989,3074,3002,2613,1806,1989,3370,0,-2757,72,389,807,-183,-1381,-0.008108823529411766,0.00021176470588235295,0.0011441176470588235,0.0023735294117647058,-0.0005382352941176471,-0.004061764705882353,-6
5950,200000,1,3,1,28,-1,-1,2,-1,0,-1,188,2791,188,376,188,6884,2791,0,376,0,6884,4187,1,-2603,2791,-188,376,-6696,2697,-0.013015,0.013955,-0.00094,0.00188,-0.03348,0.013485,-2
5951,250000,1,2,1,52,-2,-2,-2,-2,-2,-1,1376,4038,313,316,657,993,4038,313,316,657,993,3039,1,-2662,3725,-3,-341,-336,-2046,-0.010648,0.0149,-1.2e-05,-0.001364,-0.001344,-0.008184,-11
5952,30000,1,3,3,26,1,2,0,0,0,0,30698,29034,28317,27872,28456,28230,0,1442,986,1021,1015,1143,0,30698,27592,27331,26851,27441,27087,1.0232666666666668,0.9197333333333333,0.9110333333333334,0.8950333333333333,0.9147,0.9029,3
5953,60000,1,1,2,25,2,2,0,0,0,0,37287,36412,37280,35321,36099,36724,0,1800,1414,1500,1377,1402,0,37287,34612,35866,33821,34722,35322,0.62145,0.5768666666666666,0.5977666666666667,0.5636833333333333,0.5787,0.5887,4
5954,330000,1,2,1,43,1,-1,-1,-2,-2,-2,-58,22301,0,0,0,0,22359,5895,0,0,0,0,1,-22417,16406,0,0,0,0,-0.06793030303030304,0.04971515151515152,0.0,0.0,0.0,0.0,-7
5955,150000,1,1,1,39,-1,-1,-1,-1,-1,-1,10147,0,1351,2942,384,504,0,1351,2942,384,504,280,1,10147,-1351,-1591,2558,-120,224,0.06764666666666666,-0.009006666666666666,-0.010606666666666667,0.017053333333333334,-0.0008,0.0014933333333333333,-6
5956,290000,0,2,2,28,0,0,0,0,0,0,240745,216678,205930,209010,213471,217561,9323,9000,8000,8000,7800,8238,0,231422,207678,197930,201010,205671,209323,0.7980068965517242,0.7161310344827586,0.6825172413793104,0.6931379310344827,0.7092103448275862,0.7218034482758621,0
5957,310000,1,1,2,28,0,0,0,-1,-1,-1,37085,23506,12191,13775,12377,34458,3817,1000,13775,12377,34458,1269,0,33268,22506,-1584,1398,-22081,33189,0.10731612903225807,0.0726,-0.005109677419354839,0.004509677419354838,-0.07122903225806451,0.10706129032258065,-3
5958,360000,1,2,1,49,0,0,-1,-1,-2,-2,13219,8644,454,-2,-2,-2,3050,456,0,0,0,519,1,10169,8188,454,-2,-2,-521,0.028247222222222222,0.022744444444444446,0.001261111111111111,-5.555555555555556e-06,-5.555555555555556e-06,-0.0014472222222222221,-6
5959,290000,0,1,2,40,0,0,0,0,0,0,135527,134414,140607,131933,135606,132906,8000,10000,5000,6000,4700,5000,0,127527,124414,135607,125933,130906,127906,0.43974827586206894,0.4290137931034483,0.46761034482758623,0.43425172413793106,0.4514,0.4410551724137931,0
5960,400000,1,1,2,31,-1,-1,-1,0,0,0,5974,2600,110958,164959,130737,128312,2600,110958,110000,20000,58312,9031,0,3374,-108358,958,144959,72425,119281,0.008435,-0.270895,0.002395,0.3623975,0.1810625,0.2982025,-3
5961,160000,1,2,1,49,-1,-1,2,0,0,2,16982,21353,20723,21873,25999,26377,4980,0,1500,4520,939,0,1,12002,21353,19223,17353,25060,26377,0.0750125,0.13345625,0.12014375,0.10845625,0.156625,0.16485625,2
5962,110000,0,2,2,40,0,0,0,0,0,0,109191,110937,108869,43207,42954,43839,5000,3814,2000,1600,1600,1600,0,104191,107123,106869,41607,41354,42239,0.9471909090909091,0.9738454545454546,0.9715363636363636,0.37824545454545455,0.3759454545454545,0.3839909090909091,0
5963,210000,1,2,1,44,-2,-2,-2,-2,-2,-2,0,4098,0,0,0,0,4098,0,0,0,0,0,1,-4098,4098,0,0,0,0,-0.019514285714285713,0.019514285714285713,0.0,0.0,0.0,0.0,-12
5964,50000,1,2,2,53,0,0,0,0,0,0,51320,50602,50095,34120,33235,32377,1952,1979,1495,1144,1165,946,0,49368,48623,48600,32976,32070,31431,0.98736,0.97246,0.972,0.65952,0.6414,0.62862,0
5965,150000,1,2,2,26,-1,-1,0,0,-1,-1,242,3180,4900,5207,5313,6340,3180,1747,1000,9119,1027,4,0,-2938,1433,3900,-3912,4286,6336,-0.019586666666666665,0.009553333333333334,0.026,-0.02608,0.028573333333333333,0.04224,-4
5966,40000,1,2,1,25,0,0,0,0,0,2,40633,40633,40311,39380,41389,40628,1950,4300,2000,2938,0,3700,1,38683,36333,38311,36442,41389,36928,0.967075,0.908325,0.957775,0.91105,1.034725,0.9232,2
5967,10000,0,2,2,54,0,0,0,2,2,0,3697,5186,8225,8244,7963,8134,1561,3300,300,0,299,2000,0,2136,1886,7925,8244,7664,6134,0.2136,0.1886,0.7925,0.8244,0.7664,0.6134,4
5968,50000,1,2,2,25,0,0,0,0,0,0,49173,50141,96860,48803,19324,19668,1800,2100,2600,1000,1000,1000,0,47373,48041,94260,47803,18324,18668,0.94746,0.96082,1.8852,0.95606,0.36648,0.37336,0
5969,80000,1,3,2,38,0,0,0,0,0,0,77929,77711,74525,61360,49359,48253,3006,2747,2344,1756,1758,1717,0,74923,74964,72181,59604,47601,46536,0.9365375,0.93705,0.9022625,0.74505,0.5950125,0.5817,0
5970,300000,0,1,2,32,2,0,0,0,0,0,255299,255607,258394,261024,260672,263894,9106,11000,11009,10000,10000,10000,0,246193,244607,247385,251024,250672,253894,0.8206433333333333,0.8153566666666666,0.8246166666666667,0.8367466666666666,0.8355733333333333,0.8463133333333334,2
5971,500000,0,2,1,38,-1,-1,-1,-1,0,-1,6178,825,2122,34159,3340,24752,829,2133,34313,17,24875,839,1,5349,-1308,-32191,34142,-21535,23913,0.010698,-0.002616,-0.064382,0.068284,-0.04307,0.047826,-5
5972,200000,0,3,1,44,2,0,0,0,0,0,147817,121668,67240,69798,72243,75277,11000,11000,5000,5000,5000,3000,1,136817,110668,62240,64798,67243,72277,0.684085,0.55334,0.3112,0.32399,0.336215,0.361385,2
5973,160000,1,1,2,36,1,-2,-2,-2,-2,-1,0,0,0,0,0,300,0,0,0,0,300,0,0,0,0,0,0,-300,300,0.0,0.0,0.0,0.0,-0.001875,0.001875,-8
5974,60000,1,2,2,24,1,2,0,0,0,0,60425,57786,55272,55925,57063,48228,28,2500,2000,2030,2100,3500,0,60397,55286,53272,53895,54963,44728,1.0066166666666667,0.9214333333333333,0.8878666666666667,0.89825,0.91605,0.7454666666666667,3
5975,80000,1,1,1,33,0,0,0,0,0,0,65484,66798,68120,70088,71345,72314,3000,3000,3109,3000,3000,3000,1,62484,63798,65011,67088,68345,69314,0.78105,0.797475,0.8126375,0.8386,0.8543125,0.866425,0
5976,60000,0,2,2,49,0,0,0,0,0,0,81411,52017,35423,24023,20175,16137,38709,1609,661,656,1000,5000,0,42702,50408,34762,23367,19175,11137,0.7117,0.8401333333333333,0.5793666666666667,0.38945,0.31958333333333333,0.18561666666666668,0
5977,50000,0,2,2,43,0,0,0,-2,-2,-2,34110,3552,0,0,0,0,3505,0,0,0,0,0,0,30605,3552,0,0,0,0,0.6121,0.07104,0.0,0.0,0.0,0.0,-6
5978,280000,1,2,1,26,0,-1,-1,-1,-1,-1,6056,804,4712,1728,2076,1709,1200,4720,1728,2076,1709,7508,1,4856,-3916,2984,-348,367,-5799,0.017342857142857142,-0.013985714285714285,0.010657142857142856,-0.0012428571428571428,0.0013107142857142857,-0.020710714285714287,-5
5979,50000,0,2,1,64,0,0,0,0,0,-1,48369,44762,17403,17907,19000,18055,2384,5461,2872,1093,19055,2239,1,45985,39301,14531,16814,-55,15816,0.9197,0.78602,0.29062,0.33628,-0.0011,0.31632,-1
5980,50000,1,1,2,26,0,0,0,0,0,0,48338,48283,40989,26695,18884,20131,3008,2024,3000,1000,5000,1500,0,45330,46259,37989,25695,13884,18631,0.9066,0.92518,0.75978,0.5139,0.27768,0.37262,0
5981,280000,1,2,1,43,2,-1,-1,-1,-1,-1,644,499,1641,5280,6913,-741,499,1641,5280,6915,0,0,1,145,-1142,-3639,-1635,6913,-741,0.0005178571428571428,-0.004078571428571429,-0.012996428571428572,-0.005839285714285714,0.024689285714285716,-0.0026464285714285713,-3
5982,20000,0,3,1,34,0,0,0,0,0,0,17692,17293,16803,16525,16185,-2623,2000,2004,1500,1500,0,19500,1,15692,15289,15303,15025,16185,-22123,0.7846,0.76445,0.76515,0.75125,0.80925,-1.10615,0
5983,10000,1,1,2,24,0,0,0,0,0,0,6709,7895,8751,8925,9111,9360,1300,1146,320,330,400,1000,0,5409,6749,8431,8595,8711,8360,0.5409,0.6749,0.8431,0.8595,0.8711,0.836,0
5984,210000,1,2,1,33,-1,-1,-1,-2,-2,-2,1971,748,0,0,0,0,822,0,0,0,0,0,1,1149,748,0,0,0,0,0.0054714285714285715,0.003561904761904762,0.0,0.0,0.0,0.0,-9
5985,80000,1,2,2,31,1,2,0,0,2,2,54207,52775,53906,60099,61402,60272,0,2000,7100,2400,0,4600,0,54207,50775,46806,57699,61402,55672,0.6775875,0.6346875,0.585075,0.7212375,0.767525,0.6959,7
5986,30000,0,2,2,24,-2,-2,-2,-2,-2,-2,0,0,0,0,0,0,0,0,0,0,0,0,0,0,0,0,0,0,0,0.0,0.0,0.0,0.0,0.0,0.0,-12
5987,390000,0,1,1,36,-2,-2,-2,-2,-1,-1,3931,3625,1600,3815,8330,4765,3625,1600,3315,11645,4765,2171,1,306,2025,-1715,-7830,3565,2594,0.0007846153846153846,0.005192307692307692,-0.004397435897435897,-0.020076923076923076,0.009141025641025641,0.006651282051282051,-10
5988,50000,1,2,2,23,-1,0,0,0,0,0,48570,48599,49124,48930,50316,62794,1773,2246,2000,3000,1725,6120,0,46797,46353,47124,45930,48591,56674,0.93594,0.92706,0.94248,0.9186,0.97182,1.13348,-1
5989,100000,0,2,1,46,0,0,-1,-1,-1,-2,60799,10095,1494,2200,0,0,2036,1504,2506,0,0,0,1,58763,8591,-1012,2200,0,0,0.58763,0.08591,-0.01012,0.022,0.0,0.0,-5
5990,430000,1,1,2,30,-1,-1,-1,-1,-1,-1,31423,3650,44671,81979,9120,85407,3650,44671,82555,9120,85407,14261,0,27773,-41021,-37884,72859,-76287,71146,0.06458837209302326,-0.09539767441860465,-0.08810232558139534,0.16943953488372093,-0.17741162790697673,0.16545581395348838,-6
5991,200000,0,2,1,33,0,0,-2,-2,-2,-2,205150,0,0,0,0,0,0,0,0,0,0,0,1,205150,0,0,0,0,0,1.02575,0.0,0.0,0.0,0.0,0.0,-8
5992,30000,0,1,1,35,1,2,2,2,-1,0,18829,19223,20599,15642,23789,20562,1000,2014,6,25700,800,1989,1,17829,17209,20593,-10058,22989,18573,0.5943,0.5736333333333333,0.6864333333333333,-0.33526666666666666,0.7663,0.6191,6
5993,500000,0,1,1,55,0,-1,0,0,0,0,16593,226145,216931,207423,197914,188329,226145,7815,7372,7113,6967,6261,1,-209552,218330,209559,200310,190947,182068,-0.419104,0.43666,0.419118,0.40062,0.381894,0.364136,-1
5994,420000,0,1,2,35,0,0,0,0,0,0,168182,163177,149406,136292,128344,120582,15000,6000,5000,10000,10000,10000,0,153182,157177,144406,126292,118344,110582,0.3647190476190476,0.3742309523809524,0.34382380952380953,0.30069523809523807,0.28177142857142856,0.2632904761904762,0
5995,310000,1,2,1,42,0,-1,-1,2,-1,-1,21692,19697,17257,7900,17161,14585,19697,2270,4,17161,7030,0,1,1995,17427,17253,-9261,10131,14585,0.006435483870967742,0.05621612903225807,0.05565483870967742,-0.029874193548387096,0.03268064516129032,0.0470483870967742,-2
5996,130000,0,2,2,33,2,2,2,-1,-1,-2,1183,2183,2000,700,0,0,2000,13,700,0,0,0,0,-817,2170,1300,700,0,0,-0.006284615384615385,0.016692307692307694,0.01,0.005384615384615384,0.0,0.0,2
5997,30000,0,1,2,24,-1,2,0,0,3,2,18199,17618,18631,21319,20692,21201,0,1312,3000,0,1000,1000,0,18199,16306,15631,21319,19692,20201,0.6066333333333334,0.5435333333333333,0.5210333333333333,0.7106333333333333,0.6564,0.6733666666666667,6
5998,80000,1,2,2,27,0,0,0,-1,0,0,36406,31472,10246,20202,20077,20247,2000,5056,20202,726,891,10000,0,34406,26416,-9956,19476,19186,10247,0.430075,0.3302,-0.12445,0.24345,0.239825,0.1280875,-1
5999,80000,1,3,1,53,-1,2,-1,-1,-1,-1,780,390,390,390,390,1320,0,390,390,390,1320,0,1,780,0,0,0,-930,1320,0.00975,0.0,0.0,0.0,-0.011625,0.0165,-3
6000,170000,0,2,1,37,-2,-2,-2,-2,-2,-2,5635,6321,102108,2120,2873,0,6321,102108,2120,2873,0,870,1,-686,-95787,99988,-753,2873,-870,-0.004035294117647059,-0.5634529411764706,0.5881647058823529,-0.004429411764705882,0.0169,-0.00511764705882353,-12
6001,50000,1,2,2,31,2,0,0,2,2,2,28133,29461,32067,31252,32633,33965,1800,3400,0,1900,2000,0,0,26333,26061,32067,29352,30633,33965,0.52666,0.52122,0.64134,0.58704,0.61266,0.6793,8
6002,100000,1,2,1,44,0,-1,-1,-1,-1,-1,1603,1440,1440,1440,1440,6059,1440,1440,1440,1440,6059,1440,1,163,0,0,0,-4619,4619,0.00163,0.0,0.0,0.0,-0.04619,0.04619,-5
6003,80000,1,2,2,28,-2,-2,-2,-2,-2,-2,0,0,641,658,2019,0,0,641,658,2019,0,0,0,0,-641,-17,-1361,2019,0,0.0,-0.0080125,-0.0002125,-0.0170125,0.0252375,0.0,-12
6004,450000,0,1,2,31,-1,-1,-1,-1,-2,-2,5000,5000,5000,0,0,0,5000,5000,0,0,0,0,0,0,0,5000,0,0,0,0.0,0.0,0.011111111111111112,0.0,0.0,0.0,-8
6005,130000,1,1,2,25,-1,-1,-1,-1,-1,-1,1088,1521,6042,1085,947,495,1521,6044,1619,947,495,0,0,-433,-4523,4423,138,452,495,-0.003330769230769231,-0.03479230769230769,0.03402307692307692,0.0010615384615384616,0.003476923076923077,0.0038076923076923075,-6
6006,200000,1,1,1,33,-2,-2,-1,0,0,-1,0,225,5628,5540,16378,4850,225,5628,23,16378,4850,2255,1,-225,-5403,5605,-10838,11528,2595,-0.001125,-0.027015,0.028025,-0.05419,0.05764,0.012975,-6
6007,360000,0,1,1,33,0,0,0,0,0,0,21936,35331,30580,34985,39585,49735,14000,5000,5000,5000,10150,60000,1,7936,30331,25580,29985,29435,-10265,0.022044444444444443,0.08425277777777777,0.07105555555555555,0.08329166666666667,0.08176388888888889,-0.028513888888888887,0
6008,300000,1,2,1,31,-1,-1,-1,-1,-1,-1,3863,4242,5090,309,2700,7593,5021,5134,322,5013,7611,8059,1,-1158,-892,4768,-4704,-4911,-466,-0.00386,-0.0029733333333333335,0.015893333333333332,-0.01568,-0.01637,-0.0015533333333333334,-6
6009,410000,0,2,2,48,0,0,0,-1,-1,0,28921,13482,8484,15286,17116,18777,5422,3040,15362,17133,5076,4040,0,23499,10442,-6878,-1847,12040,14737,0.05731463414634146,0.02546829268292683,-0.01677560975609756,-0.004504878048780488,0.029365853658536584,0.03594390243902439,-2
6010,150000,0,3,1,27,2,2,2,2,0,0,183405,188959,192342,189717,195670,198611,10000,8000,2000,9000,8000,110000,1,173405,180959,190342,180717,187670,88611,1.1560333333333332,1.2063933333333334,1.2689466666666667,1.20478,1.2511333333333334,0.59074,8
6011,180000,1,2,2,25,0,0,0,2,0,0,169225,172888,182533,176099,178391,181986,7800,14010,4,6431,6600,6675,0,161425,158878,182529,169668,171791,175311,0.8968055555555555,0.8826555555555555,1.01405,0.9426,0.9543944444444444,0.97395,2
6012,500000,1,1,2,39,1,-2,-2,-2,-2,-2,0,0,0,0,0,0,0,0,0,0,0,0,0,0,0,0,0,0,0,0.0,0.0,0.0,0.0,0.0,0.0,-9
6013,160000,0,1,2,53,2,2,-1,-1,-2,-1,1309,0,4582,0,0,2191,0,4582,0,0,2191,4825,0,1309,-4582,4582,0,-2191,-2634,0.00818125,-0.0286375,0.0286375,0.0,-0.01369375,-0.0164625,-1
6014,20000,0,2,2,24,2,0,0,0,0,0,16794,17496,18981,19608,19600,20000,1288,1773,1400,392,400,0,0,15506,15723,17581,19216,19200,20000,0.7753,0.78615,0.87905,0.9608,0.96,1.0,2
6015,330000,1,2,2,41,0,0,0,0,0,0,76279,79179,82293,86458,91512,100433,4179,5000,6458,6512,10433,5442,0,72100,74179,75835,79946,81079,94991,0.21848484848484848,0.22478484848484848,0.22980303030303031,0.24226060606060607,0.24569393939393938,0.28785151515151514,0
6016,180000,1,1,2,29,1,-2,-2,-2,-2,-2,0,0,0,0,0,0,0,0,0,0,0,0,0,0,0,0,0,0,0,0.0,0.0,0.0,0.0,0.0,0.0,-9
6017,230000,1,3,1,50,-2,-2,-2,-2,-2,-2,2789,2942,2520,2936,3493,3160,2942,2520,2936,3493,3160,2784,1,-153,422,-416,-557,333,376,-0.0006652173913043478,0.0018347826086956521,-0.001808695652173913,-0.0024217391304347828,0.0014478260869565218,0.0016347826086956522,-12
6018,240000,1,1,1,54,0,0,0,0,2,0,60381,64395,66323,70422,69170,71018,5000,3000,5200,0,3000,5400,1,55381,61395,61123,70422,66170,65618,0.23075416666666668,0.2558125,0.2546791666666667,0.293425,0.27570833333333333,0.2734083333333333,2
6019,230000,0,2,1,35,0,0,0,0,0,-1,176853,180639,180117,179717,124117,182717,10000,5000,0,5000,189600,10000,1,166853,175639,180117,174717,-65483,172717,0.7254478260869566,0.7636478260869565,0.7831173913043479,0.7596391304347826,-0.28470869565217394,0.7509434782608696,-1
6020,80000,0,1,2,25,0,0,0,0,0,0,42444,55744,43476,41087,41951,31826,30000,3000,6000,8000,2000,14000,0,12444,52744,37476,33087,39951,17826,0.15555,0.6593,0.46845,0.4135875,0.4993875,0.222825,0
6021,20000,0,2,2,23,0,0,0,0,0,0,9550,10867,11585,12899,13087,13327,1480,1198,1512,700,600,2700,0,8070,9669,10073,12199,12487,10627,0.4035,0.48345,0.50365,0.60995,0.62435,0.53135,0
6022,200000,1,2,2,26,0,0,0,0,0,0,26179,26643,23524,23788,26089,25908,4022,3000,3000,4092,1000,3000,0,22157,23643,20524,19696,25089,22908,0.110785,0.118215,0.10262,0.09848,0.125445,0.11454,0
6023,50000,1,2,2,56,0,0,-1,0,0,-1,30121,31295,19100,18900,0,3900,2295,19100,0,0,3900,0,0,27826,12195,19100,18900,-3900,3900,0.55652,0.2439,0.382,0.378,-0.078,0.078,-2
6024,80000,0,2,2,26,1,2,0,0,0,-1,27897,24833,23331,21964,19664,2544,0,1527,1500,540,2544,2789,0,27897,23306,21831,21424,17120,-245,0.3487125,0.291325,0.2728875,0.2678,0.214,-0.0030625,2
6025,290000,1,2,1,49,-2,-2,-1,2,0,0,-236,-236,11764,11186,6863,6179,0,12000,0,0,0,0,1,-236,-12236,11764,11186,6863,6179,-0.0008137931034482758,-0.042193103448275864,0.04056551724137931,0.03857241379310345,0.02366551724137931,0.021306896551724137,-3
6026,400000,1,1,1,42,-1,2,-1,-1,-1,-1,80,80,3710,33605,47029,39400,0,3828,33627,47029,40000,0,1,80,-3748,-29917,-13424,7029,39400,0.0002,-0.00937,-0.0747925,-0.03356,0.0175725,0.0985,-3
6027,200000,1,1,2,33,0,0,0,0,0,0,19572,28858,52512,71923,19923,-77,10000,25000,20400,0,0,77,0,9572,3858,32112,71923,19923,-154,0.04786,0.01929,0.16056,0.359615,0.099615,-0.00077,0
6028,30000,1,2,1,24,0,0,0,2,2,0,26755,27828,29103,29565,26319,27738,1507,2172,1523,0,2000,2000,1,25248,25656,27580,29565,24319,25738,0.8416,0.8552,0.9193333333333333,0.9855,0.8106333333333333,0.8579333333333333,4
6029,20000,1,2,1,24,0,0,0,0,-1,0,17599,18920,19000,0,80,540,1920,1000,0,40,1000,844,1,15679,17920,19000,-40,-920,-304,0.78395,0.896,0.95,-0.002,-0.046,-0.0152,-1
6030,450000,1,1,1,40,-2,-2,-2,-2,-2,-2,5512,19420,1473,560,0,0,19428,1473,560,0,0,1128,1,-13916,17947,913,560,0,-1128,-0.030924444444444445,0.03988222222222222,0.002028888888888889,0.0012444444444444445,0.0,-0.0025066666666666666,-12
6031,10000,1,2,1,49,0,0,0,0,0,0,8671,6613,7648,8758,9410,4373,1265,1300,1400,1000,304,283,1,7406,5313,6248,7758,9106,4090,0.7406,0.5313,0.6248,0.7758,0.9106,0.409,0
6032,30000,1,3,2,40,-1,0,0,-1,2,2,2208,7808,0,196,46,5346,7006,0,196,0,5300,0,0,-4798,7808,-196,196,-5254,5346,-0.15993333333333334,0.26026666666666665,-0.006533333333333334,0.006533333333333334,-0.17513333333333334,0.1782,2
6033,370000,1,2,1,44,-2,-2,-2,-2,-2,-2,0,1742,0,0,0,0,1742,0,0,0,0,0,1,-1742,1742,0,0,0,0,-0.004708108108108108,0.004708108108108108,0.0,0.0,0.0,0.0,-12
6034,80000,1,3,2,24,2,0,0,0,0,0,58850,59867,47925,23642,21707,20544,2700,4500,1000,933,5000,500,0,56150,55367,46925,22709,16707,20044,0.701875,0.6920875,0.5865625,0.2838625,0.2088375,0.25055,2
6035,180000,1,1,1,36,-2,-2,-2,-2,-2,-2,2846,2092,4629,3007,5827,1118,2092,4631,3007,5827,1200,1030,1,754,-2539,1622,-2820,4627,88,0.004188888888888889,-0.014105555555555555,0.00901111111111111,-0.015666666666666666,0.025705555555555554,0.0004888888888888889,-12
6036,280000,1,1,1,36,0,0,0,0,0,0,58983,60788,63225,29701,30172,30771,2755,3463,1300,1100,1100,2000,1,56228,57325,61925,28601,29072,28771,0.20081428571428572,0.20473214285714286,0.2211607142857143,0.10214642857142857,0.10382857142857142,0.10275357142857143,0
6037,360000,1,1,2,36,1,-1,-1,-1,-1,-1,-8,2379,0,11850,150,459,2387,0,11850,300,459,52,0,-2395,2379,-11850,11550,-309,407,-0.006652777777777777,0.006608333333333333,-0.032916666666666664,0.03208333333333333,-0.0008583333333333333,0.0011305555555555557,-4
6038,50000,0,2,2,25,0,0,0,0,0,0,24724,25895,23627,24827,25521,26523,2000,2000,2000,1500,2000,2000,0,22724,23895,21627,23327,23521,24523,0.45448,0.4779,0.43254,0.46654,0.47042,0.49046,0
6039,490000,0,2,1,51,1,-2,-1,2,0,0,-16,-16,5498,282,28688,26302,0,7504,0,28606,0,2499,1,-16,-7520,5498,-28324,28688,23803,-3.265306122448979e-05,-0.015346938775510204,0.011220408163265307,-0.05780408163265306,0.058546938775510204,0.048577551020408165,0
6040,220000,1,3,2,34,-2,-2,-2,-2,-1,0,99518,-482,-482,-482,18,4834,937,0,0,500,4816,3000,0,98581,-482,-482,-982,-4798,1834,0.4480954545454545,-0.002190909090909091,-0.002190909090909091,-0.004463636363636364,-0.02180909090909091,0.008336363636363637,-9
6041,600000,1,1,2,31,-2,-2,-2,-2,-2,-2,-84,115,349,-9,-9,-9,700,349,9,0,0,0,0,-784,-234,340,-9,-9,-9,-0.0013066666666666667,-0.00039,0.0005666666666666667,-1.5e-05,-1.5e-05,-1.5e-05,-12
6042,100000,1,1,2,29,0,0,0,-1,0,0,85268,65279,33077,43593,40782,37949,5000,5024,43593,1700,1500,1500,0,80268,60255,-10516,41893,39282,36449,0.80268,0.60255,-0.10516,0.41893,0.39282,0.36449,-1
6043,160000,1,2,1,51,0,0,0,2,0,0,67610,69908,78087,75255,78593,59816,4000,10000,0,5000,3000,3000,1,63610,59908,78087,70255,75593,56816,0.3975625,0.374425,0.48804375,0.43909375,0.47245625,0.3551,2
6044,500000,0,3,1,52,-1,-1,-1,-1,-1,-1,30561,38207,18008,29158,11484,103340,38219,18008,29248,11484,103340,28524,1,-7658,20199,-11240,17674,-91856,74816,-0.015316,0.040398,-0.02248,0.035348,-0.183712,0.149632,-6
6045,40000,0,2,1,25,0,0,0,0,0,2,37540,38611,39508,38674,38410,37661,1976,1873,1300,2824,0,2000,1,35564,36738,38208,35850,38410,35661,0.8891,0.91845,0.9552,0.89625,0.96025,0.891525,2
6046,70000,1,2,2,23,0,0,0,0,0,0,64882,63824,63352,28085,28487,27006,2782,2700,1732,1134,1128,1003,0,62100,61124,61620,26951,27359,26003,0.8871428571428571,0.8732,0.8802857142857143,0.3850142857142857,0.39084285714285716,0.37147142857142856,0
6047,320000,0,2,2,28,0,0,0,0,0,-1,11639,7508,5591,2371,4754,4932,2552,2016,0,12,5036,10306,0,9087,5492,5591,2359,-282,-5374,0.028396875,0.0171625,0.017471875,0.007371875,-0.00088125,-0.01679375,-1
6048,250000,0,1,1,51,2,2,2,2,2,2,2487,2487,2487,2487,2487,2487,0,0,0,0,0,0,1,2487,2487,2487,2487,2487,2487,0.009948,0.009948,0.009948,0.009948,0.009948,0.009948,12
6049,210000,1,2,1,36,-1,0,0,0,0,0,47718,233289,227143,221126,215358,163444,199000,7613,7116,6980,5813,5762,1,-151282,225676,220027,214146,209545,157682,-0.7203904761904761,1.074647619047619,1.0477476190476191,1.019742857142857,0.9978333333333333,0.7508666666666667,-1
6050,410000,1,1,2,28,0,0,0,0,-2,-1,210866,109320,11546,858,0,1117,2444,3056,968,0,1117,0,0,208422,106264,10578,858,-1117,1117,0.5083463414634146,0.25918048780487807,0.0258,0.0020926829268292685,-0.002724390243902439,0.002724390243902439,-3
6051,80000,1,2,1,51,1,-2,-2,-1,-1,-1,-12,-12,-12,17691,4599,4134,0,0,17703,4599,4134,0,1,-12,-12,-17715,13092,465,4134,-0.00015,-0.00015,-0.2214375,0.16365,0.0058125,0.051675,-6
6052,50000,1,3,1,30,-1,-1,-1,-1,-1,-1,1032,1464,1722,316,2615,2104,1464,1722,316,2615,2104,3379,1,-432,-258,1406,-2299,511,-1275,-0.00864,-0.00516,0.02812,-0.04598,0.01022,-0.0255,-6
6053,120000,0,1,2,31,0,0,0,0,0,0,64670,68574,71849,74974,83137,51377,5000,5000,5000,10000,5000,5000,0,59670,63574,66849,64974,78137,46377,0.49725,0.5297833333333334,0.557075,0.54145,0.6511416666666666,0.386475,0
6054,170000,1,3,1,54,0,0,0,0,0,0,139211,136982,130585,127013,126635,127093,7020,7005,7000,6000,6000,6000,1,132191,129977,123585,121013,120635,121093,0.7775941176470588,0.7645705882352941,0.7269705882352941,0.7118411764705882,0.7096176470588236,0.7123117647058823,0
6055,300000,0,3,1,32,-1,-1,-1,0,0,-1,590,2635,1461,3242,-80,720,2635,1461,2000,0,800,15,1,-2045,1174,-539,3242,-880,705,-0.006816666666666667,0.003913333333333333,-0.0017966666666666667,0.010806666666666666,-0.0029333333333333334,0.00235,-4
6056,220000,1,1,2,29,-2,-2,-2,-2,-2,-2,-37,5645,11731,-729,-5960,-5960,5682,11742,0,5231,0,0,0,-5719,-6097,11731,-5960,-5960,-5960,-0.025995454545454544,-0.027713636363636364,0.05332272727272727,-0.027090909090909093,-0.027090909090909093,-0.027090909090909093,-12
6057,100000,0,1,2,27,0,0,0,0,0,0,55734,52557,33415,28776,17580,6441,1631,1286,200,645,909,200,0,54103,51271,33215,28131,16671,6241,0.54103,0.51271,0.33215,0.28131,0.16671,0.06241,0
6058,330000,1,3,1,45,0,0,0,0,0,0,33369,34509,35406,34770,35468,36211,2000,1470,1374,1072,1113,2000,1,31369,33039,34032,33698,34355,34211,0.09505757575757576,0.10011818181818181,0.10312727272727273,0.10211515151515152,0.1041060606060606,0.10366969696969697,0
6059,200000,1,1,1,35,1,2,0,0,0,0,205002,195441,192803,304997,188504,189527,41,8597,8583,6880,7235,6839,1,204961,186844,184220,298117,181269,182688,1.024805,0.93422,0.9211,1.490585,0.906345,0.91344,3
6060,70000,1,2,2,34,0,0,0,0,0,0,62694,63995,66446,67786,69686,70500,1818,3000,1903,2458,1900,0,0,60876,60995,64543,65328,67786,70500,0.8696571428571429,0.8713571428571428,0.9220428571428572,0.9332571428571429,0.9683714285714285,1.0071428571428571,0
6061,360000,0,2,2,28,-1,-1,-1,-1,-1,-1,9780,6672,11201,9718,8781,11846,6712,11244,9747,8806,11872,19035,0,3068,-4572,1454,912,-3091,-7189,0.008522222222222223,-0.0127,0.004038888888888889,0.002533333333333333,-0.00858611111111111,-0.019969444444444446,-6
6062,70000,1,1,2,36,0,0,0,0,0,0,79640,75021,71101,73831,46898,48686,3000,2893,4231,8000,2500,1675,0,76640,72128,66870,65831,44398,47011,1.0948571428571428,1.0304,0.9552857142857143,0.9404428571428571,0.6342571428571429,0.6715857142857142,0
6063,30000,0,2,2,38,0,0,0,0,0,0,21697,22834,24459,25361,27011,27655,1500,2000,1350,2000,1000,1500,0,20197,20834,23109,23361,26011,26155,0.6732333333333334,0.6944666666666667,0.7703,0.7787,0.8670333333333333,0.8718333333333333,0
6064,50000,1,2,2,22,0,0,0,0,0,0,49609,61162,31485,15281,18031,18233,2100,2000,4000,3000,1500,1000,0,47509,59162,27485,12281,16531,17233,0.95018,1.18324,0.5497,0.24562,0.33062,0.34466,0
6065,210000,0,2,1,39,-1,-1,-1,-1,0,0,600,169,497,15433,8500,10500,169,497,15436,170,2000,2822,1,431,-328,-14939,15263,6500,7678,0.0020523809523809522,-0.001561904761904762,-0.07113809523809524,0.07268095238095239,0.030952380952380953,0.03656190476190476,-4
6066,160000,0,1,2,28,-1,-1,-1,0,0,-1,3236,-524,3003,737,0,894,0,3740,0,0,894,0,0,3236,-4264,3003,737,-894,894,0.020225,-0.02665,0.01876875,0.00460625,-0.0055875,0.0055875,-4
6067,150000,0,2,1,36,2,2,2,2,2,2,47529,40605,39394,37686,38810,31548,17,3105,2,2020,36,1048,1,47512,37500,39392,35666,38774,30500,0.3167466666666667,0.25,0.2626133333333333,0.23777333333333334,0.25849333333333335,0.20333333333333334,12
6068,300000,1,2,2,31,-1,0,0,0,0,0,10817,8785,10282,11797,15571,17303,2000,2000,2000,4000,2000,3000,0,8817,6785,8282,7797,13571,14303,0.02939,0.022616666666666667,0.027606666666666668,0.02599,0.04523666666666667,0.047676666666666666,-1
6069,280000,0,1,1,42,-2,-2,-2,-2,-2,-2,-26,-26,-26,-26,5294,-4,0,0,0,5320,0,919,1,-26,-26,-26,-5346,5294,-923,-9.285714285714286e-05,-9.285714285714286e-05,-9.285714285714286e-05,-0.019092857142857144,0.01890714285714286,-0.0032964285714285712,-12
6070,50000,0,2,3,52,0,0,0,0,0,0,49854,51215,50144,10683,9953,9567,2500,1500,1300,800,1000,1500,0,47354,49715,48844,9883,8953,8067,0.94708,0.9943,0.97688,0.19766,0.17906,0.16134,0
6071,20000,1,2,1,28,2,2,2,0,0,0,17023,18432,17848,19103,19229,18856,2000,0,1574,700,688,687,1,15023,18432,16274,18403,18541,18169,0.75115,0.9216,0.8137,0.92015,0.92705,0.90845,6
6072,470000,0,1,1,39,-1,0,0,0,0,0,79455,74993,48344,45433,45853,21158,2348,1542,1041,2019,789,5013,1,77107,73451,47303,43414,45064,16145,0.16405744680851064,0.15627872340425533,0.10064468085106383,0.09237021276595744,0.09588085106382979,0.03435106382978723,-1
6073,10000,1,1,2,29,-1,-1,-1,-1,-1,-1,1727,1508,3096,3400,4522,-240,1508,3098,3400,4522,0,1000,0,219,-1590,-304,-1122,4522,-1240,0.0219,-0.159,-0.0304,-0.1122,0.4522,-0.124,-6
6074,150000,1,3,2,28,2,0,0,0,0,0,107603,109835,110255,110247,110955,105145,5500,5500,5300,3853,4000,4000,0,102103,104335,104955,106394,106955,101145,0.6806866666666667,0.6955666666666667,0.6997,0.7092933333333333,0.7130333333333333,0.6743,2
6075,260000,0,1,2,27,0,0,0,0,0,0,256324,250666,245741,240132,234520,227149,10000,9000,10340,11500,8042,14000,0,246324,241666,235401,228632,226478,213149,0.9474,0.9294846153846154,0.9053884615384615,0.8793538461538462,0.8710692307692308,0.8198038461538462,0
6076,50000,0,3,2,46,0,0,0,0,0,0,48060,48923,48924,33778,19492,19582,2326,2000,1235,622,1000,1000,0,45734,46923,47689,33156,18492,18582,0.91468,0.93846,0.95378,0.66312,0.36984,0.37164,0
6077,340000,1,2,2,27,0,0,0,0,-1,0,59322,70886,81480,13580,22474,70590,20063,20385,6157,22533,60052,30059,0,39259,50501,75323,-8953,-37578,40531,0.11546764705882354,0.14853235294117648,0.22153823529411765,-0.02633235294117647,-0.1105235294117647,0.11920882352941177,-1
6078,80000,1,2,2,25,0,0,0,0,0,0,4418,7327,10190,13768,17748,10577,3000,3000,4000,5000,1000,1310,0,1418,4327,6190,8768,16748,9267,0.017725,0.0540875,0.077375,0.1096,0.20935,0.1158375,0
6079,100000,1,3,1,47,0,0,0,0,0,0,46104,47146,48162,48806,49910,51400,2086,2102,1746,1890,2400,0,1,44018,45044,46416,46916,47510,51400,0.44018,0.45044,0.46416,0.46916,0.4751,0.514,0
6080,20000,1,2,1,27,0,0,-1,-1,-2,-2,7286,2160,780,0,0,0,1006,780,0,0,0,0,1,6280,1380,780,0,0,0,0.314,0.069,0.039,0.0,0.0,0.0,-6
6081,500000,0,2,1,59,0,0,0,0,0,0,197792,201418,205895,212010,214287,218266,7200,8000,10010,7500,7266,6218,1,190592,193418,195885,204510,207021,212048,0.381184,0.386836,0.39177,0.40902,0.414042,0.424096,0
6082,100000,0,2,1,42,0,0,0,0,0,0,98430,99998,16138,17758,18774,20272,5000,2000,2000,2000,2000,2000,1,93430,97998,14138,15758,16774,18272,0.9343,0.97998,0.14138,0.15758,0.16774,0.18272,0
6083,170000,1,2,1,28,0,0,0,0,0,0,105509,106445,68703,66338,62135,65706,4285,3000,3000,3000,5000,3000,1,101224,103445,65703,63338,57135,62706,0.5954352941176471,0.6085,0.38648823529411763,0.3725764705882353,0.33608823529411763,0.36885882352941174,0
6084,220000,1,1,1,44,0,0,0,0,0,0,215191,215969,216849,214030,213678,190469,10000,10000,7000,6568,6000,5000,1,205191,205969,209849,207462,207678,185469,0.9326863636363636,0.9362227272727273,0.9538590909090909,0.9430090909090909,0.9439909090909091,0.8430409090909091,0
6085,200000,1,2,1,35,1,-2,-2,-2,-2,-2,0,0,0,0,0,0,0,0,0,0,0,2865,1,0,0,0,0,0,-2865,0.0,0.0,0.0,0.0,0.0,-0.014325,-9
6086,50000,1,2,1,41,0,0,0,0,0,0,21910,23251,24059,24658,25212,25642,2000,1500,1000,1100,1000,1000,1,19910,21751,23059,23558,24212,24642,0.3982,0.43502,0.46118,0.47116,0.48424,0.49284,0
6087,10000,1,2,2,27,2,0,0,0,0,0,6694,7546,8345,8688,8865,9046,1124,1207,1000,177,181,0,0,5570,6339,7345,8511,8684,9046,0.557,0.6339,0.7345,0.8511,0.8684,0.9046,2
6088,200000,0,1,2,29,0,0,0,0,0,0,45841,37221,34718,32148,25380,22701,4000,7000,7000,7000,7000,295,0,41841,30221,27718,25148,18380,22406,0.209205,0.151105,0.13859,0.12574,0.0919,0.11203,0
6089,150000,1,3,1,28,0,0,0,0,0,0,146325,140902,131798,115350,105770,111850,5125,10104,10017,4000,15000,8000,1,141200,130798,121781,111350,90770,103850,0.9413333333333334,0.8719866666666667,0.8118733333333333,0.7423333333333333,0.6051333333333333,0.6923333333333334,0
6090,410000,0,2,1,54,-1,-1,-1,2,-1,-1,1413,1701,6566,5206,986,986,1710,7064,430,990,990,990,1,-297,-5363,6136,4216,-4,-4,-0.000724390243902439,-0.01308048780487805,0.014965853658536586,0.010282926829268292,-9.75609756097561e-06,-9.75609756097561e-06,-3
6091,430000,0,2,2,42,0,0,0,0,0,0,59648,52811,45441,39174,28261,25411,2035,1587,1161,1943,995,606,0,57613,51224,44280,37231,27266,24805,0.13398372093023256,0.11912558139534883,0.1029767441860465,0.08658372093023256,0.0634093023255814,0.057686046511627904,0
6092,140000,1,1,2,23,0,-1,-1,-1,-1,0,1217,866,390,0,2601,179,866,390,0,2601,0,1326,0,351,476,390,-2601,2601,-1147,0.002507142857142857,0.0034,0.002785714285714286,-0.018578571428571427,0.018578571428571427,-0.008192857142857142,-4
6093,110000,0,3,2,49,0,0,0,0,0,0,113928,112775,110399,48532,44703,47869,4915,4379,12466,5000,5307,5000,0,109013,108396,97933,43532,39396,42869,0.9910272727272728,0.9854181818181819,0.8903,0.39574545454545457,0.35814545454545454,0.3897181818181818,0
6094,70000,0,2,2,25,0,0,0,0,0,0,23018,24044,25059,25559,26094,26612,1400,1415,915,947,952,986,0,21618,22629,24144,24612,25142,25626,0.30882857142857145,0.3232714285714286,0.34491428571428573,0.3516,0.3591714285714286,0.3660857142857143,0
6095,10000,1,1,1,23,0,0,0,0,0,0,7641,8557,9080,1410,9508,8997,1262,1000,1115,9329,331,1000,1,6379,7557,7965,-7919,9177,7997,0.6379,0.7557,0.7965,-0.7919,0.9177,0.7997,0
6096,40000,0,2,1,37,0,0,2,0,0,0,9608,12127,11647,13138,14903,17664,3000,0,2000,2000,3000,2000,1,6608,12127,9647,11138,11903,15664,0.1652,0.303175,0.241175,0.27845,0.297575,0.3916,2
6097,60000,1,2,2,23,2,0,0,0,0,0,58900,60020,60195,60864,40512,39523,2717,2929,2429,1551,1567,1456,0,56183,57091,57766,59313,38945,38067,0.9363833333333333,0.9515166666666667,0.9627666666666667,0.98855,0.6490833333333333,0.63445,2
6098,50000,0,3,2,47,0,0,0,0,0,0,15019,16026,17257,41868,23201,18623,1263,1494,25105,728,651,624,0,13756,14532,-7848,41140,22550,17999,0.27512,0.29064,-0.15696,0.8228,0.451,0.35998,0
6099,10000,0,2,1,43,3,2,2,4,3,2,8261,9470,11163,10852,10396,10085,1500,2000,0,0,0,350,1,6761,7470,11163,10852,10396,9735,0.6761,0.747,1.1163,1.0852,1.0396,0.9735,16
6100,30000,1,2,2,22,1,2,2,0,0,-2,22167,22474,18180,15900,0,0,1000,150,0,0,0,0,0,21167,22324,18180,15900,0,0,0.7055666666666667,0.7441333333333333,0.606,0.53,0.0,0.0,3
6101,160000,1,1,2,27,-1,-1,-1,-1,0,-1,288,451,1665,330,165,794,451,1680,330,0,794,2349,0,-163,-1229,1335,330,-629,-1555,-0.00101875,-0.00768125,0.00834375,0.0020625,-0.00393125,-0.00971875,-5
6102,110000,1,3,1,36,-1,-1,-1,-1,-1,0,3681,6026,1555,2043,1037,4718,6026,1555,2045,1037,4000,6233,1,-2345,4471,-490,1006,-2963,-1515,-0.02131818181818182,0.04064545454545455,-0.004454545454545455,0.009145454545454545,-0.026936363636363637,-0.013772727272727273,-5
6103,350000,1,1,2,44,3,2,2,2,2,2,314607,322032,327193,333278,340791,348006,14000,12000,13000,13000,13000,12200,0,300607,310032,314193,320278,327791,335806,0.8588771428571429,0.8858057142857143,0.8976942857142857,0.91508,0.9365457142857143,0.9594457142857142,13
6104,160000,1,1,1,35,1,-2,-2,-2,-2,-2,0,0,0,0,0,0,0,0,0,0,0,1404,1,0,0,0,0,0,-1404,0.0,0.0,0.0,0.0,0.0,-0.008775,-9
6105,70000,1,1,2,23,0,0,0,0,0,0,7531,8545,9588,10900,46462,47599,1145,1188,1500,36000,2000,1668,0,6386,7357,8088,-25100,44462,45931,0.09122857142857142,0.1051,0.11554285714285714,-0.3585714285714286,0.6351714285714286,0.6561571428571429,0
6106,200000,1,2,2,35,0,0,0,0,2,0,104393,108956,109339,113799,75536,66643,6300,4588,6910,30,2375,9577,0,98093,104368,102429,113769,73161,57066,0.490465,0.52184,0.512145,0.568845,0.365805,0.28533,2
6107,50000,1,1,2,25,2,0,0,0,0,0,49052,48026,47361,44293,17807,18324,3006,2300,3064,1799,790,1100,0,46046,45726,44297,42494,17017,17224,0.92092,0.91452,0.88594,0.84988,0.34034,0.34448,2
6108,500000,0,1,2,40,0,0,0,0,0,0,353356,320704,321094,317546,279250,239172,17000,11684,15000,8995,9457,10000,0,336356,309020,306094,308551,269793,229172,0.672712,0.61804,0.612188,0.617102,0.539586,0.458344,0
6109,140000,1,2,2,27,0,0,0,2,2,2,119692,91710,91744,70832,70768,71755,5000,8000,0,8000,3000,0,0,114692,83710,91744,62832,67768,71755,0.8192285714285714,0.5979285714285715,0.6553142857142857,0.4488,0.48405714285714285,0.5125357142857143,6
6110,60000,0,2,2,43,1,-2,-1,-1,-2,-2,0,0,780,0,0,0,0,780,0,0,0,0,0,0,-780,780,0,0,0,0.0,-0.013,0.013,0.0,0.0,0.0,-7
6111,60000,1,3,1,34,0,0,0,2,0,0,9928,11261,12853,12352,12703,13338,1500,2090,0,700,1000,1400,1,8428,9171,12853,11652,11703,11938,0.14046666666666666,0.15285,0.21421666666666667,0.1942,0.19505,0.19896666666666665,2
6112,230000,0,2,1,39,0,0,0,0,0,0,20307,19864,17789,14416,14445,14452,2000,2263,2000,2000,2000,2000,1,18307,17601,15789,12416,12445,12452,0.07959565217391304,0.07652608695652174,0.06864782608695652,0.053982608695652176,0.05410869565217391,0.054139130434782606,0
6113,200000,0,3,2,37,0,0,0,0,0,0,103715,104025,97749,99168,58256,59313,3942,4949,4800,2256,2313,2194,0,99773,99076,92949,96912,55943,57119,0.498865,0.49538,0.464745,0.48456,0.279715,0.285595,0
6114,260000,0,3,1,43,0,0,0,0,0,0,205599,151040,150917,152447,123771,126472,6000,7500,6000,4300,4500,4500,1,199599,143540,144917,148147,119271,121972,0.7676884615384615,0.5520769230769231,0.5573730769230769,0.5697961538461539,0.4587346153846154,0.4691230769230769,0
6115,150000,1,1,1,42,-1,2,2,-1,0,-1,496,1188,940,965,965,726,940,0,965,0,726,0,1,-444,1188,-25,965,239,726,-0.00296,0.00792,-0.00016666666666666666,0.0064333333333333334,0.0015933333333333333,0.00484,1
6116,100000,1,1,2,29,1,2,2,2,0,-1,6266,2366,7042,780,390,390,0,5000,0,0,390,1320,0,6266,-2634,7042,780,0,-930,0.06266,-0.02634,0.07042,0.0078,0.0,-0.0093,6
6117,60000,1,2,1,37,1,2,2,2,2,2,49335,48241,52222,52777,51332,55489,0,4763,2000,0,5000,2000,1,49335,43478,50222,52777,46332,53489,0.82225,0.7246333333333334,0.8370333333333333,0.8796166666666667,0.7722,0.8914833333333333,11
6118,230000,1,1,1,39,0,0,0,0,0,0,219712,208532,229229,143168,145270,141874,30500,25000,10000,5000,5000,18000,1,189212,183532,219229,138168,140270,123874,0.8226608695652174,0.7979652173913043,0.9531695652173913,0.6007304347826087,0.6098695652173913,0.5385826086956522,0
6119,180000,1,3,1,56,-1,-1,-1,-1,-1,-1,440,440,440,440,440,440,440,440,440,440,440,440,1,0,0,0,0,0,0,0.0,0.0,0.0,0.0,0.0,0.0,-6
6120,70000,0,1,2,27,0,0,0,0,0,0,70119,68536,66601,29401,28949,29795,3600,1646,600,28468,1327,1000,0,66519,66890,66001,933,27622,28795,0.9502714285714285,0.9555714285714285,0.9428714285714286,0.01332857142857143,0.3946,0.41135714285714287,0
6121,370000,0,1,2,37,-2,-2,-2,-2,-2,-2,12913,3409,2070,1895,2214,29613,3409,2070,1895,2214,29613,535,0,9504,1339,175,-319,-27399,29078,0.025686486486486488,0.003618918918918919,0.00047297297297297297,-0.0008621621621621621,-0.07405135135135135,0.0785891891891892,-12
6122,390000,1,1,2,41,-2,-2,-2,-2,-2,-2,-13,-13,-13,-13,-13,-13,0,0,0,0,0,13,0,-13,-13,-13,-13,-13,-26,-3.3333333333333335e-05,-3.3333333333333335e-05,-3.3333333333333335e-05,-3.3333333333333335e-05,-3.3333333333333335e-05,-6.666666666666667e-05,-12
6123,60000,0,2,2,24,-1,-1,-1,0,0,-1,836,836,6842,4603,3884,760,836,6842,1000,117,760,10038,0,0,-6006,5842,4486,3124,-9278,0.0,-0.1001,0.09736666666666667,0.07476666666666666,0.052066666666666664,-0.15463333333333334,-4
6124,10000,1,2,2,40,0,0,0,0,0,0,6160,6787,7377,7127,6931,6660,1123,1103,243,296,280,16,0,5037,5684,7134,6831,6651,6644,0.5037,0.5684,0.7134,0.6831,0.6651,0.6644,0
6125,300000,1,3,1,34,0,0,0,0,0,0,280823,275303,271952,193403,187562,191069,11000,12000,7200,6500,6173,5500,1,269823,263303,264752,186903,181389,185569,0.89941,0.8776766666666667,0.8825066666666667,0.62301,0.60463,0.6185633333333334,0
6126,370000,1,1,1,42,0,0,0,0,0,0,291006,271452,256269,200761,125646,111185,12100,11295,8300,5000,4600,10000,1,278906,260157,247969,195761,121046,101185,0.7538,0.703127027027027,0.6701864864864865,0.5290837837837837,0.32715135135135137,0.27347297297297296,0
6127,50000,0,2,2,54,0,0,0,0,-2,-1,72374,81665,67450,0,0,16271,15000,2650,0,0,16271,2000,0,57374,79015,67450,0,-16271,14271,1.14748,1.5803,1.349,0.0,-0.32542,0.28542,-3
6128,60000,0,3,1,31,1,2,0,0,0,0,69311,60059,54851,38863,39135,39049,0,2293,1367,1407,1410,1400,1,69311,57766,53484,37456,37725,37649,1.1551833333333332,0.9627666666666667,0.8914,0.6242666666666666,0.62875,0.6274833333333333,3
6129,30000,1,1,2,23,2,0,0,0,0,0,25366,26554,27435,28270,28632,30193,2000,2000,2000,1500,2400,1100,0,23366,24554,25435,26770,26232,29093,0.7788666666666667,0.8184666666666667,0.8478333333333333,0.8923333333333333,0.8744,0.9697666666666667,2
6130,30000,1,1,1,23,0,0,0,0,0,0,20340,21400,22428,23747,24154,25808,1400,1374,1693,1100,2200,0,1,18940,20026,20735,22647,21954,25808,0.6313333333333333,0.6675333333333333,0.6911666666666667,0.7549,0.7318,0.8602666666666666,0
6131,140000,0,2,1,41,0,0,2,2,2,2,57607,60676,64072,62444,67411,71144,4000,5000,0,6000,5000,0,1,53607,55676,64072,56444,62411,71144,0.38290714285714283,0.3976857142857143,0.4576571428571429,0.40317142857142857,0.44579285714285716,0.5081714285714286,8
6132,20000,0,2,1,40,0,0,0,0,0,0,10288,9276,5622,19263,18433,26132,3010,2010,15000,4000,2000,2000,1,7278,7266,-9378,15263,16433,24132,0.3639,0.3633,-0.4689,0.76315,0.82165,1.2066,0
6133,80000,1,1,2,23,1,-1,2,-1,0,0,-12,2321,60,5182,2792,189,2333,0,5182,0,0,2597,0,-2345,2321,-5122,5182,2792,-2408,-0.0293125,0.0290125,-0.064025,0.064775,0.0349,-0.0301,1
6134,100000,1,3,2,44,0,0,0,0,0,0,89988,92388,94478,59387,60953,59786,3852,4135,2200,2521,2162,2697,0,86136,88253,92278,56866,58791,57089,0.86136,0.88253,0.92278,0.56866,0.58791,0.57089,0
6135,100000,0,3,1,49,0,0,-2,-2,-2,-2,33333,0,0,0,0,0,0,0,0,0,0,0,1,33333,0,0,0,0,0,0.33333,0.0,0.0,0.0,0.0,0.0,-8
6136,60000,0,2,2,22,1,3,2,0,0,0,25300,23150,20999,21423,19049,18282,0,0,1000,1000,1000,1000,0,25300,23150,19999,20423,18049,17282,0.4216666666666667,0.3858333333333333,0.33331666666666665,0.3403833333333333,0.3008166666666667,0.2880333333333333,6
6137,200000,1,1,1,45,-1,-1,-1,-1,-2,-2,632,337,670,0,0,0,337,670,0,0,0,451,1,295,-333,670,0,0,-451,0.001475,-0.001665,0.00335,0.0,0.0,-0.002255,-8
6138,110000,1,3,2,28,0,0,2,2,0,0,85918,87442,82975,80446,80006,80421,4000,6000,12,3100,3200,3000,0,81918,81442,82963,77346,76806,77421,0.7447090909090909,0.7403818181818181,0.7542090909090909,0.7031454545454545,0.6982363636363637,0.7038272727272727,4
6139,50000,0,3,1,54,1,2,0,0,0,0,48679,47597,48503,49517,19592,19868,0,2100,2500,800,1000,900,1,48679,45497,46003,48717,18592,18968,0.97358,0.90994,0.92006,0.97434,0.37184,0.37936,3
6140,220000,0,2,1,47,-1,-1,-1,-1,-1,-1,3489,6246,29390,8460,19000,13550,6261,29390,8489,19000,13550,2969,1,-2772,-23144,20901,-10540,5450,10581,-0.0126,-0.1052,0.09500454545454545,-0.04790909090909091,0.024772727272727273,0.048095454545454545,-6
6141,300000,0,1,1,48,-1,-1,-1,-1,-1,-1,5036,32897,6493,23292,1254,7808,32898,6493,23324,1254,7808,3023,1,-27862,26404,-16831,22038,-6554,4785,-0.09287333333333334,0.08801333333333333,-0.05610333333333333,0.07346,-0.021846666666666667,0.01595,-6
6142,50000,1,2,1,34,0,0,2,0,0,0,11367,10982,10243,10826,11699,10146,3000,1000,1000,1000,2000,2000,1,8367,9982,9243,9826,9699,8146,0.16734,0.19964,0.18486,0.19652,0.19398,0.16292,2
6143,20000,0,1,2,28,0,0,0,0,0,0,17359,16828,17723,18733,12249,19910,2700,4150,1500,577,8000,300,0,14659,12678,16223,18156,4249,19610,0.73295,0.6339,0.81115,0.9078,0.21245,0.9805,0
6144,50000,1,2,2,36,2,0,0,0,0,0,42380,40288,32631,29968,29092,29977,1901,1744,1027,1033,1345,1000,0,40479,38544,31604,28935,27747,28977,0.80958,0.77088,0.63208,0.5787,0.55494,0.57954,2
6145,10000,0,2,2,23,0,0,2,0,0,2,7886,9085,7784,8547,8907,6844,1500,1000,1000,600,200,500,0,6386,8085,6784,7947,8707,6344,0.6386,0.8085,0.6784,0.7947,0.8707,0.6344,4
6146,280000,0,2,1,45,-1,-1,-1,-1,-1,-1,1207,1207,1207,1207,1207,1207,1207,1207,1207,1207,1207,1207,1,0,0,0,0,0,0,0.0,0.0,0.0,0.0,0.0,0.0,-6
6147,70000,0,3,2,41,0,0,0,0,0,0,70476,68539,69520,51605,50311,50729,2700,3500,2000,2000,2500,2500,0,67776,65039,67520,49605,47811,48229,0.9682285714285714,0.9291285714285714,0.9645714285714285,0.7086428571428571,0.6830142857142857,0.6889857142857143,0
6148,370000,1,2,1,45,0,0,0,-1,-1,-1,137250,141167,103000,41200,1109,99723,5927,5000,41200,1109,99723,5000,1,131323,136167,61800,40091,-98614,94723,0.35492702702702705,0.3680189189189189,0.16702702702702701,0.10835405405405406,-0.2665243243243243,0.2560081081081081,-3
6149,360000,0,3,1,54,-2,-2,-2,-2,-2,-1,16230,-200,0,0,69000,2500,0,200,0,69000,2500,0,1,16230,-400,0,-69000,66500,2500,0.045083333333333336,-0.0011111111111111111,0.0,-0.19166666666666668,0.18472222222222223,0.006944444444444444,-11
6150,280000,0,1,1,37,2,-1,-1,-1,-2,-1,1405,1549,1504,0,0,2949,1549,1504,0,0,2949,2838,1,-144,45,1504,0,-2949,111,-0.0005142857142857143,0.0001607142857142857,0.005371428571428571,0.0,-0.010532142857142858,0.00039642857142857145,-4
6151,290000,1,1,1,30,0,0,0,0,0,0,53476,52089,49979,36439,33231,32131,2009,2569,1532,987,1002,1035,1,51467,49520,48447,35452,32229,31096,0.17747241379310344,0.17075862068965517,0.16705862068965519,0.12224827586206896,0.11113448275862069,0.10722758620689656,0
6152,360000,1,2,1,40,-2,-2,-2,-2,-2,-2,8736,969,6083,9852,27210,1765,974,6120,9901,27352,1768,2111,1,7762,-5151,-3818,-17500,25442,-346,0.02156111111111111,-0.014308333333333333,-0.010605555555555556,-0.04861111111111111,0.07067222222222222,-0.0009611111111111112,-12
6153,50000,1,3,1,45,0,0,0,0,0,0,4151,5162,6184,7194,7336,7490,1088,1110,1120,262,272,273,1,3063,4052,5064,6932,7064,7217,0.06126,0.08104,0.10128,0.13864,0.14128,0.14434,0
6154,280000,0,1,2,38,0,0,0,0,0,0,138984,140300,145127,145571,115765,118190,4900,6918,7100,4388,4500,4300,0,134084,133382,138027,141183,111265,113890,0.47887142857142856,0.47636428571428574,0.49295357142857144,0.504225,0.397375,0.40675,0
6155,20000,0,2,2,24,0,0,0,0,0,0,17172,18179,19061,20182,19982,19482,1597,1479,1600,400,0,298,0,15575,16700,17461,19782,19982,19184,0.77875,0.835,0.87305,0.9891,0.9991,0.9592,0
6156,90000,0,3,1,49,2,2,2,2,2,2,74766,76470,77514,78730,80316,82321,3500,2900,3100,3000,3500,6500,1,71266,73570,74414,75730,76816,75821,0.7918444444444445,0.8174444444444444,0.8268222222222222,0.8414444444444444,0.8535111111111111,0.8424555555555555,12
6157,50000,1,1,2,28,1,2,0,0,0,0,43810,44184,4273,4999,5726,1473,1500,1300,2390,2200,0,3283,0,42310,42884,1883,2799,5726,-1810,0.8462,0.85768,0.03766,0.05598,0.11452,-0.0362,3
6158,90000,0,3,3,34,-2,-2,-2,-2,-2,-2,33957,4976,176,21601,7423,9252,4990,176,21665,8213,9279,16445,0,28967,4800,-21489,13388,-1856,-7193,0.32185555555555556,0.05333333333333334,-0.23876666666666665,0.14875555555555556,-0.020622222222222222,-0.07992222222222223,-12
6159,300000,1,1,2,46,1,-2,-2,-2,-2,-2,0,0,0,0,0,0,0,0,0,0,0,0,0,0,0,0,0,0,0,0.0,0.0,0.0,0.0,0.0,0.0,-9
6160,360000,0,1,2,28,-2,-2,-2,-2,-2,-2,14433,15157,8564,1495,5977,1211,2394,8606,1502,6006,4217,2228,0,12039,6551,7062,-4511,1760,-1017,0.03344166666666667,0.018197222222222222,0.019616666666666668,-0.012530555555555555,0.004888888888888889,-0.002825,-12
6161,240000,1,2,1,41,-2,-2,-2,-2,-2,-2,5366,-34,6911,611,2631,4583,0,6945,614,2634,4606,6242,1,5366,-6979,6297,-2023,-1975,-1659,0.022358333333333334,-0.029079166666666666,0.0262375,-0.008429166666666666,-0.008229166666666666,-0.0069125,-12
6162,60000,0,1,2,30,-1,-1,-1,-1,-1,-1,264,264,264,264,264,264,264,264,264,264,264,0,0,0,0,0,0,0,264,0.0,0.0,0.0,0.0,0.0,0.0044,-6
6163,100000,1,2,1,24,2,0,0,0,-2,-1,68371,9015,3325,0,0,93737,1300,1000,0,0,94562,3700,1,67071,8015,3325,0,-94562,90037,0.67071,0.08015,0.03325,0.0,-0.94562,0.90037,-1
6164,150000,1,1,2,32,1,-1,-1,-1,0,-1,0,258,44476,18547,32581,95780,258,44476,18547,17000,95780,99983,0,-258,-44218,25929,1547,-63199,-4203,-0.00172,-0.29478666666666664,0.17286,0.010313333333333334,-0.4213266666666667,-0.02802,-3
6165,50000,0,2,2,28,0,0,0,0,0,0,45622,47061,48264,27806,24901,25441,2500,2500,2000,2000,941,3113,0,43122,44561,46264,25806,23960,22328,0.86244,0.89122,0.92528,0.51612,0.4792,0.44656,0
6166,300000,1,1,2,27,-1,-1,-1,-1,0,0,2566,4658,197,10767,26117,15800,4725,197,10770,15350,5000,424,0,-2159,4461,-10573,-4583,21117,15376,-0.007196666666666666,0.01487,-0.035243333333333335,-0.015276666666666666,0.07039,0.05125333333333333,-4
6167,50000,0,2,1,37,-1,-1,-1,-1,-1,-1,4719,22449,6640,5410,9570,1500,22530,6640,5410,9570,1500,0,1,-17811,15809,1230,-4160,8070,1500,-0.35622,0.31618,0.0246,-0.0832,0.1614,0.03,-6
6168,130000,1,2,1,26,0,0,0,0,0,0,45563,46607,47329,45854,46822,47567,2100,1807,1800,1701,2002,1853,1,43463,44800,45529,44153,44820,45714,0.3343307692307692,0.3446153846153846,0.3502230769230769,0.33963846153846156,0.3447692307692308,0.35164615384615383,0
6169,150000,1,3,1,33,0,0,0,0,0,-1,21112,13155,14534,3334,318,1963,5000,4500,3300,300,2029,16368,1,16112,8655,11234,3034,-1711,-14405,0.10741333333333333,0.0577,0.07489333333333334,0.020226666666666667,-0.011406666666666667,-0.09603333333333333,-1
6170,50000,1,2,2,27,1,2,0,0,2,2,51176,48900,48854,50243,51187,47551,0,2200,3700,2000,0,2000,0,51176,46700,45154,48243,51187,45551,1.02352,0.934,0.90308,0.96486,1.02374,0.91102,7
6171,50000,0,2,2,23,0,0,0,0,0,-1,47038,51310,49956,19485,13925,15706,10020,2170,1200,4000,15706,10000,0,37018,49140,48756,15485,-1781,5706,0.74036,0.9828,0.97512,0.3097,-0.03562,0.11412,-1
6172,20000,1,2,2,24,0,0,0,0,0,0,13867,14834,15931,15850,16226,14411,1500,1450,369,429,288,250,0,12367,13384,15562,15421,15938,14161,0.61835,0.6692,0.7781,0.77105,0.7969,0.70805,0
6173,390000,1,2,1,29,-2,-2,-2,-2,-2,-2,10598,1446,2041,4582,2070,0,1571,2041,4582,2070,0,3100,1,9027,-595,-2541,2512,2070,-3100,0.023146153846153848,-0.0015256410256410257,-0.006515384615384616,0.006441025641025641,0.0053076923076923075,-0.007948717948717949,-12
6174,240000,1,1,2,30,1,1,-2,-2,-2,-2,9028,-1868,-1868,-1868,-1868,-1868,0,0,0,0,0,0,0,9028,-1868,-1868,-1868,-1868,-1868,0.037616666666666666,-0.007783333333333333,-0.007783333333333333,-0.007783333333333333,-0.007783333333333333,-0.007783333333333333,-6
6175,210000,0,1,2,28,1,0,0,0,0,0,5397,5079,6020,6143,6268,399,5000,1000,123,125,0,1280,0,397,4079,5897,6018,6268,-881,0.0018904761904761905,0.019423809523809524,0.02808095238095238,0.028657142857142857,0.029847619047619046,-0.004195238095238096,1
6176,20000,0,3,2,24,2,0,0,0,0,0,11179,12188,12904,14217,14360,16140,1504,1220,1533,676,2177,559,0,9675,10968,11371,13541,12183,15581,0.48375,0.5484,0.56855,0.67705,0.60915,0.77905,2
6177,110000,0,1,1,36,2,0,0,0,0,0,36152,37246,38340,39018,40122,41069,2000,2000,1500,1500,1500,1135,1,34152,35246,36840,37518,38622,39934,0.3104727272727273,0.3204181818181818,0.33490909090909093,0.34107272727272725,0.3511090909090909,0.36303636363636366,2
6178,480000,0,2,2,51,-2,-2,-2,-2,-2,-2,2900,17646,0,15620,5200,1355,17646,0,15620,5200,1355,2750,0,-14746,17646,-15620,10420,3845,-1395,-0.030720833333333333,0.0367625,-0.03254166666666667,0.021708333333333333,0.008010416666666667,-0.00290625,-12
6179,50000,0,3,1,40,0,0,0,0,0,0,46850,31923,47574,7613,7613,7756,2068,18135,2000,1000,1000,2000,1,44782,13788,45574,6613,6613,5756,0.89564,0.27576,0.91148,0.13226,0.13226,0.11512,0
6180,160000,1,2,2,23,0,0,0,-1,-1,-2,21905,22473,21380,283,0,-17149,1373,1000,283,0,0,20261,0,20532,21473,21097,283,0,-37410,0.128325,0.13420625,0.13185625,0.00176875,0.0,-0.2338125,-4
6181,80000,1,2,3,30,0,0,0,0,0,0,11976,10010,10982,11325,11569,10303,1185,1157,500,400,500,5000,0,10791,8853,10482,10925,11069,5303,0.1348875,0.1106625,0.131025,0.1365625,0.1383625,0.0662875,0
6182,40000,1,2,2,23,0,0,0,0,2,2,18653,20035,21406,24735,24050,43317,2000,2000,4000,0,20000,2000,0,16653,18035,17406,24735,4050,41317,0.416325,0.450875,0.43515,0.618375,0.10125,1.032925,4
6183,310000,1,2,2,27,0,0,0,0,0,0,122127,110388,119365,113435,140988,145161,10000,10124,20000,30125,30137,20171,0,112127,100264,99365,83310,110851,124990,0.3617,0.32343225806451614,0.32053225806451613,0.268741935483871,0.3575838709677419,0.40319354838709676,0
6184,20000,0,2,2,43,0,0,2,2,2,2,5909,8134,7859,9518,9216,10067,2500,0,1800,0,1000,0,0,3409,8134,6059,9518,8216,10067,0.17045,0.4067,0.30295,0.4759,0.4108,0.50335,8
6185,250000,1,2,2,31,1,2,0,0,0,0,59878,58348,59530,60668,59786,130890,0,2150,2116,65,72460,5000,0,59878,56198,57414,60603,-12674,125890,0.239512,0.224792,0.229656,0.242412,-0.050696,0.50356,3
6186,70000,1,1,2,25,1,2,2,2,2,2,53742,52281,55981,54484,59080,59096,0,4545,0,5500,2090,0,0,53742,47736,55981,48984,56990,59096,0.7677428571428572,0.6819428571428572,0.7997285714285715,0.6997714285714286,0.8141428571428572,0.8442285714285714,11
6187,300000,1,1,2,38,0,0,2,-1,-1,-1,15001,12751,2318,3792,11977,29127,2318,0,3792,11977,29127,16600,0,12683,12751,-1474,-8185,-17150,12527,0.042276666666666664,0.04250333333333333,-0.004913333333333333,-0.027283333333333333,-0.057166666666666664,0.041756666666666664,-1
6188,360000,1,1,2,34,-2,-2,-2,-2,-2,-2,6276,16062,8539,8665,2132,745,16142,8630,8710,2142,748,3030,0,-9866,7432,-171,6523,1384,-2285,-0.027405555555555555,0.020644444444444444,-0.000475,0.018119444444444445,0.0038444444444444446,-0.006347222222222222,-12
6189,40000,0,1,2,29,1,2,2,2,2,2,37681,36775,39982,38979,39479,39329,0,3800,0,1200,0,0,0,37681,32975,39982,37779,39479,39329,0.942025,0.824375,0.99955,0.944475,0.986975,0.983225,11
6190,10000,0,2,2,37,0,0,0,0,2,2,8755,8158,7540,8164,6963,5923,1167,1022,1036,0,2700,0,0,7588,7136,6504,8164,4263,5923,0.7588,0.7136,0.6504,0.8164,0.4263,0.5923,4
6191,500000,1,1,1,37,-1,-1,-1,-1,-1,0,6694,17470,15091,1587,61385,56252,17470,15091,1587,61385,0,56733,1,-10776,2379,13504,-59798,61385,-481,-0.021552,0.004758,0.027008,-0.119596,0.12277,-0.000962,-5
6192,100000,1,4,2,34,0,0,0,0,0,-1,91674,91348,87244,23181,7721,3219,5004,3811,3002,4000,3219,1864,0,86670,87537,84242,19181,4502,1355,0.8667,0.87537,0.84242,0.19181,0.04502,0.01355,-1
6193,370000,1,2,1,41,-2,-2,-2,-2,-2,-2,1442,9750,0,30100,0,0,9750,0,30100,0,0,0,1,-8308,9750,-30100,30100,0,0,-0.022454054054054054,0.026351351351351353,-0.08135135135135135,0.08135135135135135,0.0,0.0,-12
6194,70000,1,1,2,26,0,0,0,0,0,0,69754,71377,71225,64644,68427,69893,2791,2939,2364,4876,2557,3599,0,66963,68438,68861,59768,65870,66294,0.9566142857142858,0.9776857142857143,0.9837285714285714,0.8538285714285714,0.941,0.9470571428571428,0
6195,170000,1,1,1,52,-1,-1,2,-1,-1,-1,2939,5447,416,7509,6387,1516,3000,5,7509,6387,1666,3023,1,-61,5442,-7093,1122,4721,-1507,-0.00035882352941176473,0.03201176470588235,-0.04172352941176471,0.0066,0.027770588235294116,-0.008864705882352941,-3
6196,110000,0,3,2,52,0,0,0,2,0,0,56327,57106,58489,57800,57312,57188,2700,3300,2044,2100,2000,2266,0,53627,53806,56445,55700,55312,54922,0.4875181818181818,0.48914545454545455,0.5131363636363636,0.5063636363636363,0.5028363636363636,0.4992909090909091,2
6197,20000,0,3,2,33,1,2,2,2,2,2,16247,15689,18417,17802,19543,18442,0,3000,0,2000,0,1000,0,16247,12689,18417,15802,19543,17442,0.81235,0.63445,0.92085,0.7901,0.97715,0.8721,11
6198,500000,0,1,1,51,0,0,0,0,0,0,225233,235045,244517,243132,243869,251540,15000,15006,10000,10000,12000,15000,1,210233,220039,234517,233132,231869,236540,0.420466,0.440078,0.469034,0.466264,0.463738,0.47308,0
6199,10000,0,3,2,24,1,2,2,2,2,2,7826,8745,8440,9229,8969,8819,1200,0,900,0,2000,0,0,6626,8745,7540,9229,6969,8819,0.6626,0.8745,0.754,0.9229,0.6969,0.8819,11
6200,270000,1,3,1,42,2,0,0,0,0,0,106986,103249,89221,86996,86384,85440,3578,3207,3000,3200,3241,3078,1,103408,100042,86221,83796,83143,82362,0.3829925925925926,0.3705259259259259,0.31933703703703703,0.31035555555555555,0.30793703703703706,0.30504444444444445,2
6201,80000,1,1,2,43,0,0,0,-2,-1,-1,80958,77783,-478,-1739,1261,1261,1556,0,0,4261,1261,540,0,79402,77783,-478,-6000,0,721,0.992525,0.9722875,-0.005975,-0.075,0.0,0.0090125,-4
6202,40000,1,1,2,27,1,-1,-1,-2,-1,-1,0,450,0,0,247,0,450,0,0,247,0,0,0,-450,450,0,-247,247,0,-0.01125,0.01125,0.0,-0.006175,0.006175,0.0,-5
6203,310000,1,2,2,26,0,0,0,0,0,0,219155,223308,225574,224001,230902,105844,10000,10000,6000,10000,39000,4000,0,209155,213308,219574,214001,191902,101844,0.6746935483870967,0.6880903225806452,0.7083032258064517,0.6903258064516129,0.6190387096774194,0.3285290322580645,0
6204,50000,1,3,1,42,0,0,0,0,0,0,51123,50646,41150,30405,30671,30664,2089,2190,1100,1271,1264,2778,1,49034,48456,40050,29134,29407,27886,0.98068,0.96912,0.801,0.58268,0.58814,0.55772,0
6205,20000,1,2,2,21,-1,-1,2,2,-1,-1,18763,14410,13771,362,5308,0,14410,0,28,22073,0,0,0,4353,14410,13743,-21711,5308,0,0.21765,0.7205,0.68715,-1.08555,0.2654,0.0,0
6206,140000,1,2,1,30,-1,-1,-1,-1,-1,-1,2290,2290,2292,3365,1567,1707,2290,2292,3365,1567,1707,1707,1,0,-2,-1073,1798,-140,0,0.0,-1.4285714285714285e-05,-0.007664285714285715,0.012842857142857144,-0.001,0.0,-6
6207,170000,0,2,2,36,-2,-2,-2,-2,-2,-2,600,1598,0,1340,0,0,1598,0,1340,0,0,3200,0,-998,1598,-1340,1340,0,-3200,-0.005870588235294118,0.0094,-0.00788235294117647,0.00788235294117647,0.0,-0.018823529411764704,-12
6208,130000,1,1,1,31,0,0,0,0,0,0,128319,131825,127949,129357,126999,126719,6300,4800,5000,4700,5000,5000,1,122019,127025,122949,124657,121999,121719,0.9386076923076923,0.9771153846153846,0.9457615384615384,0.9589,0.9384538461538462,0.9363,0
6209,280000,1,2,2,30,-1,-1,-1,0,0,-2,1373,207,3516,2769,0,0,207,3516,0,0,0,0,0,1166,-3309,3516,2769,0,0,0.004164285714285714,-0.011817857142857142,0.012557142857142857,0.009889285714285715,0.0,0.0,-5
6210,160000,1,2,1,41,1,-1,-1,-1,-1,-1,0,1496,1496,1496,1496,1496,1496,1496,1496,1496,1496,1496,1,-1496,0,0,0,0,0,-0.00935,0.0,0.0,0.0,0.0,0.0,-4
6211,160000,1,2,1,32,-1,-1,-1,0,0,0,390,390,1560,1170,780,390,390,1560,0,0,0,390,1,0,-1170,1560,1170,780,0,0.0,-0.0073125,0.00975,0.0073125,0.004875,0.0,-3
6212,140000,1,2,2,31,0,0,0,0,0,0,138119,137950,140254,139679,141748,142174,6600,6500,5100,5300,6000,5000,0,131519,131450,135154,134379,135748,137174,0.9394214285714285,0.9389285714285714,0.9653857142857143,0.95985,0.9696285714285714,0.9798142857142857,0
6213,20000,0,2,2,38,0,0,0,0,0,0,17760,19646,17922,18895,19325,19859,6500,2000,2000,1500,1000,1000,0,11260,17646,15922,17395,18325,18859,0.563,0.8823,0.7961,0.86975,0.91625,0.94295,0
6214,50000,1,2,2,22,0,-1,-1,0,0,0,1470,627,14596,19323,19728,20142,627,14596,5000,716,742,404,0,843,-13969,9596,18607,18986,19738,0.01686,-0.27938,0.19192,0.37214,0.37972,0.39476,-2
6215,320000,0,1,1,50,-2,-2,-2,-2,-2,-2,6426,-4,816,30026,49154,1299,0,824,31144,25664,2610,1833,1,6426,-828,-30328,4362,46544,-534,0.02008125,-0.0025875,-0.094775,0.01363125,0.14545,-0.00166875,-12
6216,50000,0,2,1,34,1,2,2,2,2,2,16501,15947,18134,17622,19249,14259,0,2500,0,2000,0,1000,1,16501,13447,18134,15622,19249,13259,0.33002,0.26894,0.36268,0.31244,0.38498,0.26518,11
6217,310000,0,2,1,48,0,0,0,0,0,0,102646,101640,102740,97791,86200,83017,5200,4700,4250,3100,3100,3100,1,97446,96940,98490,94691,83100,79917,0.31434193548387096,0.31270967741935485,0.31770967741935485,0.30545483870967743,0.26806451612903226,0.2577967741935484,0
6218,50000,0,3,2,24,4,3,2,2,2,0,27226,26508,26976,27206,26631,27185,0,1200,968,0,998,1479,0,27226,25308,26008,27206,25633,25706,0.54452,0.50616,0.52016,0.54412,0.51266,0.51412,13
6219,180000,1,2,2,34,-1,-1,-1,-1,-1,-1,194,191,187,176,188,187,200,187,180,200,187,750,0,-6,4,7,-24,1,-563,-3.3333333333333335e-05,2.2222222222222223e-05,3.888888888888889e-05,-0.00013333333333333334,5.555555555555556e-06,-0.003127777777777778,-6
6220,70000,0,2,1,35,0,0,0,0,0,0,32507,29775,31273,33739,34632,33746,3000,2000,3000,1600,1500,1600,1,29507,27775,28273,32139,33132,32146,0.4215285714285714,0.3967857142857143,0.4039,0.45912857142857144,0.4733142857142857,0.45922857142857143,0
6221,30000,0,2,2,23,1,2,0,0,0,-1,29772,28707,29235,14040,500,22292,0,1600,1000,0,22292,1000,0,29772,27107,28235,14040,-21792,21292,0.9924,0.9035666666666666,0.9411666666666667,0.468,-0.7264,0.7097333333333333,2
6222,100000,0,4,2,28,-2,-2,-2,-2,-2,-2,1000,0,0,0,0,0,0,0,0,0,0,0,0,1000,0,0,0,0,0,0.01,0.0,0.0,0.0,0.0,0.0,-12
6223,30000,1,2,2,25,3,2,2,2,2,2,9095,10297,9988,11708,11223,12079,1500,0,1892,0,1042,700,0,7595,10297,8096,11708,10181,11379,0.25316666666666665,0.34323333333333333,0.26986666666666664,0.39026666666666665,0.33936666666666665,0.3793,13
6224,20000,1,2,1,42,0,0,0,0,0,0,19185,18621,19605,19717,19203,19871,1323,1307,691,705,995,722,1,17862,17314,18914,19012,18208,19149,0.8931,0.8657,0.9457,0.9506,0.9104,0.95745,0
6225,270000,1,1,2,31,-1,-1,0,-1,-1,0,173,2254,3679,4065,3975,8195,2254,1522,4065,4056,81,83,0,-2081,732,-386,9,3894,8112,-0.007707407407407408,0.002711111111111111,-0.0014296296296296297,3.3333333333333335e-05,0.014422222222222222,0.030044444444444443,-4
6226,60000,1,3,1,59,-1,-1,-1,-1,-1,-1,694,694,694,694,694,28948,694,694,694,694,28948,1044,1,0,0,0,0,-28254,27904,0.0,0.0,0.0,0.0,-0.4709,0.4650666666666667,-6
6227,150000,1,2,2,32,5,4,3,2,2,2,79529,77757,75841,73678,77273,56577,0,0,0,4874,1000,0,0,79529,77757,75841,68804,76273,56577,0.5301933333333333,0.51838,0.5056066666666666,0.45869333333333334,0.5084866666666666,0.37718,18
6228,100000,0,2,2,28,0,0,0,0,-2,-1,180765,64653,10388,3762,1434,12609,3018,1400,3786,1774,12714,38665,0,177747,63253,6602,1988,-11280,-26056,1.77747,0.63253,0.06602,0.01988,-0.1128,-0.26056,-3
6229,180000,0,1,1,46,-1,3,2,-1,-1,-1,780,780,390,390,390,540,0,0,390,390,540,390,1,780,780,0,0,-150,150,0.004333333333333333,0.004333333333333333,0.0,0.0,-0.0008333333333333334,0.0008333333333333334,1
6230,40000,0,2,2,26,3,3,2,2,2,2,5754,6407,6156,7146,7384,7117,900,0,1100,500,0,708,0,4854,6407,5056,6646,7384,6409,0.12135,0.160175,0.1264,0.16615,0.1846,0.160225,14
6231,130000,1,2,1,49,0,0,0,0,0,0,53714,55404,56566,57139,58300,59523,2570,2650,2100,2100,2150,3000,1,51144,52754,54466,55039,56150,56523,0.3934153846153846,0.4058,0.41896923076923076,0.4233769230769231,0.4319230769230769,0.4347923076923077,0
6232,50000,0,2,2,32,1,2,2,0,0,0,48793,50194,49101,47549,48817,45928,2500,0,1800,2000,2000,2000,0,46293,50194,47301,45549,46817,43928,0.92586,1.00388,0.94602,0.91098,0.93634,0.87856,5
6233,140000,1,1,2,25,-1,-1,-1,-1,-1,-1,1605,1844,1311,643,2561,1440,1844,1311,643,2561,1440,1582,0,-239,533,668,-1918,1121,-142,-0.0017071428571428572,0.003807142857142857,0.004771428571428571,-0.0137,0.008007142857142857,-0.0010142857142857143,-6
6234,210000,1,1,2,31,0,0,0,0,0,0,77830,68850,42884,23547,18574,12466,2555,2027,1045,1000,500,10000,0,75275,66823,41839,22547,18074,2466,0.35845238095238097,0.3182047619047619,0.19923333333333335,0.10736666666666667,0.08606666666666667,0.011742857142857143,0
6235,170000,1,2,2,29,0,0,0,0,0,0,69314,65083,67062,68188,56454,58453,2330,3028,2847,2600,3400,2045,0,66984,62055,64215,65588,53054,56408,0.3940235294117647,0.3650294117647059,0.37773529411764706,0.38581176470588235,0.3120823529411765,0.33181176470588236,0
6236,90000,1,1,1,31,1,2,-1,0,0,-1,8318,6111,33212,8978,1782,23173,39,33500,0,0,25000,0,1,8279,-27389,33212,8978,-23218,23173,0.09198888888888888,-0.3043222222222222,0.3690222222222222,0.09975555555555556,-0.25797777777777775,0.2574777777777778,1
6237,150000,0,1,2,32,0,0,2,2,2,0,52582,57496,55705,57210,57084,13194,6395,0,2100,222,1000,650,0,46187,57496,53605,56988,56084,12544,0.3079133333333333,0.3833066666666667,0.35736666666666667,0.37992,0.37389333333333336,0.08362666666666667,6
6238,150000,1,2,1,37,0,0,0,0,0,0,135211,142398,121570,130780,130780,0,10109,10000,10000,10000,20000,16100,1,125102,132398,111570,120780,110780,-16100,0.8340133333333334,0.8826533333333333,0.7438,0.8052,0.7385333333333334,-0.10733333333333334,0
6239,60000,0,2,2,24,0,0,2,0,0,0,57480,60491,57187,57619,57033,58493,4207,1000,1690,1473,2354,2009,0,53273,59491,55497,56146,54679,56484,0.8878833333333334,0.9915166666666667,0.92495,0.9357666666666666,0.9113166666666667,0.9414,2
6240,300000,1,2,1,31,0,-1,-1,-1,0,0,3565,316,316,17597,15257,9482,316,316,17597,2000,2690,2000,1,3249,0,-17281,15597,12567,7482,0.01083,0.0,-0.05760333333333333,0.05199,0.04189,0.02494,-3
6241,200000,0,1,2,38,2,-1,-1,-1,-1,-1,1810,3388,-12,1081,1884,2089,3405,0,1093,1893,2097,7132,0,-1595,3388,-1105,-812,-213,-5043,-0.007975,0.01694,-0.005525,-0.00406,-0.001065,-0.025215,-3
6242,220000,1,3,2,43,0,0,0,0,0,0,223022,215787,220680,219459,177765,175238,7750,8397,7349,6518,7000,7000,0,215272,207390,213331,212941,170765,168238,0.9785090909090909,0.9426818181818182,0.9696863636363636,0.9679136363636364,0.7762045454545454,0.7647181818181819,0
6243,110000,1,1,1,40,0,0,2,0,0,0,52691,55000,52277,52055,52437,55560,5000,0,2000,3000,5000,2000,1,47691,55000,50277,49055,47437,53560,0.43355454545454547,0.5,0.45706363636363634,0.44595454545454544,0.43124545454545454,0.4869090909090909,2
6244,250000,1,2,1,28,2,0,0,0,2,0,28245,29468,31488,34060,33213,34670,2000,2500,3100,0,2000,8000,1,26245,26968,28388,34060,31213,26670,0.10498,0.107872,0.113552,0.13624,0.124852,0.10668,4
6245,160000,1,2,1,58,-1,-1,-1,-1,-1,-1,1443,1443,1443,1443,1443,1443,1443,1443,1443,1443,1443,1443,1,0,0,0,0,0,0,0.0,0.0,0.0,0.0,0.0,0.0,-6
6246,30000,1,3,1,47,0,0,0,0,0,0,15979,17705,19107,20281,20941,21799,2000,2000,1500,1000,1200,2000,1,13979,15705,17607,19281,19741,19799,0.46596666666666664,0.5235,0.5869,0.6427,0.6580333333333334,0.6599666666666667,0
6247,520000,0,1,1,38,0,0,0,0,0,0,98615,102085,102762,104865,106947,109507,5102,3800,3803,3822,4277,4868,1,93513,98285,98959,101043,102670,104639,0.1798326923076923,0.1890096153846154,0.19030576923076922,0.19431346153846155,0.1974423076923077,0.20122884615384615,0
6248,100000,0,2,2,24,0,0,0,0,0,0,87478,88627,92187,95030,29470,3470,3500,5000,5000,4000,3000,5000,0,83978,83627,87187,91030,26470,-1530,0.83978,0.83627,0.87187,0.9103,0.2647,-0.0153,0
6249,210000,0,2,2,47,-2,-2,-2,-2,-2,-2,-163,-163,-163,-65167,-168,2999,0,0,5530,84332,21500,30000,0,-163,-163,-5693,-149499,-21668,-27001,-0.0007761904761904762,-0.0007761904761904762,-0.02710952380952381,-0.7119,-0.10318095238095239,-0.12857619047619048,-12
6250,500000,0,1,1,43,1,-2,-2,-2,-2,-2,0,0,0,0,0,0,0,0,0,0,0,0,1,0,0,0,0,0,0,0.0,0.0,0.0,0.0,0.0,0.0,-9
6251,360000,1,2,1,42,0,0,0,0,0,0,118368,124934,131328,137605,140729,146194,10000,10000,10000,5500,8000,6000,1,108368,114934,121328,132105,132729,140194,0.30102222222222225,0.3192611111111111,0.3370222222222222,0.36695833333333333,0.36869166666666664,0.38942777777777776,0
6252,260000,0,2,1,62,-1,-1,-1,-1,-1,-1,390,390,390,390,390,390,390,780,390,390,390,390,1,0,-390,0,0,0,0,0.0,-0.0015,0.0,0.0,0.0,0.0,-6
6253,20000,0,2,2,36,2,0,0,-1,-1,-1,19597,35869,9066,309,3019,16496,1503,2036,309,3100,16890,500,0,18094,33833,8757,-2791,-13871,15996,0.9047,1.69165,0.43785,-0.13955,-0.69355,0.7998,-1
6254,400000,1,1,2,33,-1,-1,-1,-1,-1,-1,7768,31313,8744,11640,41432,20075,31330,8853,11816,41432,20974,44135,0,-23562,22460,-3072,-29792,20458,-24060,-0.058905,0.05615,-0.00768,-0.07448,0.051145,-0.06015,-6
6255,20000,1,2,1,45,-1,-1,-1,-1,-1,-1,650,264,264,264,654,654,264,264,264,1044,654,264,1,386,0,0,-780,0,390,0.0193,0.0,0.0,-0.039,0.0,0.0195,-6
6256,230000,1,2,2,25,0,-1,2,0,0,0,14330,222761,197630,172058,174123,178052,232557,0,7556,6219,6721,7074,0,-218227,222761,190074,165839,167402,170978,-0.9488130434782609,0.9685260869565218,0.8264086956521739,0.7210391304347826,0.7278347826086956,0.7433826086956522,1
6257,50000,0,2,2,29,1,2,2,0,0,2,12460,13489,12987,13699,15868,15474,1530,0,1234,2403,0,711,0,10930,13489,11753,11296,15868,14763,0.2186,0.26978,0.23506,0.22592,0.31736,0.29526,7
6258,200000,1,2,1,26,0,0,0,-1,-1,-1,15150,16311,16900,5000,0,282,1411,1000,5000,0,282,8423,1,13739,15311,11900,5000,-282,-8141,0.068695,0.076555,0.0595,0.025,-0.00141,-0.040705,-3
6259,210000,0,1,1,40,-1,-1,-1,-1,-1,-1,6223,8143,3712,3091,90817,308,8146,3719,3091,90817,308,3369,1,-1923,4424,621,-87726,90509,-3061,-0.009157142857142857,0.021066666666666668,0.002957142857142857,-0.41774285714285714,0.4309952380952381,-0.014576190476190477,-6
6260,200000,0,1,1,38,-1,-1,-1,-1,-2,-2,3048,0,100000,0,0,0,0,100000,0,0,0,0,1,3048,-100000,100000,0,0,0,0.01524,-0.5,0.5,0.0,0.0,0.0,-8
6261,50000,0,2,1,56,1,2,2,0,0,0,48141,50783,49581,36828,19361,19780,3739,28,1502,670,708,681,1,44402,50755,48079,36158,18653,19099,0.88804,1.0151,0.96158,0.72316,0.37306,0.38198,5
6262,380000,1,1,1,33,0,0,0,0,0,0,112926,108573,216399,213259,203377,185056,4677,130533,7609,12000,7000,6000,1,108249,-21960,208790,201259,196377,179056,0.2848657894736842,-0.05778947368421053,0.5494473684210527,0.529628947368421,0.5167815789473684,0.4712,0
6263,150000,1,2,1,34,-2,-2,-2,-2,-2,-2,316,1801,1139,2246,5435,466,1801,1139,2246,5435,466,316,1,-1485,662,-1107,-3189,4969,150,-0.0099,0.004413333333333333,-0.00738,-0.02126,0.033126666666666665,0.001,-12
6264,230000,1,2,1,30,0,-1,-1,-1,0,0,8685,1079,2923,25916,4219,7903,1079,3000,25916,2219,4000,6000,1,7606,-1921,-22993,23697,219,1903,0.0330695652173913,-0.008352173913043479,-0.09996956521739131,0.10303043478260869,0.0009521739130434782,0.008273913043478262,-3
6265,60000,1,1,2,24,0,0,0,0,0,0,60381,39798,38344,37311,37428,38187,1639,1590,1500,1354,1377,1514,0,58742,38208,36844,35957,36051,36673,0.9790333333333333,0.6368,0.6140666666666666,0.5992833333333333,0.60085,0.6112166666666666,0
6266,50000,0,2,1,32,1,-2,-1,-1,-1,0,-11545,-1935,7321,2850,6340,3110,10000,10000,7867,6340,3000,2218,1,-21545,-11935,-546,-3490,3340,892,-0.4309,-0.2387,-0.01092,-0.0698,0.0668,0.01784,-4
6267,500000,1,2,2,26,0,0,0,0,0,0,59039,58262,54586,29280,31284,29371,4028,2077,1001,3008,1305,1007,0,55011,56185,53585,26272,29979,28364,0.110022,0.11237,0.10717,0.052544,0.059958,0.056728,0
6268,30000,1,2,2,22,0,0,-1,-1,2,2,17358,-36,23114,24727,24192,25905,0,23150,2000,0,2119,0,0,17358,-23186,21114,24727,22073,25905,0.5786,-0.7728666666666667,0.7038,0.8242333333333334,0.7357666666666667,0.8635,2
6269,260000,0,1,2,30,-1,-1,-1,0,0,-1,496,496,992,992,496,1488,496,992,496,0,1488,496,0,0,-496,496,992,-992,992,0.0,-0.0019076923076923077,0.0019076923076923077,0.0038153846153846155,-0.0038153846153846155,0.0038153846153846155,-4
6270,200000,0,2,1,40,0,0,0,0,0,0,63182,44876,38764,37618,35737,40710,1765,10007,2019,5027,15031,7088,1,61417,34869,36745,32591,20706,33622,0.307085,0.174345,0.183725,0.162955,0.10353,0.16811,0
6271,390000,1,1,2,33,0,0,0,0,0,0,85538,79875,82853,82747,44143,38488,3500,4502,3518,2003,3001,3000,0,82038,75373,79335,80744,41142,35488,0.21035384615384614,0.19326410256410256,0.20342307692307693,0.20703589743589743,0.10549230769230769,0.0909948717948718,0
6272,490000,0,1,1,41,0,0,0,0,0,0,79712,81707,85703,87725,88727,91483,3000,5000,4000,3000,4000,5000,1,76712,76707,81703,84725,84727,86483,0.15655510204081632,0.15654489795918367,0.16674081632653062,0.17290816326530611,0.17291224489795917,0.17649591836734693,0
6273,270000,0,1,1,40,0,0,0,0,0,0,3686,4699,5718,6727,6861,7005,1084,1103,1112,246,255,651,1,2602,3596,4606,6481,6606,6354,0.009637037037037038,0.013318518518518518,0.01705925925925926,0.024003703703703704,0.024466666666666668,0.023533333333333333,0
6274,30000,1,4,2,23,2,2,-1,-1,-1,-1,2826,2068,16952,15336,24336,436,0,16952,16104,14000,486,0,0,2826,-14884,848,1336,23850,436,0.0942,-0.4961333333333333,0.028266666666666666,0.044533333333333334,0.795,0.014533333333333334,0
6275,200000,1,3,1,44,0,0,0,0,0,0,34760,37871,39879,42946,46141,46305,4000,3000,4000,4000,3000,3000,1,30760,34871,35879,38946,43141,43305,0.1538,0.174355,0.179395,0.19473,0.215705,0.216525,0
6276,20000,1,2,1,34,0,0,2,-1,-1,-1,3223,3176,220,632,0,316,1220,0,632,0,316,782,1,2003,3176,-412,632,-316,-466,0.10015,0.1588,-0.0206,0.0316,-0.0158,-0.0233,-1
6277,200000,0,1,1,43,0,0,-1,0,0,0,202225,-4359,190829,96686,100131,102467,1029,200000,10000,5000,4000,4000,1,201196,-204359,180829,91686,96131,98467,1.00598,-1.021795,0.904145,0.45843,0.480655,0.492335,-1
6278,70000,1,3,2,24,0,0,0,0,0,0,5633,6646,7665,8836,9532,9730,1114,1133,1304,1000,351,2523,0,4519,5513,6361,7836,9181,7207,0.06455714285714285,0.07875714285714286,0.09087142857142858,0.11194285714285715,0.13115714285714286,0.10295714285714286,0
6279,80000,1,3,2,25,0,0,0,0,0,0,88786,86391,84871,81813,45094,38121,3200,4000,3000,1500,1500,1300,0,85586,82391,81871,80313,43594,36821,1.069825,1.0298875,1.0233875,1.0039125,0.544925,0.4602625,0
6280,260000,1,1,2,31,0,0,0,0,0,0,181679,187642,190152,186696,188632,190948,8900,7200,6800,7100,7200,6500,0,172779,180442,183352,179596,181432,184448,0.6645346153846153,0.6940076923076923,0.7052,0.6907538461538462,0.6978153846153846,0.7094153846153847,0
6281,150000,1,3,2,30,0,0,0,0,0,0,24523,22224,20880,17305,16094,18516,2029,3030,3118,3003,3040,2050,0,22494,19194,17762,14302,13054,16466,0.14996,0.12796,0.11841333333333333,0.09534666666666666,0.08702666666666667,0.10977333333333333,0
6282,80000,0,2,1,36,0,0,0,0,0,0,25028,26054,20344,7311,6100,2160,3033,3379,0,0,0,0,1,21995,22675,20344,7311,6100,2160,0.2749375,0.2834375,0.2543,0.0913875,0.07625,0.027,0
6283,360000,1,2,2,30,-2,-2,-2,-2,-2,-2,2500,0,0,0,0,0,0,0,0,0,0,0,0,2500,0,0,0,0,0,0.006944444444444444,0.0,0.0,0.0,0.0,0.0,-12
6284,360000,1,1,2,29,0,0,-1,-1,-1,-1,15854,8174,1004,1004,646,3508,1000,1004,1004,646,3508,0,0,14854,7170,0,358,-2862,3508,0.04126111111111111,0.019916666666666666,0.0,0.0009944444444444445,-0.00795,0.009744444444444444,-4
6285,220000,1,1,1,37,0,0,0,0,0,0,152197,154167,158981,162348,164162,168013,6000,7300,7500,6000,6500,7000,1,146197,146867,151481,156348,157662,161013,0.6645318181818182,0.6675772727272727,0.68855,0.7106727272727272,0.7166454545454546,0.7318772727272728,0
6286,320000,1,2,1,32,0,0,0,0,0,0,101121,86781,74909,55472,53699,46313,5800,9805,5006,3704,12860,13201,1,95321,76976,69903,51768,40839,33112,0.297878125,0.24055,0.218446875,0.161775,0.127621875,0.103475,0
6287,230000,1,2,2,30,-2,-1,0,0,0,0,0,63508,59835,60963,59337,71089,63508,2300,2200,2200,25000,2400,0,-63508,61208,57635,58763,34337,68689,-0.2761217391304348,0.2661217391304348,0.2505869565217391,0.2554913043478261,0.1492913043478261,0.2986478260869565,-3
6288,150000,0,3,1,39,-2,-2,-2,-2,-2,-2,0,0,0,0,0,0,0,0,0,0,0,0,1,0,0,0,0,0,0,0.0,0.0,0.0,0.0,0.0,0.0,-12
6289,90000,1,3,1,46,0,0,0,0,0,0,5965,6978,8152,9009,9359,9460,1120,1293,1150,500,400,400,1,4845,5685,7002,8509,8959,9060,0.05383333333333333,0.06316666666666666,0.0778,0.09454444444444444,0.09954444444444445,0.10066666666666667,0
6290,120000,1,1,2,31,1,-1,-1,0,-1,-1,0,1730,2457,2192,2655,0,1730,2459,0,2655,0,0,0,-1730,-729,2457,-463,2655,0,-0.014416666666666666,-0.006075,0.020475,-0.0038583333333333334,0.022125,0.0,-3
6291,360000,0,2,2,28,-1,-1,-1,-1,-1,-1,7156,9780,6672,11201,9718,8781,9849,6712,11244,9747,8806,11872,0,-2693,3068,-4572,1454,912,-3091,-0.007480555555555555,0.008522222222222223,-0.0127,0.004038888888888889,0.002533333333333333,-0.00858611111111111,-6
6292,100000,1,3,1,42,-1,-1,-1,-1,-1,-1,1651,631,3611,631,631,0,631,3611,631,631,0,2113,1,1020,-2980,2980,0,631,-2113,0.0102,-0.0298,0.0298,0.0,0.00631,-0.02113,-6
6293,200000,0,1,1,44,-1,-1,-2,-2,-2,-2,667,0,0,0,0,0,0,0,0,0,0,0,1,667,0,0,0,0,0,0.003335,0.0,0.0,0.0,0.0,0.0,-10
6294,20000,0,3,2,45,1,-1,-1,-1,-1,-2,0,390,0,780,0,0,780,0,780,0,0,0,0,-780,390,-780,780,0,0,-0.039,0.0195,-0.039,0.039,0.0,0.0,-5
6295,50000,0,2,1,37,0,0,0,0,-2,-2,23607,24921,25775,0,0,0,2000,1800,0,0,0,0,1,21607,23121,25775,0,0,0,0.43214,0.46242,0.5155,0.0,0.0,0.0,-4
6296,20000,0,2,2,30,2,2,2,0,0,0,20586,20568,20185,20016,20044,20172,1300,700,700,1700,1600,700,0,19286,19868,19485,18316,18444,19472,0.9643,0.9934,0.97425,0.9158,0.9222,0.9736,6
6297,160000,1,1,1,34,-1,-1,-1,-1,-1,-1,1072,3297,5923,158,11030,158,3297,5939,158,11030,158,158,1,-2225,-2642,5765,-10872,10872,0,-0.01390625,-0.0165125,0.03603125,-0.06795,0.06795,0.0,-6
6298,150000,1,2,2,28,0,-1,0,-1,-1,-2,12272,4447,5228,1623,0,0,4447,1000,1623,0,0,0,0,7825,3447,3605,1623,0,0,0.05216666666666667,0.02298,0.024033333333333334,0.01082,0.0,0.0,-5
6299,230000,0,2,2,36,-2,-2,-2,-2,-2,-2,3245,1855,2577,8001,2970,-1,1864,2590,8039,2984,0,381,0,1381,-735,-5462,5017,2970,-382,0.006004347826086957,-0.0031956521739130435,-0.02374782608695652,0.02181304347826087,0.01291304347826087,-0.0016608695652173913,-12
6300,100000,0,3,2,24,1,2,0,0,0,0,100364,97551,66365,62913,9389,6076,107,2893,2104,312,207,2004,0,100257,94658,64261,62601,9182,4072,1.00257,0.94658,0.64261,0.62601,0.09182,0.04072,3
6301,210000,1,1,1,66,0,0,0,0,0,0,132797,135581,138644,141679,92170,93998,4921,5317,5631,3345,3360,3483,1,127876,130264,133013,138334,88810,90515,0.6089333333333333,0.6203047619047619,0.6333952380952381,0.6587333333333333,0.4229047619047619,0.43102380952380953,0
6302,30000,0,3,2,28,1,2,2,2,0,0,25554,28031,28345,27591,28218,29880,3204,1068,0,1068,2136,600,0,22350,26963,28345,26523,26082,29280,0.745,0.8987666666666667,0.9448333333333333,0.8841,0.8694,0.976,7
6303,90000,1,1,1,41,2,2,2,2,2,2,78700,80348,81630,82890,84709,86252,3500,3200,3200,3300,3100,3100,1,75200,77148,78430,79590,81609,83152,0.8355555555555556,0.8572,0.8714444444444445,0.8843333333333333,0.9067666666666667,0.9239111111111111,12
6304,20000,1,3,1,43,-1,-1,-1,0,-1,-1,390,0,780,390,390,0,0,1170,0,390,0,780,1,390,-1170,780,0,390,-780,0.0195,-0.0585,0.039,0.0,0.0195,-0.039,-5
6305,390000,1,1,1,34,-2,-2,-2,-1,-1,0,7639,10876,6203,1518,46365,48795,6083,1051,1545,47280,3000,3000,1,1556,9825,4658,-45762,43365,45795,0.0039897435897435895,0.02519230769230769,0.011943589743589743,-0.11733846153846154,0.11119230769230769,0.11742307692307692,-8
6306,50000,1,2,2,24,-1,-1,-1,-1,0,0,390,390,390,780,780,0,390,390,780,0,0,0,0,0,0,-390,780,780,0,0.0,0.0,-0.0078,0.0156,0.0156,0.0,-4
6307,110000,1,2,2,32,1,-1,-1,-1,-1,0,-296,1733,-153,6540,632,316,2345,0,7009,632,0,36049,0,-2641,1733,-7162,5908,632,-35733,-0.02400909090909091,0.015754545454545455,-0.06510909090909091,0.05370909090909091,0.005745454545454546,-0.32484545454545455,-3
6308,70000,1,1,2,25,0,0,0,0,0,0,66738,68601,65615,66429,67858,69723,3005,3000,2500,2500,3000,1400,0,63733,65601,63115,63929,64858,68323,0.9104714285714286,0.9371571428571429,0.9016428571428572,0.9132714285714286,0.9265428571428571,0.9760428571428571,0
6309,260000,1,1,1,32,-1,-1,2,-1,-1,-1,598,2268,2268,1732,718,165,2268,0,1732,718,165,3735,1,-1670,2268,536,1014,553,-3570,-0.006423076923076923,0.008723076923076924,0.0020615384615384614,0.0039,0.002126923076923077,-0.01373076923076923,-3
6310,100000,1,2,2,43,0,0,0,2,2,0,51146,54716,58766,58950,56889,60255,5000,5500,2300,0,5000,5000,0,46146,49216,56466,58950,51889,55255,0.46146,0.49216,0.56466,0.5895,0.51889,0.55255,4
6311,280000,0,2,1,31,0,0,0,0,0,0,266511,269245,268332,271904,157565,150665,9557,10001,8585,4761,5082,5008,1,256954,259244,259747,267143,152483,145657,0.9176928571428571,0.9258714285714286,0.9276678571428572,0.9540821428571429,0.5445821428571429,0.5202035714285714,0
6312,120000,0,1,2,36,0,0,2,0,0,2,24466,28255,27507,27952,31136,30486,4500,0,1200,3800,0,1500,0,19966,28255,26307,24152,31136,28986,0.16638333333333333,0.23545833333333333,0.219225,0.20126666666666668,0.2594666666666667,0.24155,4
6313,210000,0,1,2,32,-2,-2,-2,-2,-2,-1,918,1144,3977,5365,789,1086,1146,3988,5381,791,1088,948,0,-228,-2844,-1404,4574,-299,138,-0.0010857142857142858,-0.013542857142857143,-0.006685714285714285,0.02178095238095238,-0.0014238095238095238,0.0006571428571428571,-11
6314,60000,1,3,2,45,0,0,0,0,0,0,54920,39886,40056,39996,40261,32644,1726,1502,1287,1322,1179,1156,0,53194,38384,38769,38674,39082,31488,0.8865666666666666,0.6397333333333334,0.64615,0.6445666666666666,0.6513666666666666,0.5248,0
6315,500000,0,3,2,53,-1,-1,-1,-1,-1,2,17362,16666,16666,16666,33923,16666,16666,16666,16666,33923,0,16666,0,696,0,0,-17257,33923,0,0.001392,0.0,0.0,-0.034514,0.067846,0.0,-3
6316,100000,0,1,2,28,0,0,0,0,0,0,12332,12832,8564,7241,7364,7542,1296,1123,1000,223,1500,0,0,11036,11709,7564,7018,5864,7542,0.11036,0.11709,0.07564,0.07018,0.05864,0.07542,0
6317,280000,1,2,2,28,-2,-2,-2,-2,-2,-2,17795,4117,1199,247,0,1896,4125,1201,249,0,1896,548,0,13670,2916,950,247,-1896,1348,0.04882142857142857,0.010414285714285714,0.0033928571428571428,0.0008821428571428572,-0.0067714285714285715,0.0048142857142857145,-12
6318,310000,0,1,2,37,-2,-2,-2,-2,-2,-2,0,0,0,0,0,0,0,0,0,0,0,0,0,0,0,0,0,0,0,0.0,0.0,0.0,0.0,0.0,0.0,-12
6319,80000,1,2,1,29,1,2,2,0,0,0,56340,57022,55081,55350,55906,57538,2600,0,2200,2028,3000,2200,1,53740,57022,52881,53322,52906,55338,0.67175,0.712775,0.6610125,0.666525,0.661325,0.691725,5
6320,220000,0,2,2,30,-1,-1,2,-1,2,2,776,1552,776,221876,223986,204957,1552,0,221876,7500,4,10000,0,-776,1552,-221100,214376,223982,194957,-0.0035272727272727274,0.007054545454545455,-1.005,0.9744363636363637,1.0181,0.8861681818181818,3
6321,50000,0,2,2,41,0,0,0,0,0,0,39369,40710,42736,43751,44619,45900,2000,3000,1729,1597,2000,1709,0,37369,37710,41007,42154,42619,44191,0.74738,0.7542,0.82014,0.84308,0.85238,0.88382,0
6322,180000,1,1,2,27,0,0,0,0,0,0,101489,78738,78639,44295,44113,37805,10006,8000,1610,10000,1333,8818,0,91483,70738,77029,34295,42780,28987,0.5082388888888889,0.3929888888888889,0.42793888888888887,0.19052777777777777,0.23766666666666666,0.1610388888888889,0
6323,180000,0,1,1,35,1,2,2,2,2,2,133424,134835,131176,139976,138325,146136,5000,0,11000,700,10300,0,1,128424,134835,120176,139276,128025,146136,0.7134666666666667,0.7490833333333333,0.6676444444444445,0.7737555555555555,0.71125,0.8118666666666666,11
6324,280000,0,1,1,45,-1,-1,-1,-1,-1,-1,2270,1703,-15,30943,15631,17508,1703,0,30958,15631,17508,10049,1,567,1703,-30973,15312,-1877,7459,0.002025,0.006082142857142857,-0.11061785714285714,0.05468571428571429,-0.0067035714285714285,0.026639285714285713,-6
6325,20000,1,2,1,50,0,0,0,0,2,0,13779,14788,15815,17891,17308,17521,1245,1272,2348,0,640,1615,1,12534,13516,13467,17891,16668,15906,0.6267,0.6758,0.67335,0.89455,0.8334,0.7953,2
6326,360000,0,1,1,35,-1,-1,-1,-2,-2,-2,3771,900,0,0,0,0,900,0,0,0,0,0,1,2871,900,0,0,0,0,0.007975,0.0025,0.0,0.0,0.0,0.0,-9
6327,150000,1,1,2,28,2,0,0,0,0,0,65809,55997,46392,36172,25767,16791,1498,1614,1227,655,2000,5000,0,64311,54383,45165,35517,23767,11791,0.42874,0.36255333333333334,0.3011,0.23678,0.15844666666666668,0.07860666666666667,2
6328,60000,1,1,2,28,0,0,2,0,0,0,6393,10540,10232,11237,11427,20973,4278,0,1483,673,10000,11540,0,2115,10540,8749,10564,1427,9433,0.03525,0.17566666666666667,0.14581666666666668,0.17606666666666668,0.023783333333333333,0.15721666666666667,2
6329,150000,1,2,2,25,-1,-1,-1,-1,0,-1,1344,1041,2021,4495,15145,525,1041,2021,4495,10650,525,0,0,303,-980,-2474,-6155,14620,525,0.00202,-0.006533333333333334,-0.016493333333333332,-0.04103333333333333,0.09746666666666666,0.0035,-5
6330,100000,0,2,1,29,0,0,0,0,0,0,66195,62771,63533,57079,16634,26438,2303,3000,3000,1000,10022,3065,1,63892,59771,60533,56079,6612,23373,0.63892,0.59771,0.60533,0.56079,0.06612,0.23373,0
6331,210000,1,3,1,41,-2,-2,-2,-2,-2,-2,16486,15725,18210,10784,41477,6879,15728,18213,10784,41477,6879,9498,1,758,-2488,7426,-30693,34598,-2619,0.0036095238095238094,-0.011847619047619048,0.03536190476190476,-0.14615714285714285,0.16475238095238096,-0.01247142857142857,-12
6332,130000,1,1,2,26,-2,-2,-2,-2,-2,-1,0,0,0,402,0,2054,0,0,402,0,2054,0,0,0,0,-402,402,-2054,2054,0.0,0.0,-0.0030923076923076924,0.0030923076923076924,-0.0158,0.0158,-11
6333,250000,0,1,2,32,3,2,2,2,2,2,2500,2500,2500,2500,2500,2500,0,0,0,0,0,0,0,2500,2500,2500,2500,2500,2500,0.01,0.01,0.01,0.01,0.01,0.01,13
6334,420000,0,1,1,47,0,0,0,0,0,0,54799,53507,54678,55403,56260,57598,5000,5000,3000,3000,3000,3000,1,49799,48507,51678,52403,53260,54598,0.11856904761904762,0.11549285714285715,0.12304285714285715,0.12476904761904761,0.12680952380952382,0.1299952380952381,0
6335,30000,0,2,1,33,0,0,0,0,0,0,23900,25507,26489,27017,56186,29146,2000,1418,946,1437,3000,0,1,21900,24089,25543,25580,53186,29146,0.73,0.8029666666666667,0.8514333333333334,0.8526666666666667,1.7728666666666666,0.9715333333333334,0
6336,310000,1,2,1,37,-2,-2,-1,0,0,0,0,0,5365,6274,7017,8893,0,5365,1000,1000,2000,2000,1,0,-5365,4365,5274,5017,6893,0.0,-0.017306451612903225,0.014080645161290322,0.017012903225806453,0.016183870967741935,0.022235483870967743,-5
6337,20000,0,2,2,27,0,0,0,0,-2,-2,2003,2948,3372,0,0,0,1086,1000,0,0,0,0,0,917,1948,3372,0,0,0,0.04585,0.0974,0.1686,0.0,0.0,0.0,-4
6338,140000,1,1,2,28,-1,-1,-1,-1,-2,-2,8483,9526,33788,-18,-18,-18,9532,33788,0,0,0,0,0,-1049,-24262,33788,-18,-18,-18,-0.007492857142857143,-0.1733,0.24134285714285714,-0.00012857142857142858,-0.00012857142857142858,-0.00012857142857142858,-8
6339,310000,0,1,1,48,0,0,-1,-1,-1,2,29662,5384,4488,2630,150,335,1536,4510,2652,150,185,0,1,28126,874,1836,2480,-35,335,0.09072903225806452,0.0028193548387096773,0.00592258064516129,0.008,-0.00011290322580645161,0.0010806451612903225,-1
6340,260000,1,1,1,30,0,0,0,0,0,0,25661,30196,69429,167640,169446,172989,5000,40000,100000,5720,5922,5958,1,20661,-9804,-30571,161920,163524,167031,0.07946538461538462,-0.03770769230769231,-0.11758076923076922,0.6227692307692307,0.6289384615384616,0.6424269230769231,0
6341,180000,1,1,1,47,0,0,0,0,0,0,174648,104179,84940,65613,67256,71934,5000,13000,3000,2700,6000,5000,1,169648,91179,81940,62913,61256,66934,0.9424888888888889,0.50655,0.4552222222222222,0.34951666666666664,0.3403111111111111,0.37185555555555555,0
6342,360000,1,3,1,29,1,-2,-2,-2,-2,-2,0,0,0,0,0,0,0,0,0,0,0,0,1,0,0,0,0,0,0,0.0,0.0,0.0,0.0,0.0,0.0,-9
6343,220000,1,1,1,31,0,0,0,0,0,0,67722,74057,75767,77902,79505,82061,7500,3500,4000,3500,4000,3000,1,60222,70557,71767,74402,75505,79061,0.2737363636363636,0.32071363636363637,0.3262136363636364,0.3381909090909091,0.34320454545454543,0.3593681818181818,0
6344,50000,1,2,2,25,0,0,0,0,0,2,51461,51179,50628,50154,53936,51459,2000,1771,1770,6038,0,2112,0,49461,49408,48858,44116,53936,49347,0.98922,0.98816,0.97716,0.88232,1.07872,0.98694,2
6345,80000,1,1,2,28,1,2,2,2,2,2,53541,54694,55297,55788,57146,58351,2600,2100,2000,2400,2300,2315,0,50941,52594,53297,53388,54846,56036,0.6367625,0.657425,0.6662125,0.66735,0.685575,0.70045,11
6346,50000,0,3,2,26,-2,-2,-2,-2,-2,-2,0,0,0,0,0,0,0,0,0,0,0,0,0,0,0,0,0,0,0,0.0,0.0,0.0,0.0,0.0,0.0,-12
6347,20000,0,3,2,57,-1,-1,-2,-1,-1,-1,170,-220,-610,18990,390,930,0,0,19990,390,930,0,0,170,-220,-20600,18600,-540,930,0.0085,-0.011,-1.03,0.93,-0.027,0.0465,-7
6348,200000,0,3,1,43,-1,-1,-1,0,0,-1,1435,1270,3783,2522,1261,1436,1270,4000,0,0,1436,1261,1,165,-2730,3783,2522,-175,175,0.000825,-0.01365,0.018915,0.01261,-0.000875,0.000875,-4
6349,30000,1,3,1,46,-1,-1,-1,2,0,0,2572,8822,5786,2749,28241,26960,8848,5869,0,26965,1066,3196,1,-6276,2953,5786,-24216,27175,23764,-0.2092,0.09843333333333333,0.19286666666666666,-0.8072,0.9058333333333334,0.7921333333333334,-1
6350,400000,1,1,2,31,-2,-2,-2,-2,-2,-2,-287,-287,5439,5747,687,19898,0,5726,5753,687,19934,40024,0,-287,-6013,-314,5060,-19247,-20126,-0.0007175,-0.0150325,-0.000785,0.01265,-0.0481175,-0.050315,-12
6351,80000,1,3,1,48,0,-1,-1,-1,-1,-1,33058,1945,2587,2108,1921,2071,1945,2587,2108,1936,2071,0,1,31113,-642,479,172,-150,2071,0.3889125,-0.008025,0.0059875,0.00215,-0.001875,0.0258875,-5
6352,20000,0,2,1,33,0,0,0,0,0,0,11026,9535,10510,10472,10140,10101,1174,1149,501,356,507,458,1,9852,8386,10009,10116,9633,9643,0.4926,0.4193,0.50045,0.5058,0.48165,0.48215,0
6353,50000,1,3,1,40,0,0,2,2,-2,-2,48747,53239,51400,0,0,0,5300,0,0,0,0,0,1,43447,53239,51400,0,0,0,0.86894,1.06478,1.028,0.0,0.0,0.0,0
6354,300000,0,1,2,31,1,-1,-1,-1,-1,-1,-122,22953,3565,19869,26249,1332,23075,3583,19969,26380,1338,0,0,-23197,19370,-16404,-6511,24911,1332,-0.07732333333333333,0.06456666666666666,-0.05468,-0.021703333333333335,0.08303666666666666,0.00444,-4
6355,30000,1,3,2,31,-1,-1,-1,-1,-1,-2,5477,7314,2970,2587,0,0,8011,2970,2587,0,0,0,0,-2534,4344,383,2587,0,0,-0.08446666666666666,0.1448,0.012766666666666667,0.08623333333333333,0.0,0.0,-7
6356,170000,0,1,1,39,2,2,2,2,4,3,74298,80073,81959,89991,88018,86299,7000,3800,10000,0,0,3100,1,67298,76273,71959,89991,88018,83199,0.39587058823529414,0.44866470588235297,0.42328823529411763,0.5293588235294118,0.5177529411764706,0.4894058823529412,15
6357,50000,1,2,1,50,0,0,0,-1,-1,-1,48119,48318,21750,4387,4392,9493,1554,1028,4387,4392,9493,492,1,46565,47290,17363,-5,-5101,9001,0.9313,0.9458,0.34726,-0.0001,-0.10202,0.18002,-3
6358,30000,1,2,1,38,3,2,0,0,0,-1,3379,1715,1170,780,390,150,0,1100,0,0,150,780,1,3379,615,1170,780,240,-630,0.11263333333333334,0.0205,0.039,0.026,0.008,-0.021,4
6359,150000,1,1,2,25,-1,-1,-1,2,2,-2,2784,0,594,594,0,0,0,594,0,0,0,0,0,2784,-594,594,594,0,0,0.01856,-0.00396,0.00396,0.00396,0.0,0.0,-1
6360,220000,1,1,2,29,-2,-2,-2,-1,-1,-1,0,799,0,5501,3816,15448,799,0,5501,3816,15448,4179,0,-799,799,-5501,1685,-11632,11269,-0.003631818181818182,0.003631818181818182,-0.025004545454545453,0.007659090909090909,-0.05287272727272727,0.051222727272727274,-9
6361,50000,0,2,2,27,3,2,2,0,0,-1,13694,14880,14242,13968,14319,2614,1700,0,426,501,2614,1390,0,11994,14880,13816,13467,11705,1224,0.23988,0.2976,0.27632,0.26934,0.2341,0.02448,6
6362,110000,0,3,2,63,1,2,0,0,0,0,49992,48918,49890,46884,47350,43169,0,2164,1730,1788,1538,1607,0,49992,46754,48160,45096,45812,41562,0.45447272727272725,0.42503636363636366,0.43781818181818183,0.40996363636363636,0.41647272727272727,0.37783636363636364,3
6363,210000,0,1,2,28,-1,-1,-1,-1,-1,-1,1832,1074,1002,711,420,1572,1074,1002,711,420,1572,0,0,758,72,291,291,-1152,1572,0.0036095238095238094,0.00034285714285714285,0.0013857142857142857,0.0013857142857142857,-0.005485714285714286,0.007485714285714286,-6
6364,90000,1,2,1,27,0,0,0,0,0,0,20461,21465,22495,23504,23815,24311,1649,1679,1688,999,1029,1040,1,18812,19786,20807,22505,22786,23271,0.20902222222222222,0.21984444444444445,0.2311888888888889,0.25005555555555553,0.2531777777777778,0.25856666666666667,0
6365,500000,1,2,1,54,0,0,0,0,0,0,455977,397418,392278,375931,364134,354019,13455,13691,12692,11883,11922,10032,1,442522,383727,379586,364048,352212,343987,0.885044,0.767454,0.759172,0.728096,0.704424,0.687974,0
6366,30000,0,2,2,24,0,0,0,2,0,0,14597,15614,18246,17660,17768,18151,1568,3200,0,700,670,1500,0,13029,12414,18246,16960,17098,16651,0.4343,0.4138,0.6082,0.5653333333333334,0.5699333333333333,0.5550333333333334,2
6367,130000,1,1,2,25,1,2,-1,-1,-1,-1,2576,2356,5978,2750,3641,1735,0,6000,2750,3641,1735,7290,0,2576,-3644,3228,-891,1906,-5555,0.019815384615384617,-0.02803076923076923,0.02483076923076923,-0.006853846153846154,0.014661538461538462,-0.04273076923076923,-1
6368,170000,1,2,1,46,-1,-1,-1,-2,-1,-1,2741,1848,0,0,1542,3498,1848,0,0,1542,3498,8095,1,893,1848,0,-1542,-1956,-4597,0.005252941176470588,0.010870588235294118,0.0,-0.009070588235294118,-0.011505882352941177,-0.027041176470588235,-7
6369,260000,0,3,1,44,0,0,0,0,0,0,250416,257987,260104,253488,145630,148720,11000,7100,135546,4500,4590,4501,1,239416,250887,124558,248988,141040,144219,0.9208307692307692,0.96495,0.47906923076923075,0.9576461538461538,0.5424615384615384,0.5546884615384615,0
6370,350000,1,1,1,44,0,0,0,0,-1,-1,110819,115058,76156,51500,150,500,6000,4000,2500,150,500,0,1,104819,111058,73656,51350,-350,500,0.29948285714285716,0.31730857142857144,0.2104457142857143,0.1467142857142857,-0.001,0.0014285714285714286,-2
6371,100000,1,2,2,30,0,0,0,0,0,0,96636,95169,97303,99339,77082,77677,3402,3663,3788,2695,2772,2903,0,93234,91506,93515,96644,74310,74774,0.93234,0.91506,0.93515,0.96644,0.7431,0.74774,0
6372,50000,0,3,3,55,0,0,0,0,0,0,45555,41372,41544,13007,16233,14952,1968,1843,434,5000,582,679,0,43587,39529,41110,8007,15651,14273,0.87174,0.79058,0.8222,0.16014,0.31302,0.28546,0
6373,280000,0,1,2,30,-2,-2,-2,-2,-2,-2,3310,-6,4759,996,0,1199,0,4765,996,0,1199,909,0,3310,-4771,3763,996,-1199,290,0.011821428571428571,-0.017039285714285715,0.013439285714285714,0.0035571428571428572,-0.004282142857142857,0.0010357142857142856,-12
6374,120000,1,2,1,31,0,0,0,0,0,0,45716,44610,45428,34401,34360,35523,2000,1732,2041,1000,1500,1000,1,43716,42878,43387,33401,32860,34523,0.3643,0.35731666666666667,0.3615583333333333,0.27834166666666665,0.2738333333333333,0.2876916666666667,0
6375,180000,0,3,1,37,-1,-1,-1,0,-1,-1,1170,420,2745,3053,1012,1312,420,2745,1000,1392,1312,1110,1,750,-2325,1745,1661,-300,202,0.004166666666666667,-0.012916666666666667,0.009694444444444445,0.009227777777777777,-0.0016666666666666668,0.0011222222222222222,-5
6376,180000,1,1,2,27,2,2,0,0,2,2,153198,151128,152785,168657,165872,173667,1813,5667,18483,0,11000,1842,0,151385,145461,134302,168657,154872,171825,0.8410277777777778,0.8081166666666667,0.7461222222222222,0.9369833333333333,0.8604,0.9545833333333333,8
6377,10000,0,3,1,30,0,0,0,3,2,0,7470,8315,11267,10626,10160,10052,1141,3258,0,0,357,400,1,6329,5057,11267,10626,9803,9652,0.6329,0.5057,1.1267,1.0626,0.9803,0.9652,5
6378,50000,1,3,1,36,2,2,2,2,0,0,45557,46732,46589,30949,29857,30322,2200,1100,0,1224,1105,1400,1,43357,45632,46589,29725,28752,28922,0.86714,0.91264,0.93178,0.5945,0.57504,0.57844,8
6379,400000,1,2,1,32,0,0,0,0,0,0,183339,179701,179979,89317,59413,65890,10016,7473,6151,2000,7015,45,1,173323,172228,173828,87317,52398,65845,0.4333075,0.43057,0.43457,0.2182925,0.130995,0.1646125,0
6380,80000,0,2,2,29,-1,0,0,-1,0,0,10278,5991,4457,75743,76343,76567,1085,1000,75743,2667,3395,1772,0,9193,4991,-71286,73076,72948,74795,0.1149125,0.0623875,-0.891075,0.91345,0.91185,0.9349375,-2
6381,130000,1,2,1,28,0,0,0,0,0,0,86914,85558,77163,80240,46637,51409,6134,3100,5000,3000,6000,13031,1,80780,82458,72163,77240,40637,38378,0.6213846153846154,0.6342923076923077,0.5551,0.5941538461538461,0.31259230769230767,0.2952153846153846,0
6382,30000,0,1,2,26,4,3,2,0,0,-2,25899,25177,22768,18600,0,0,0,600,800,0,0,0,0,25899,24577,21968,18600,0,0,0.8633,0.8192333333333334,0.7322666666666666,0.62,0.0,0.0,7
6383,250000,1,1,1,27,0,0,0,0,0,0,85238,87797,75436,58695,41211,34987,20004,2893,2201,1215,10040,10041,1,65234,84904,73235,57480,31171,24946,0.260936,0.339616,0.29294,0.22992,0.124684,0.099784,0
6384,530000,0,2,1,54,-2,-2,-2,-2,-1,0,-30,-420,390,390,166210,129716,0,1200,390,166210,6000,3000,1,-30,-1620,0,-165820,160210,126716,-5.660377358490566e-05,-0.0030566037735849055,0.0,-0.31286792452830187,0.3022830188679245,0.23908679245283018,-9
6385,110000,1,2,1,36,-1,-1,-1,-1,-1,-1,2002,1056,4680,880,880,880,1056,4756,880,880,880,880,1,946,-3700,3800,0,0,0,0.0086,-0.03363636363636364,0.034545454545454546,0.0,0.0,0.0,-6
6386,20000,1,2,1,59,1,2,0,0,0,-2,19328,18711,17657,20000,0,0,0,1700,3000,0,0,0,1,19328,17011,14657,20000,0,0,0.9664,0.85055,0.73285,1.0,0.0,0.0,1
6387,100000,1,1,2,28,2,0,0,0,0,0,96193,82342,81967,82177,78840,79261,3600,3800,3000,3000,3023,3000,0,92593,78542,78967,79177,75817,76261,0.92593,0.78542,0.78967,0.79177,0.75817,0.76261,2
6388,300000,0,1,2,37,0,0,0,0,0,0,52268,53440,54615,47146,47486,16937,3000,3011,582,602,627,587,0,49268,50429,54033,46544,46859,16350,0.16422666666666666,0.16809666666666667,0.18011,0.15514666666666665,0.15619666666666668,0.0545,0
6389,50000,1,2,1,37,2,2,2,0,0,0,1894,3200,3381,3559,1948,2415,1500,400,200,500,500,400,1,394,2800,3181,3059,1448,2015,0.00788,0.056,0.06362,0.06118,0.02896,0.0403,6
6390,50000,0,3,1,49,0,0,0,0,0,0,49331,46429,47446,39516,17643,32230,2000,3030,4000,2000,2800,2936,1,47331,43399,43446,37516,14843,29294,0.94662,0.86798,0.86892,0.75032,0.29686,0.58588,0
6391,180000,1,2,2,25,0,0,0,0,0,0,109030,177633,139415,136942,114632,117808,78266,5203,30023,10024,10000,4458,0,30764,172430,109392,126918,104632,113350,0.17091111111111112,0.9579444444444445,0.6077333333333333,0.7051,0.5812888888888889,0.6297222222222222,0
6392,110000,0,3,1,43,-1,-1,-1,0,0,0,390,5050,63032,33228,31073,25035,5050,63032,1100,1100,1000,1000,1,-4660,-57982,61932,32128,30073,24035,-0.04236363636363636,-0.5271090909090909,0.5630181818181819,0.29207272727272726,0.2733909090909091,0.2185,-3
6393,110000,0,4,1,36,-1,0,0,0,0,0,3385,31169,50526,51816,34262,23366,28000,20000,3000,3000,3000,3000,1,-24615,11169,47526,48816,31262,20366,-0.22377272727272726,0.10153636363636363,0.43205454545454547,0.44378181818181817,0.2842,0.18514545454545456,-1
6394,30000,0,3,2,26,0,0,0,0,0,0,28337,27203,25791,18972,28051,20782,2000,2000,1600,10000,2140,0,0,26337,25203,24191,8972,25911,20782,0.8779,0.8401,0.8063666666666667,0.29906666666666665,0.8637,0.6927333333333333,0
6395,70000,1,3,1,38,0,0,0,0,0,0,24758,25581,16105,17571,18330,16268,1273,1534,2000,1000,1000,1000,1,23485,24047,14105,16571,17330,15268,0.3355,0.3435285714285714,0.2015,0.23672857142857143,0.24757142857142858,0.2181142857142857,0
6396,500000,0,1,1,47,-1,2,-1,0,0,-1,7233,2321,18261,16456,11225,36770,0,18261,0,0,40270,0,1,7233,-15940,18261,16456,-29045,36770,0.014466,-0.03188,0.036522,0.032912,-0.05809,0.07354,-1
6397,60000,1,2,2,35,0,0,0,-1,0,0,42174,40510,20513,22123,17094,18668,3090,10709,22154,1000,2000,700,0,39084,29801,-1641,21123,15094,17968,0.6514,0.4966833333333333,-0.02735,0.35205,0.25156666666666666,0.29946666666666666,-1
6398,50000,1,2,1,30,2,0,0,-2,-2,-2,6425,4580,0,0,0,0,1050,0,0,0,0,0,1,5375,4580,0,0,0,0,0.1075,0.0916,0.0,0.0,0.0,0.0,-4
6399,120000,1,2,1,50,0,0,2,0,0,0,38261,58084,33018,19172,14938,21290,23000,0,10076,10000,10000,10000,1,15261,58084,22942,9172,4938,11290,0.127175,0.4840333333333333,0.19118333333333334,0.07643333333333334,0.04115,0.09408333333333334,2
6400,140000,1,3,2,31,0,0,0,0,0,0,137254,92636,94641,96667,98883,79972,3320,3500,3600,3900,3000,3000,0,133934,89136,91041,92767,95883,76972,0.9566714285714286,0.6366857142857143,0.6502928571428571,0.6626214285714286,0.6848785714285714,0.5498,0
6401,230000,0,1,1,46,1,2,2,2,2,2,189724,193112,197039,200300,203018,199689,8000,8500,8000,7500,0,6622,1,181724,184612,189039,192800,203018,193067,0.790104347826087,0.8026608695652174,0.821908695652174,0.8382608695652174,0.8826869565217391,0.8394217391304348,11
6402,200000,0,3,1,44,0,0,0,0,0,0,138877,144085,142520,151078,176717,168431,6437,5000,10000,27080,10017,4200,1,132440,139085,132520,123998,166700,164231,0.6622,0.695425,0.6626,0.61999,0.8335,0.821155,0
6403,120000,1,2,1,40,1,2,3,2,3,2,57816,62139,60584,63871,62251,63443,5900,0,4900,0,2500,2500,1,51916,62139,55684,63871,59751,60943,0.4326333333333333,0.517825,0.46403333333333335,0.5322583333333334,0.497925,0.5078583333333333,13
6404,50000,1,1,2,23,0,0,0,0,0,0,33959,35409,36120,36991,37744,39115,2000,1601,1472,1500,2000,5000,0,31959,33808,34648,35491,35744,34115,0.63918,0.67616,0.69296,0.70982,0.71488,0.6823,0
6405,180000,1,3,2,40,-2,-2,-2,-2,-2,-2,0,0,0,0,0,0,0,0,0,0,0,0,0,0,0,0,0,0,0,0.0,0.0,0.0,0.0,0.0,0.0,-12
6406,20000,0,1,2,32,0,0,0,3,2,0,11777,14851,17575,17063,15711,28600,3276,3000,3,7,2058,669,0,8501,11851,17572,17056,13653,27931,0.42505,0.59255,0.8786,0.8528,0.68265,1.39655,5
6407,120000,1,2,2,23,0,0,0,0,0,0,100727,96551,69676,44879,43532,44467,4324,3234,1448,1400,1400,1400,0,96403,93317,68228,43479,42132,43067,0.8033583333333333,0.7776416666666667,0.5685666666666667,0.362325,0.3511,0.35889166666666666,0
6408,360000,0,2,2,29,0,0,0,0,0,0,114527,119487,113438,112940,122122,121547,20046,5046,10000,10048,10043,5014,0,94481,114441,103438,102892,112079,116533,0.2624472222222222,0.3178916666666667,0.2873277777777778,0.2858111111111111,0.31133055555555555,0.3237027777777778,0
6409,20000,1,3,1,27,3,2,0,0,0,0,16004,15450,16892,17396,14017,0,0,1696,1200,22,0,0,1,16004,13754,15692,17374,14017,0,0.8002,0.6877,0.7846,0.8687,0.70085,0.0,5
6410,120000,0,2,2,28,0,0,0,0,0,0,8022,9493,11612,12438,13099,15926,2000,3000,3000,3000,3000,3000,0,6022,6493,8612,9438,10099,12926,0.05018333333333334,0.054108333333333335,0.07176666666666667,0.07865,0.08415833333333333,0.10771666666666667,0
6411,210000,1,2,2,32,-1,-1,2,0,-1,-1,576,3578,34,10734,30367,8193,3578,0,10700,30367,19644,4431,0,-3002,3578,-10666,-19633,10723,3762,-0.014295238095238095,0.017038095238095238,-0.05079047619047619,-0.0934904761904762,0.05106190476190476,0.017914285714285716,-2
6412,50000,0,3,1,38,0,0,0,0,0,0,31304,33479,34617,35735,37154,38380,3000,2000,2000,2000,2000,2000,1,28304,31479,32617,33735,35154,36380,0.56608,0.62958,0.65234,0.6747,0.70308,0.7276,0
6413,280000,1,1,2,32,-1,0,0,0,0,0,215052,191094,195204,199091,201581,206054,7000,7200,8800,7300,7700,16000,0,208052,183894,186404,191791,193881,190054,0.7430428571428571,0.6567642857142857,0.6657285714285714,0.6849678571428571,0.6924321428571428,0.6787642857142857,-1
6414,450000,1,2,1,38,-2,-2,-2,-2,-2,-2,10972,15005,13887,17255,17515,0,15008,1200,5255,4566,0,3648,1,-4036,13805,8632,12689,17515,-3648,-0.008968888888888889,0.03067777777777778,0.019182222222222222,0.028197777777777776,0.03892222222222222,-0.008106666666666667,-12
6415,380000,0,1,2,33,0,0,0,0,0,0,77994,79099,80828,82583,84687,84832,3000,3000,3100,3500,3500,3200,0,74994,76099,77728,79083,81187,81632,0.19735263157894736,0.20026052631578947,0.20454736842105264,0.20811315789473683,0.21365,0.21482105263157894,0
6416,30000,1,4,1,36,-2,-2,-2,-2,-2,-2,8839,0,4342,690,0,99,0,4342,690,0,99,0,1,8839,-4342,3652,690,-99,99,0.29463333333333336,-0.14473333333333332,0.12173333333333333,0.023,-0.0033,0.0033,-12
6417,90000,1,2,1,50,0,0,-1,-1,-1,-1,76025,55440,11227,4000,5000,10327,10374,16926,4000,6000,10327,0,1,65651,38514,7227,-2000,-5327,10327,0.7294555555555555,0.42793333333333333,0.0803,-0.022222222222222223,-0.05918888888888889,0.11474444444444444,-4
6418,350000,1,1,2,27,0,0,0,0,0,0,83415,76562,64995,61464,44664,51550,4000,3312,4050,1165,20055,20076,0,79415,73250,60945,60299,24609,31474,0.2269,0.2092857142857143,0.17412857142857144,0.17228285714285715,0.07031142857142857,0.08992571428571429,0
6419,270000,1,3,1,58,-2,-2,-2,-2,-2,-2,936,1188,2078,795,828,1251,1188,2078,795,828,1251,2267,1,-252,-890,1283,-33,-423,-1016,-0.0009333333333333333,-0.0032962962962962963,0.004751851851851852,-0.00012222222222222221,-0.0015666666666666667,-0.003762962962962963,-12
6420,290000,1,2,1,41,0,0,2,0,0,0,4783,7239,6957,4954,7221,6988,2552,0,1000,5000,2500,3659,1,2231,7239,5957,-46,4721,3329,0.007693103448275862,0.024962068965517243,0.020541379310344828,-0.0001586206896551724,0.016279310344827585,0.011479310344827586,2
6421,170000,1,1,1,44,-2,-2,-2,-2,-2,-2,754,0,0,0,1903,0,0,0,0,1903,0,0,1,754,0,0,-1903,1903,0,0.004435294117647059,0.0,0.0,-0.011194117647058823,0.011194117647058823,0.0,-12
6422,240000,1,1,2,36,0,0,0,0,0,0,7283,5266,5113,7113,7113,4178,1263,1000,2000,2500,2000,5000,0,6020,4266,3113,4613,5113,-822,0.025083333333333332,0.017775,0.012970833333333332,0.019220833333333333,0.021304166666666666,-0.003425,0
6423,310000,1,2,2,37,0,0,0,-1,-1,-2,68430,72280,77097,7636,0,0,5000,7097,7636,0,0,2039,0,63430,65183,69461,7636,0,-2039,0.20461290322580644,0.21026774193548387,0.22406774193548387,0.02463225806451613,0.0,-0.00657741935483871,-4
6424,80000,1,2,1,34,-1,-1,-1,-1,0,-1,1383,5030,1964,7541,3201,5026,5030,1964,7568,0,5026,2371,1,-3647,3066,-5604,7541,-1825,2655,-0.0455875,0.038325,-0.07005,0.0942625,-0.0228125,0.0331875,-5
6425,20000,1,3,1,41,-1,-1,-1,0,0,0,780,0,732,642,1252,643,0,732,300,1000,500,1000,1,780,-732,432,-358,752,-357,0.039,-0.0366,0.0216,-0.0179,0.0376,-0.01785,-3
6426,250000,0,1,2,35,-1,-1,-1,-1,-1,-1,2746,1666,3572,76552,100566,0,1666,3597,76552,100566,0,0,0,1080,-1931,-72980,-24014,100566,0,0.00432,-0.007724,-0.29192,-0.096056,0.402264,0.0,-6
6427,50000,1,1,2,27,0,0,0,0,0,0,28387,36276,17445,15575,8075,-589,10000,1031,4050,4000,0,0,0,18387,35245,13395,11575,8075,-589,0.36774,0.7049,0.2679,0.2315,0.1615,-0.01178,0
6428,30000,1,2,1,23,0,0,0,0,2,0,21710,23021,23851,26067,25357,25887,1670,1500,2609,0,930,946,1,20040,21521,21242,26067,24427,24941,0.668,0.7173666666666667,0.7080666666666666,0.8689,0.8142333333333334,0.8313666666666667,2
6429,20000,0,2,2,27,0,0,0,0,0,-2,18290,20144,19106,19292,0,0,2458,1200,386,1000,0,0,0,15832,18944,18720,18292,0,0,0.7916,0.9472,0.936,0.9146,0.0,0.0,-2
6430,50000,0,3,2,28,0,0,0,0,0,0,57207,58211,48160,48398,17942,16334,2000,2100,1300,650,600,1652,0,55207,56111,46860,47748,17342,14682,1.10414,1.12222,0.9372,0.95496,0.34684,0.29364,0
6431,140000,0,3,1,43,-1,0,0,0,0,0,139445,137950,133250,98147,98924,95100,5500,5000,3500,3510,3500,3500,1,133945,132950,129750,94637,95424,91600,0.95675,0.9496428571428571,0.9267857142857143,0.6759785714285714,0.6816,0.6542857142857142,-1
6432,20000,0,2,2,23,0,0,0,2,0,0,14784,15483,18109,17521,18026,19082,1253,2879,0,796,1500,0,0,13531,12604,18109,16725,16526,19082,0.67655,0.6302,0.90545,0.83625,0.8263,0.9541,2
6433,20000,0,2,2,51,-1,-1,-2,-1,-1,-2,780,0,-1500,780,0,0,0,0,2280,0,0,0,0,780,0,-3780,780,0,0,0.039,0.0,-0.189,0.039,0.0,0.0,-8
6434,270000,0,1,1,37,0,0,0,0,0,0,156346,159223,165480,76144,77944,76577,7000,9000,5000,3000,3000,3000,1,149346,150223,160480,73144,74944,73577,0.5531333333333334,0.5563814814814815,0.5943703703703703,0.2709037037037037,0.27757037037037036,0.2725074074074074,0
6435,40000,1,3,1,39,0,0,2,2,2,2,34378,37584,38072,37160,39628,40428,3768,1400,0,3081,1600,0,1,30610,36184,38072,34079,38028,40428,0.76525,0.9046,0.9518,0.851975,0.9507,1.0107,8
6436,20000,1,2,1,29,0,0,0,0,0,0,13958,15016,16069,16776,17118,19835,1600,1600,1278,620,3000,900,1,12358,13416,14791,16156,14118,18935,0.6179,0.6708,0.73955,0.8078,0.7059,0.94675,0
6437,90000,1,1,2,31,0,0,2,0,0,-1,63872,66983,63070,1184,4154,3502,5003,0,1000,4000,3502,1400,0,58869,66983,62070,-2816,652,2102,0.6541,0.7442555555555556,0.6896666666666667,-0.03128888888888889,0.007244444444444445,0.023355555555555556,1
6438,490000,0,1,1,50,-1,-1,-1,-1,-1,-1,17884,6836,4657,3398,1476,1602,6836,4657,3398,1476,1602,7531,1,11048,2179,1259,1922,-126,-5929,0.022546938775510204,0.004446938775510204,0.002569387755102041,0.003922448979591837,-0.00025714285714285715,-0.0121,-6
6439,450000,0,2,2,37,0,0,-1,-1,0,0,457627,38692,4549,16885,6440,7440,1000,4549,16885,129,1000,0,0,456627,34143,-12336,16756,5440,7440,1.0147266666666668,0.07587333333333333,-0.027413333333333335,0.037235555555555556,0.012088888888888889,0.016533333333333334,-2
6440,10000,0,1,2,30,3,2,2,7,7,7,2300,2300,2300,2300,2300,2300,0,0,0,0,0,0,0,2300,2300,2300,2300,2300,2300,0.23,0.23,0.23,0.23,0.23,0.23,28
6441,50000,0,3,1,37,5,4,3,2,0,0,54078,52946,51841,50306,49706,49706,0,0,0,0,0,0,1,54078,52946,51841,50306,49706,49706,1.08156,1.05892,1.03682,1.00612,0.99412,0.99412,14
6442,20000,0,2,2,23,1,3,2,2,0,0,17529,16967,17176,16605,17185,18340,0,780,0,1000,1600,1000,0,17529,16187,17176,15605,15585,17340,0.87645,0.80935,0.8588,0.78025,0.77925,0.867,8
6443,50000,0,2,2,32,0,0,0,0,2,2,48934,25276,18588,19994,20258,19783,1602,1320,1718,729,0,397,0,47332,23956,16870,19265,20258,19386,0.94664,0.47912,0.3374,0.3853,0.40516,0.38772,4
6444,290000,1,2,1,53,-1,-1,-1,-1,-1,-1,1538,199,1440,1017,3798,4898,199,1440,1017,3798,4898,5034,1,1339,-1241,423,-2781,-1100,-136,0.004617241379310345,-0.004279310344827586,0.0014586206896551725,-0.009589655172413792,-0.003793103448275862,-0.0004689655172413793,-6
6445,240000,1,1,2,33,0,0,0,0,0,0,239278,237018,238641,230758,196830,201112,9582,9963,8013,6658,7059,6609,0,229696,227055,230628,224100,189771,194503,0.9570666666666666,0.9460625,0.96095,0.93375,0.7907125,0.8104291666666666,0
6446,370000,1,2,2,38,0,0,0,0,0,0,75823,63617,65585,67223,62201,64356,5000,3000,3003,3000,3500,60000,0,70823,60617,62582,64223,58701,4356,0.19141351351351352,0.16382972972972973,0.16914054054054053,0.17357567567567567,0.15865135135135136,0.011772972972972973,0
6447,220000,1,1,1,26,0,0,0,0,0,0,52593,65221,73395,81697,57517,58920,15000,10000,10000,5000,1776,10000,1,37593,55221,63395,76697,55741,48920,0.17087727272727274,0.2510045454545455,0.2881590909090909,0.34862272727272725,0.2533681818181818,0.22236363636363637,0
6448,200000,0,2,1,40,1,2,2,0,-1,0,303719,268163,228720,234177,201490,190721,5133,0,5857,202076,6726,5346,1,298586,268163,222863,32101,194764,185375,1.49293,1.340815,1.114315,0.160505,0.97382,0.926875,4
6449,110000,1,1,2,28,0,0,2,2,-2,-2,101138,69449,34983,-18,-18,-18,3400,0,0,0,0,0,0,97738,69449,34983,-18,-18,-18,0.8885272727272727,0.6313545454545455,0.3180272727272727,-0.00016363636363636363,-0.00016363636363636363,-0.00016363636363636363,0
6450,30000,0,3,1,35,0,0,0,0,0,0,28486,28182,26168,23119,23268,29327,2000,3000,5000,3000,7000,1156,1,26486,25182,21168,20119,16268,28171,0.8828666666666667,0.8394,0.7056,0.6706333333333333,0.5422666666666667,0.9390333333333334,0
6451,10000,0,2,2,24,1,2,2,2,2,2,6496,6246,8965,8672,9525,9228,0,3000,0,1000,0,800,0,6496,3246,8965,7672,9525,8428,0.6496,0.3246,0.8965,0.7672,0.9525,0.8428,11
6452,160000,1,2,1,55,0,0,0,0,0,0,86179,83960,61589,58702,56853,56002,4000,3000,2000,2000,3000,5000,1,82179,80960,59589,56702,53853,51002,0.51361875,0.506,0.37243125,0.3543875,0.33658125,0.3187625,0
6453,360000,1,2,1,32,0,-1,-1,-1,-1,-1,101403,2389,11996,0,67372,66666,2389,11996,0,67372,66666,66666,1,99014,-9607,11996,-67372,706,0,0.2750388888888889,-0.026686111111111112,0.033322222222222225,-0.18714444444444445,0.001961111111111111,0.0,-5
6454,200000,0,1,2,40,0,0,0,0,0,0,66052,68994,70825,73902,74943,76996,3800,3300,4000,2600,3000,3000,0,62252,65694,66825,71302,71943,73996,0.31126,0.32847,0.334125,0.35651,0.359715,0.36998,0
6455,220000,1,1,2,36,-2,-2,-2,-2,-2,-2,122,104,2635,2460,859,2784,104,2653,2472,859,2784,2287,0,18,-2549,163,1601,-1925,497,8.181818181818182e-05,-0.011586363636363636,0.0007409090909090909,0.007277272727272727,-0.00875,0.002259090909090909,-12
6456,110000,1,1,2,32,1,2,0,0,0,2,58679,56871,56279,24271,52040,25453,1210,2056,1200,2300,0,1000,0,57469,54815,55079,21971,52040,24453,0.5224454545454545,0.4983181818181818,0.5007181818181818,0.19973636363636363,0.4730909090909091,0.2223,5
6457,320000,1,1,2,32,-2,-2,-2,-2,-2,-2,-1,-1,-1,-1,0,-400,0,0,0,1,400,6083,0,-1,-1,-1,-2,-400,-6483,-3.125e-06,-3.125e-06,-3.125e-06,-6.25e-06,-0.00125,-0.020259375,-12
6458,200000,1,1,1,42,0,0,0,0,0,0,23242,24575,25284,25938,26478,26889,1711,1420,1074,1107,1000,1000,1,21531,23155,24210,24831,25478,25889,0.107655,0.115775,0.12105,0.124155,0.12739,0.129445,0
6459,120000,0,2,2,25,0,0,0,0,0,0,120633,118741,104754,79227,77751,69889,4622,3384,2589,3000,2460,1300,0,116011,115357,102165,76227,75291,68589,0.9667583333333334,0.9613083333333333,0.851375,0.635225,0.627425,0.571575,0
6460,30000,0,2,2,23,0,0,0,0,0,0,26725,28289,29489,30237,30504,29771,2000,2000,1502,1112,1100,2000,0,24725,26289,27987,29125,29404,27771,0.8241666666666667,0.8763,0.9329,0.9708333333333333,0.9801333333333333,0.9257,0
6461,100000,0,1,2,29,-2,-2,-2,-2,-2,-2,390,390,390,780,0,599,390,390,780,0,599,0,0,0,0,-390,780,-599,599,0.0,0.0,-0.0039,0.0078,-0.00599,0.00599,-12
6462,300000,1,1,2,28,1,-2,-2,-2,-2,-2,0,0,0,0,0,0,0,0,0,0,0,0,0,0,0,0,0,0,0,0.0,0.0,0.0,0.0,0.0,0.0,-9
6463,320000,1,1,2,30,-1,-1,-1,-2,-2,-1,1663,7025,1189,0,2701,2043,7025,1189,0,2701,2043,0,0,-5362,5836,1189,-2701,658,2043,-0.01675625,0.0182375,0.003715625,-0.008440625,0.00205625,0.006384375,-8
6464,20000,0,2,2,26,0,0,0,0,0,0,4491,5906,7298,8515,9869,11196,1500,1500,1500,1500,1500,1500,0,2991,4406,5798,7015,8369,9696,0.14955,0.2203,0.2899,0.35075,0.41845,0.4848,0
6465,240000,0,2,2,30,0,0,0,0,0,-1,151127,155421,154926,148681,24105,9770,10000,10000,300,1000,9770,18037,0,141127,145421,154626,147681,14335,-8267,0.5880291666666667,0.6059208333333334,0.644275,0.6153375,0.059729166666666667,-0.034445833333333335,-1
6466,60000,1,2,2,31,1,2,0,0,0,2,20544,19921,20993,21736,23172,22661,0,1700,1400,1800,0,1800,0,20544,18221,19593,19936,23172,20861,0.3424,0.30368333333333336,0.32655,0.33226666666666665,0.3862,0.34768333333333334,5
6467,80000,1,3,1,55,0,0,0,0,0,0,46777,44628,43943,42913,43217,41662,5024,5014,5016,5017,5011,5014,1,41753,39614,38927,37896,38206,36648,0.5219125,0.495175,0.4865875,0.4737,0.477575,0.4581,0
6468,140000,0,2,1,29,0,0,0,0,0,0,130767,134946,130470,132038,131961,124256,6696,5000,4866,5300,5055,5000,1,124071,129946,125604,126738,126906,119256,0.8862214285714286,0.9281857142857143,0.8971714285714286,0.9052714285714286,0.9064714285714286,0.8518285714285714,0
6469,100000,1,1,1,51,1,-2,-2,-1,2,2,0,0,0,300,150,780,0,0,300,0,630,0,1,0,0,-300,300,-480,780,0.0,0.0,-0.003,0.003,-0.0048,0.0078,0
6470,50000,1,3,1,53,0,0,0,0,0,-2,20211,48672,34694,35503,2025,0,36396,1662,1471,2125,0,0,1,-16185,47010,33223,33378,2025,0,-0.3237,0.9402,0.66446,0.66756,0.0405,0.0,-2
6471,290000,1,2,2,41,0,0,0,0,0,0,286391,140960,112394,113459,123967,131735,10000,5620,10000,20000,10000,10000,0,276391,135340,102394,93459,113967,121735,0.9530724137931035,0.4666896551724138,0.35308275862068966,0.32227241379310345,0.3929896551724138,0.4197758620689655,0
6472,20000,1,2,2,53,0,0,0,0,0,0,8847,10202,11227,11145,11381,12191,1500,1500,400,416,1002,0,0,7347,8702,10827,10729,10379,12191,0.36735,0.4351,0.54135,0.53645,0.51895,0.60955,0
6473,130000,1,3,2,29,0,0,-1,-1,-1,-1,12939,10000,2277,1132,1289,0,1000,2277,1132,1289,0,2080,0,11939,7723,1145,-157,1289,-2080,0.09183846153846154,0.05940769230769231,0.008807692307692308,-0.0012076923076923076,0.009915384615384616,-0.016,-4
6474,50000,0,2,2,49,0,0,0,0,0,0,59236,53689,48551,34656,18077,18815,2000,2124,2047,5618,1000,2000,0,57236,51565,46504,29038,17077,16815,1.14472,1.0313,0.93008,0.58076,0.34154,0.3363,0
6475,100000,0,1,2,32,1,2,2,0,0,0,95794,97390,94110,92823,68136,53170,4000,0,2000,2000,3000,0,0,91794,97390,92110,90823,65136,53170,0.91794,0.9739,0.9211,0.90823,0.65136,0.5317,5
6476,90000,1,2,2,24,0,0,0,0,-2,-2,80699,68100,33434,0,0,0,2991,2655,0,0,0,0,0,77708,65445,33434,0,0,0,0.8634222222222222,0.7271666666666666,0.37148888888888887,0.0,0.0,0.0,-4
6477,30000,1,2,2,24,1,2,2,2,2,2,7134,7872,9528,9725,9427,10118,1000,1800,500,0,1000,0,0,6134,6072,9028,9725,8427,10118,0.20446666666666666,0.2024,0.30093333333333333,0.32416666666666666,0.2809,0.33726666666666666,11
6478,50000,1,2,2,28,0,0,0,0,0,0,19969,27267,19833,24014,27429,29189,8000,3302,5000,6500,10000,20000,0,11969,23965,14833,17514,17429,9189,0.23938,0.4793,0.29666,0.35028,0.34858,0.18378,0
6479,240000,1,2,1,53,0,0,0,0,2,0,135322,100522,84626,76205,46771,35207,4531,3728,3612,0,1100,2000,1,130791,96794,81014,76205,45671,33207,0.5449625,0.4033083333333333,0.33755833333333335,0.3175208333333333,0.19029583333333333,0.1383625,2
6480,140000,1,3,1,37,-1,-1,-1,-1,-1,-1,1208,4411,3957,5241,3943,3933,4411,3957,5241,3943,3933,0,1,-3203,454,-1284,1298,10,3933,-0.02287857142857143,0.003242857142857143,-0.009171428571428572,0.009271428571428571,7.142857142857143e-05,0.02809285714285714,-6
6481,80000,0,1,2,23,0,0,0,-1,2,2,60130,59744,44031,48089,44789,30423,2550,1848,6084,38,4,70,0,57580,57896,37947,48051,44785,30353,0.71975,0.7237,0.4743375,0.6006375,0.5598125,0.3794125,3
6482,50000,1,2,1,30,0,0,0,0,-2,-2,34811,30753,6680,0,0,0,2000,1000,0,0,0,0,1,32811,29753,6680,0,0,0,0.65622,0.59506,0.1336,0.0,0.0,0.0,-4
6483,230000,1,1,2,25,0,0,0,0,0,0,50757,52906,54454,53457,55128,52788,3000,3000,2000,2500,2500,2000,0,47757,49906,52454,50957,52628,50788,0.2076391304347826,0.21698260869565217,0.2280608695652174,0.22155217391304347,0.22881739130434783,0.22081739130434783,0
6484,480000,0,2,1,53,1,-1,-1,-1,-1,-1,-11,11349,13461,9327,1368,1538,11360,13469,9327,1368,1538,15605,1,-11371,-2120,4134,7959,-170,-14067,-0.023689583333333333,-0.004416666666666667,0.0086125,0.01658125,-0.0003541666666666667,-0.02930625,-4
6485,30000,0,1,2,36,3,2,0,0,-1,-1,26851,26136,30391,13150,18504,6699,0,5334,39,18559,6821,26275,0,26851,20802,30352,-5409,11683,-19576,0.8950333333333333,0.6934,1.0117333333333334,-0.1803,0.38943333333333335,-0.6525333333333333,3
6486,30000,1,1,2,24,-1,-1,2,-1,-1,-1,736,1472,736,736,736,1423,1472,0,736,736,1423,831,0,-736,1472,0,0,-687,592,-0.024533333333333334,0.04906666666666667,0.0,0.0,-0.0229,0.019733333333333332,-3
6487,260000,1,1,1,32,-2,-2,-2,-2,-2,-2,2378,4884,329,2464,2673,12354,4884,329,2465,2673,12354,9583,1,-2506,4555,-2136,-209,-9681,2771,-0.009638461538461538,0.01751923076923077,-0.008215384615384616,-0.0008038461538461538,-0.03723461538461539,0.010657692307692307,-12
6488,50000,0,2,2,43,1,2,2,0,0,0,44344,45363,44326,44901,45844,48385,2021,0,1596,1655,3684,0,0,42323,45363,42730,43246,42160,48385,0.84646,0.90726,0.8546,0.86492,0.8432,0.9677,5
6489,400000,1,3,1,40,0,-1,-1,-1,-1,-1,30179,35550,71671,-329,65691,23657,35729,72031,0,66020,23776,32948,1,-5550,-36481,71671,-66349,41915,-9291,-0.013875,-0.0912025,0.1791775,-0.1658725,0.1047875,-0.0232275,-5
6490,10000,0,2,2,24,0,0,0,0,0,-2,7521,8519,8142,8235,0,0,1145,1148,1021,0,0,0,0,6376,7371,7121,8235,0,0,0.6376,0.7371,0.7121,0.8235,0.0,0.0,-2
6491,140000,0,2,1,48,-1,-1,2,0,0,-2,1600,5012,4739,4739,0,0,5012,0,0,0,0,2770,1,-3412,5012,4739,4739,0,-2770,-0.02437142857142857,0.0358,0.03385,0.03385,0.0,-0.019785714285714285,-2
6492,50000,1,2,1,39,1,-2,-2,-1,-1,-1,0,0,0,2219,390,390,0,0,2219,390,390,390,1,0,0,-2219,1829,0,0,0.0,0.0,-0.04438,0.03658,0.0,0.0,-6
6493,60000,0,2,1,33,0,0,0,0,0,0,42246,38923,32532,27780,29280,39976,2008,3004,3003,2000,1064,2000,1,40238,35919,29529,25780,28216,37976,0.6706333333333333,0.59865,0.49215,0.42966666666666664,0.47026666666666667,0.6329333333333333,0
6494,50000,1,2,2,25,8,7,6,5,4,3,37647,37102,36238,36374,35229,34365,0,0,1000,0,0,3000,0,37647,37102,35238,36374,35229,31365,0.75294,0.74204,0.70476,0.72748,0.70458,0.6273,33
6495,260000,1,1,2,37,-2,-1,-1,-1,-1,-1,3821,1316,2609,1017,1012,959,1316,2609,1017,1012,959,935,0,2505,-1293,1592,5,53,24,0.009634615384615384,-0.004973076923076923,0.006123076923076923,1.923076923076923e-05,0.00020384615384615385,9.23076923076923e-05,-7
6496,20000,0,2,1,46,0,0,0,0,0,0,17483,18552,19442,14678,16791,10361,1363,1256,1178,311,2264,0,1,16120,17296,18264,14367,14527,10361,0.806,0.8648,0.9132,0.71835,0.72635,0.51805,0
6497,20000,1,2,2,23,0,0,-1,0,0,0,10513,3367,444,20444,18976,19802,1000,444,20000,600,1000,1000,0,9513,2923,-19556,19844,17976,18802,0.47565,0.14615,-0.9778,0.9922,0.8988,0.9401,-1
6498,20000,0,2,2,49,0,0,0,0,-1,-1,19111,18936,18588,19260,1500,0,1286,1328,1000,1500,0,0,0,17825,17608,17588,17760,1500,0,0.89125,0.8804,0.8794,0.888,0.075,0.0,-2
6499,120000,1,2,1,39,0,0,0,0,0,0,31611,32264,32786,33018,27114,26287,1562,1500,1059,988,922,826,1,30049,30764,31727,32030,26192,25461,0.25040833333333334,0.2563666666666667,0.2643916666666667,0.2669166666666667,0.21826666666666666,0.212175,0
6500,70000,1,2,1,40,1,2,2,0,0,0,56922,60047,56884,57717,26342,26342,5500,0,2723,1062,936,943,1,51422,60047,54161,56655,25406,25399,0.7346,0.8578142857142858,0.7737285714285714,0.8093571428571429,0.3629428571428571,0.36284285714285713,5
6501,140000,1,3,1,30,0,0,0,0,2,0,93157,96304,98007,82227,65000,60848,4700,4505,12906,0,2210,2300,1,88457,91799,85101,82227,62790,58548,0.6318357142857143,0.6557071428571428,0.6078642857142857,0.5873357142857143,0.4485,0.4182,2
6502,30000,1,3,1,22,1,2,0,0,4,4,21508,20881,23217,28498,28060,29999,0,3000,6000,1200,3000,0,1,21508,17881,17217,27298,25060,29999,0.7169333333333333,0.5960333333333333,0.5739,0.9099333333333334,0.8353333333333334,0.9999666666666667,11
6503,60000,0,2,1,39,0,0,0,0,0,0,59929,35338,22856,22122,19531,16594,2110,2000,200,467,500,4100,1,57819,33338,22656,21655,19031,12494,0.96365,0.5556333333333333,0.3776,0.36091666666666666,0.3171833333333333,0.20823333333333333,0
6504,450000,1,2,1,43,-2,-2,-2,-2,-2,-2,7361,8670,6982,15945,7841,7676,8692,7010,15998,7871,7696,6957,1,-1331,1660,-9016,8074,145,719,-0.002957777777777778,0.0036888888888888887,-0.020035555555555556,0.01794222222222222,0.0003222222222222222,0.0015977777777777778,-12
6505,430000,1,2,2,27,-2,-2,-2,-2,-2,-2,263,263,4119,4390,20952,15562,1764,4120,535,20990,2506,500,0,-1501,-3857,3584,-16600,18446,15062,-0.003490697674418605,-0.008969767441860465,0.008334883720930232,-0.038604651162790694,0.04289767441860465,0.03502790697674418,-12
6506,260000,0,2,1,42,0,0,0,0,0,0,225844,219261,206742,255079,208755,196701,10030,10000,65500,10000,8000,10000,1,215814,209261,141242,245079,200755,186701,0.8300538461538461,0.80485,0.5432384615384616,0.9426115384615384,0.7721346153846154,0.7180807692307692,0
6507,50000,0,3,1,39,0,0,-2,-2,-2,-2,51400,0,0,0,0,0,0,0,0,0,0,0,1,51400,0,0,0,0,0,1.028,0.0,0.0,0.0,0.0,0.0,-8
6508,20000,1,1,2,27,3,2,2,0,0,2,16732,17866,17276,17514,18462,18036,1700,0,800,1361,0,800,0,15032,17866,16476,16153,18462,17236,0.7516,0.8933,0.8238,0.80765,0.9231,0.8618,9
6509,200000,1,2,2,30,6,5,4,3,2,0,71310,69676,67976,68468,67439,56163,0,0,2000,0,1925,1130,0,71310,69676,65976,68468,65514,55033,0.35655,0.34838,0.32988,0.34234,0.32757,0.275165,20
6510,20000,0,2,1,33,1,2,0,0,3,2,18139,17559,18662,21345,20721,20836,0,1400,3000,0,600,0,1,18139,16159,15662,21345,20121,20836,0.90695,0.80795,0.7831,1.06725,1.00605,1.0418,8
6511,210000,1,4,2,32,-2,-2,-2,-2,-2,-2,0,0,0,0,0,0,0,0,0,0,0,0,0,0,0,0,0,0,0,0.0,0.0,0.0,0.0,0.0,0.0,-12
6512,80000,1,2,1,28,1,-2,-1,-1,-1,0,0,146,1000,2525,1498,499,146,1006,2525,1504,1,649,1,-146,-860,-1525,1021,1497,-150,-0.001825,-0.01075,-0.0190625,0.0127625,0.0187125,-0.001875,-4
6513,20000,0,2,2,22,2,2,2,2,0,0,20433,19302,19276,19451,19641,20188,0,2100,1000,1000,1000,1000,0,20433,17202,18276,18451,18641,19188,1.02165,0.8601,0.9138,0.92255,0.93205,0.9594,8
6514,210000,1,2,1,35,0,0,0,0,0,0,44552,45831,46870,48089,49311,50296,2000,1800,2000,2000,1803,2000,1,42552,44031,44870,46089,47508,48296,0.20262857142857144,0.20967142857142856,0.21366666666666667,0.21947142857142857,0.22622857142857142,0.22998095238095237,0
6515,390000,1,1,1,39,0,0,-1,-1,-1,-1,42721,22836,24266,6088,2500,828,12041,24353,6118,2550,828,0,1,30680,-1517,18148,3538,1672,828,0.07866666666666666,-0.0038897435897435897,0.046533333333333336,0.009071794871794872,0.004287179487179487,0.0021230769230769233,-4
6516,130000,1,2,1,33,0,0,0,0,0,0,133461,133393,132211,101807,101083,101597,7010,6657,3899,3952,3900,4000,1,126451,126736,128312,97855,97183,97597,0.9727,0.9748923076923077,0.9870153846153846,0.7527307692307692,0.7475615384615385,0.7507461538461538,0
6517,360000,0,2,3,32,-2,-2,-2,-2,-2,-2,10591,-326,56337,10959,7056,0,326,56663,11013,7091,0,0,0,10265,-56989,45324,3868,7056,0,0.028513888888888887,-0.15830277777777776,0.1259,0.010744444444444444,0.0196,0.0,-12
6518,50000,0,2,2,26,0,0,-1,-1,-1,-1,18838,385,11500,2756,7000,12025,0,11615,2756,7000,12025,1880,0,18838,-11230,8744,-4244,-5025,10145,0.37676,-0.2246,0.17488,-0.08488,-0.1005,0.2029,-4
6519,20000,1,2,1,42,0,0,0,3,2,2,12029,13045,16024,15420,13929,11307,1224,3203,0,1000,0,2000,1,10805,9842,16024,14420,13929,9307,0.54025,0.4921,0.8012,0.721,0.69645,0.46535,7
6520,110000,1,1,2,24,0,0,2,2,0,0,9334,108868,96998,94480,90860,85529,100082,4200,0,3000,3140,4900,0,-90748,104668,96998,91480,87720,80629,-0.8249818181818181,0.9515272727272728,0.8818,0.8316363636363636,0.7974545454545454,0.7329909090909091,4
6521,20000,0,3,1,53,3,4,3,2,3,2,15507,14974,14449,15116,14582,14206,0,0,1200,0,0,2230,1,15507,14974,13249,15116,14582,11976,0.77535,0.7487,0.66245,0.7558,0.7291,0.5988,17
6522,310000,0,1,1,43,-2,-2,-2,-2,-2,-2,0,0,0,0,0,0,0,0,0,0,0,0,1,0,0,0,0,0,0,0.0,0.0,0.0,0.0,0.0,0.0,-12
6523,30000,1,1,1,41,0,0,0,0,0,0,26300,27308,28425,29233,21575,22029,1450,1560,1350,1000,801,1000,1,24850,25748,27075,28233,20774,21029,0.8283333333333334,0.8582666666666666,0.9025,0.9411,0.6924666666666667,0.7009666666666666,0
6524,80000,1,3,2,54,0,0,0,-1,-1,-1,12011,10484,12190,4000,0,4000,3794,6000,6500,0,4000,0,0,8217,4484,5690,4000,-4000,4000,0.1027125,0.05605,0.071125,0.05,-0.05,0.05,-3
6525,20000,0,1,2,29,0,0,0,2,0,0,13835,14897,17512,16926,17368,17959,1600,3170,0,1000,1000,3000,0,12235,11727,17512,15926,16368,14959,0.61175,0.58635,0.8756,0.7963,0.8184,0.74795,2
6526,160000,1,1,1,39,1,-2,-2,-2,-2,-2,0,0,0,0,0,0,0,0,0,0,0,2000,1,0,0,0,0,0,-2000,0.0,0.0,0.0,0.0,0.0,-0.0125,-9
6527,230000,0,2,1,36,0,0,0,0,0,0,4761,5786,7676,9877,10181,12472,1110,2000,2500,1000,2472,1000,1,3651,3786,5176,8877,7709,11472,0.015873913043478263,0.01646086956521739,0.022504347826086957,0.038595652173913045,0.033517391304347825,0.04987826086956522,0
6528,280000,1,1,1,30,1,-2,-2,-2,-2,-2,0,0,0,0,0,0,0,0,0,0,0,0,1,0,0,0,0,0,0,0.0,0.0,0.0,0.0,0.0,0.0,-9
6529,120000,1,2,2,31,0,0,0,0,0,0,26307,27361,28878,30428,31818,34293,1483,2000,2000,2000,3000,3000,0,24824,25361,26878,28428,28818,31293,0.20686666666666667,0.21134166666666668,0.22398333333333334,0.2369,0.24015,0.260775,0
6530,200000,0,2,2,27,0,0,2,0,0,0,25334,26203,25652,25162,24995,23901,2204,1004,1004,1013,2018,4,0,23130,25199,24648,24149,22977,23897,0.11565,0.125995,0.12324,0.120745,0.114885,0.119485,2
6531,380000,1,2,1,43,1,-2,-2,-1,-1,-1,0,0,0,2039,0,4481,0,0,2039,0,4481,312,1,0,0,-2039,2039,-4481,4169,0.0,0.0,-0.005365789473684211,0.005365789473684211,-0.011792105263157895,0.010971052631578947,-6
6532,50000,1,2,1,35,0,0,0,0,0,0,7378,7543,7754,7825,7132,7319,1121,1168,1075,218,1100,0,1,6257,6375,6679,7607,6032,7319,0.12514,0.1275,0.13358,0.15214,0.12064,0.14638,0
6533,160000,0,2,2,30,2,2,2,2,2,2,75406,76907,78047,79362,81089,82796,3300,3000,3200,3152,3200,3100,0,72106,73907,74847,76210,77889,79696,0.4506625,0.46191875,0.46779375,0.4763125,0.48680625,0.4981,12
6534,220000,1,2,1,33,2,2,0,0,0,0,223904,211137,197721,181231,182649,182644,0,8240,6549,6605,6490,6319,1,223904,202897,191172,174626,176159,176325,1.0177454545454545,0.9222590909090909,0.8689636363636364,0.7937545454545455,0.8007227272727273,0.8014772727272728,4
6535,20000,1,3,3,55,1,2,3,2,2,2,18558,20358,19743,19128,20560,20082,2400,0,0,1744,0,600,0,16158,20358,19743,17384,20560,19482,0.8079,1.0179,0.98715,0.8692,1.028,0.9741,12
6536,360000,1,1,2,28,0,-1,-1,-1,-1,-1,2386,3166,2776,2386,3166,2983,3166,2776,7158,3166,2983,2386,0,-780,390,-4382,-780,183,597,-0.0021666666666666666,0.0010833333333333333,-0.012172222222222221,-0.0021666666666666666,0.0005083333333333333,0.0016583333333333333,-5
6537,500000,0,1,1,41,0,0,0,0,0,0,505128,500867,489856,356583,289398,274590,19295,18694,12271,9699,9420,8818,1,485833,482173,477585,346884,279978,265772,0.971666,0.964346,0.95517,0.693768,0.559956,0.531544,0
6538,50000,0,2,2,30,2,2,2,2,2,-2,200,200,200,200,-200,0,0,0,0,0,200,0,0,200,200,200,200,-400,0,0.004,0.004,0.004,0.004,-0.008,0.0,8
6539,100000,0,3,1,54,0,0,0,5,4,3,46041,59526,72823,71105,69424,68006,15000,15000,0,0,0,2700,1,31041,44526,72823,71105,69424,65306,0.31041,0.44526,0.72823,0.71105,0.69424,0.65306,12
6540,70000,1,2,2,30,0,0,0,0,0,0,3878,4957,6209,6338,6587,6828,1300,1500,380,500,500,800,0,2578,3457,5829,5838,6087,6028,0.036828571428571426,0.04938571428571428,0.08327142857142857,0.0834,0.08695714285714286,0.08611428571428571,0
6541,180000,1,2,2,29,-2,-2,-2,-2,-2,-2,0,0,4690,0,150,193,0,4690,0,150,193,3403,0,0,-4690,4690,-150,-43,-3210,0.0,-0.026055555555555554,0.026055555555555554,-0.0008333333333333334,-0.00023888888888888888,-0.017833333333333333,-12
6542,210000,1,2,1,25,0,0,0,0,0,0,142848,94018,96926,100399,101472,103834,5000,4415,6000,3635,4000,5000,1,137848,89603,90926,96764,97472,98834,0.6564190476190476,0.4266809523809524,0.43298095238095236,0.4607809523809524,0.4641523809523809,0.47063809523809524,0
6543,60000,1,3,1,25,0,0,0,0,0,0,60340,58556,57251,57826,22544,26675,2200,2600,2300,3000,5000,2000,1,58140,55956,54951,54826,17544,24675,0.969,0.9326,0.91585,0.9137666666666666,0.2924,0.41125,0
6544,170000,0,1,1,41,-1,-1,-1,0,0,-1,10540,0,9871,9739,66,230,0,9871,0,0,230,23709,1,10540,-9871,9871,9739,-164,-23479,0.062,-0.05806470588235294,0.05806470588235294,0.05728823529411765,-0.0009647058823529412,-0.13811176470588235,-4
6545,30000,1,2,1,30,0,0,0,0,0,0,9211,9133,10165,11441,11479,11719,1154,1186,1462,500,400,434,1,8057,7947,8703,10941,11079,11285,0.2685666666666667,0.2649,0.2901,0.3647,0.3693,0.37616666666666665,0
6546,280000,1,2,2,42,0,0,0,0,0,0,272190,266459,228907,234179,180684,184319,9910,9000,9329,7000,6511,5500,0,262280,257459,219578,227179,174173,178819,0.9367142857142857,0.9194964285714285,0.7842071428571429,0.8113535714285715,0.6220464285714286,0.6386392857142857,0
6547,360000,1,1,2,26,2,2,-2,-2,-2,-2,2500,0,0,0,0,0,0,0,0,0,0,0,0,2500,0,0,0,0,0,0.006944444444444444,0.0,0.0,0.0,0.0,0.0,-4
6548,20000,1,2,1,26,1,2,0,0,0,0,7072,1514,1898,2558,2498,4074,2,1198,1500,500,2000,0,1,7070,316,398,2058,498,4074,0.3535,0.0158,0.0199,0.1029,0.0249,0.2037,3
6549,360000,1,1,2,28,-2,-2,-2,-2,-2,-2,23088,11628,8556,4578,4784,11938,12000,8598,4601,4808,11997,3708,0,11088,3030,3955,-230,-7213,8230,0.0308,0.008416666666666666,0.010986111111111111,-0.0006388888888888889,-0.020036111111111112,0.02286111111111111,-12
6550,100000,1,2,2,44,-1,-1,-1,-1,0,0,12566,2421,3360,2845,2505,2158,3061,1390,6477,50,43,36,0,9505,1031,-3117,2795,2462,2122,0.09505,0.01031,-0.03117,0.02795,0.02462,0.02122,-4
6551,30000,1,1,2,25,-1,2,-1,0,0,0,5285,4053,1405,3844,3427,417,0,1405,3427,0,0,984,0,5285,2648,-2022,3844,3427,-567,0.17616666666666667,0.08826666666666666,-0.0674,0.12813333333333332,0.11423333333333334,-0.0189,0
6552,20000,1,2,2,39,0,0,0,0,0,0,19064,20356,18186,16524,19026,16309,2000,2000,2000,5000,1000,6000,0,17064,18356,16186,11524,18026,10309,0.8532,0.9178,0.8093,0.5762,0.9013,0.51545,0
6553,240000,1,2,1,35,0,0,0,0,2,2,109226,110226,111030,114584,115681,112528,5500,5400,8000,4179,0,4000,1,103726,104826,103030,110405,115681,108528,0.43219166666666664,0.436775,0.4292916666666667,0.4600208333333333,0.4820041666666667,0.4522,4
6554,20000,0,2,2,48,-1,-1,2,0,0,-2,390,1170,780,780,0,0,1170,0,0,0,0,0,0,-780,1170,780,780,0,0,-0.039,0.0585,0.039,0.039,0.0,0.0,-2
6555,50000,1,2,2,23,0,0,0,0,0,0,45078,44291,39408,29689,23879,23355,3000,3000,947,1000,837,866,0,42078,41291,38461,28689,23042,22489,0.84156,0.82582,0.76922,0.57378,0.46084,0.44978,0
6556,90000,1,3,2,26,0,-1,0,0,0,-1,3268,6745,3402,8652,5381,7190,6745,1131,5381,4,7190,0,0,-3477,5614,-1979,8648,-1809,7190,-0.03863333333333333,0.062377777777777775,-0.021988888888888888,0.09608888888888889,-0.0201,0.07988888888888888,-2
6557,20000,0,4,2,22,0,0,0,0,0,0,19614,19844,19929,18775,13854,10718,11630,1369,1162,524,606,0,0,7984,18475,18767,18251,13248,10718,0.3992,0.92375,0.93835,0.91255,0.6624,0.5359,0
6558,280000,0,1,2,35,0,0,0,0,0,0,210465,200959,146652,132527,70421,60235,10299,7200,5886,3000,5000,5000,0,200166,193759,140766,129527,65421,55235,0.7148785714285715,0.6919964285714286,0.5027357142857143,0.4625964285714286,0.23364642857142856,0.19726785714285713,0
6559,180000,1,2,2,29,0,0,2,0,0,0,85465,95546,93000,93526,66726,42668,11508,0,2340,1850,4000,0,0,73957,95546,90660,91676,62726,42668,0.41087222222222225,0.5308111111111111,0.5036666666666667,0.5093111111111112,0.3484777777777778,0.23704444444444445,2
6560,260000,1,1,2,28,0,0,0,0,0,0,63504,66283,67341,54725,36117,35144,4000,3002,2000,2000,2464,1000,0,59504,63281,65341,52725,33653,34144,0.22886153846153845,0.24338846153846153,0.2513115384615385,0.20278846153846153,0.1294346153846154,0.13132307692307693,0
6561,210000,1,1,1,36,1,-2,-2,-2,-2,-2,0,0,0,0,0,0,0,0,0,0,0,0,1,0,0,0,0,0,0,0.0,0.0,0.0,0.0,0.0,0.0,-9
6562,130000,1,1,2,29,2,0,0,0,0,0,126509,109944,105049,68154,67397,61764,6000,6000,5000,2500,3000,3000,0,120509,103944,100049,65654,64397,58764,0.9269923076923077,0.7995692307692308,0.7696076923076923,0.5050307692307693,0.49536153846153846,0.45203076923076924,2
6563,20000,1,1,2,24,0,0,0,0,0,0,19403,18989,18914,19883,19293,19993,1300,1332,1301,700,1000,900,0,18103,17657,17613,19183,18293,19093,0.90515,0.88285,0.88065,0.95915,0.91465,0.95465,0
6564,30000,0,2,2,33,0,0,0,0,0,-2,28949,30319,29400,30000,0,0,2233,1000,600,0,0,0,0,26716,29319,28800,30000,0,0,0.8905333333333333,0.9773,0.96,1.0,0.0,0.0,-2
6565,80000,1,2,2,33,0,0,0,0,2,0,12554,13564,14608,17441,16866,17443,1523,1567,3400,0,1000,1000,0,11031,11997,11208,17441,15866,16443,0.1378875,0.1499625,0.1401,0.2180125,0.198325,0.2055375,2
6566,50000,0,4,2,27,0,0,0,0,0,-2,47830,47863,34725,15735,0,0,6143,2354,4147,0,0,0,0,41687,45509,30578,15735,0,0,0.83374,0.91018,0.61156,0.3147,0.0,0.0,-2
6567,20000,0,2,1,58,-1,-1,2,2,-1,-1,21116,21470,200,0,28740,1295,21654,0,0,28740,1565,0,1,-538,21470,200,-28740,27175,1295,-0.0269,1.0735,0.01,-1.437,1.35875,0.06475,0
6568,290000,1,1,1,43,-1,-1,-1,-1,0,-1,1457,1799,5029,3103,1838,690,1808,5054,3109,9,693,3579,1,-351,-3255,1920,3094,1145,-2889,-0.001210344827586207,-0.011224137931034482,0.006620689655172414,0.010668965517241379,0.003948275862068966,-0.009962068965517242,-5
6569,400000,0,2,1,44,-1,-1,0,0,0,-1,6389,59407,26616,15333,9995,4175,59570,1105,10021,51,4735,1733,1,-53181,58302,16595,15282,5260,2442,-0.1329525,0.145755,0.0414875,0.038205,0.01315,0.006105,-3
6570,70000,0,3,1,30,0,0,0,2,0,0,67730,67021,67328,60962,61146,56066,3000,6006,0,1900,2000,2000,1,64730,61015,67328,59062,59146,54066,0.9247142857142857,0.8716428571428572,0.9618285714285715,0.8437428571428571,0.8449428571428571,0.7723714285714286,2
6571,280000,1,1,2,34,-1,2,2,-2,-1,-1,8719,844,0,0,1000,0,0,0,0,1000,0,0,0,8719,844,0,-1000,1000,0,0.031139285714285713,0.003014285714285714,0.0,-0.0035714285714285713,0.0035714285714285713,0.0,-1
6572,50000,1,2,1,25,0,0,0,-1,-1,0,16092,12352,-1618,-809,46976,47618,2352,809,928,48659,1400,2000,1,13740,11543,-2546,-49468,45576,45618,0.2748,0.23086,-0.05092,-0.98936,0.91152,0.91236,-2
6573,50000,0,2,2,35,0,0,0,0,0,0,49878,46785,41728,41163,29408,30047,1718,2070,1505,1500,1242,1300,0,48160,44715,40223,39663,28166,28747,0.9632,0.8943,0.80446,0.79326,0.56332,0.57494,0
6574,350000,0,2,2,42,0,0,0,0,0,0,347790,352600,299797,218973,146326,107205,13000,11000,8232,7000,6000,7000,0,334790,341600,291565,211973,140326,100205,0.9565428571428571,0.976,0.8330428571428572,0.6056371428571429,0.40093142857142855,0.2863,0
6575,130000,0,2,2,28,0,0,0,0,0,0,88549,74624,76133,77648,79370,80071,2709,2750,2767,2961,2913,3000,0,85840,71874,73366,74687,76457,77071,0.6603076923076923,0.552876923076923,0.5643538461538462,0.5745153846153846,0.5881307692307692,0.5928538461538462,0
6576,20000,1,1,2,24,0,0,0,0,0,0,14273,13327,11789,11200,13244,13539,1183,2000,1200,2244,506,561,0,13090,11327,10589,8956,12738,12978,0.6545,0.56635,0.52945,0.4478,0.6369,0.6489,0
6577,150000,1,2,1,28,0,0,0,0,0,0,19946,18646,13086,13086,3555,0,2000,1500,1500,1000,0,0,1,17946,17146,11586,12086,3555,0,0.11964,0.11430666666666667,0.07724,0.08057333333333333,0.0237,0.0,0
6578,110000,1,2,2,25,0,0,0,0,0,0,50406,45099,46002,44701,42706,43513,1800,1800,1700,1500,1600,2000,0,48606,43299,44302,43201,41106,41513,0.44187272727272725,0.3936272727272727,0.4027454545454546,0.39273636363636366,0.3736909090909091,0.3773909090909091,0
6579,310000,0,2,2,30,-2,-2,-2,-2,-2,-2,167,-223,780,0,0,291,0,1003,0,0,291,173,0,167,-1226,780,0,-291,118,0.0005387096774193548,-0.00395483870967742,0.0025161290322580645,0.0,-0.0009387096774193548,0.00038064516129032255,-12
6580,10000,0,2,2,24,2,0,0,0,0,0,223,3035,4810,7546,9260,10000,3000,2000,3000,2000,1000,0,0,-2777,1035,1810,5546,8260,10000,-0.2777,0.1035,0.181,0.5546,0.826,1.0,2
6581,260000,0,2,1,44,-1,-1,-1,-1,-1,-2,11506,973,1183,2270,0,0,975,1186,2287,0,0,2580,1,10531,-213,-1104,2270,0,-2580,0.040503846153846154,-0.0008192307692307693,-0.0042461538461538465,0.008730769230769231,0.0,-0.009923076923076923,-7
6582,600000,0,1,1,36,0,0,0,0,0,0,372396,416438,459749,455910,463611,466570,50000,50000,15000,20000,15000,7000,1,322396,366438,444749,435910,448611,459570,0.5373266666666666,0.61073,0.7412483333333333,0.7265166666666667,0.747685,0.76595,0
6583,390000,0,1,1,33,0,0,0,0,0,0,17794,23518,28139,32711,36215,40650,6000,5000,5000,4000,5000,8883,1,11794,18518,23139,28711,31215,31767,0.03024102564102564,0.04748205128205128,0.05933076923076923,0.07361794871794872,0.08003846153846154,0.08145384615384615,0
6584,110000,0,1,2,26,0,0,0,0,0,0,110925,110909,111851,153551,75749,77217,5607,4400,2683,5466,5000,2000,0,105318,106509,109168,148085,70749,75217,0.9574363636363636,0.9682636363636363,0.9924363636363637,1.3462272727272728,0.6431727272727272,0.6837909090909091,0
6585,20000,0,2,1,25,0,0,0,0,0,0,14447,15455,17562,17322,17119,17350,1552,2659,1419,606,500,1000,1,12895,12796,16143,16716,16619,16350,0.64475,0.6398,0.80715,0.8358,0.83095,0.8175,0
6586,150000,1,2,2,29,-1,-1,-1,-1,-1,-1,933,598,1062,0,1810,0,598,1062,0,1810,0,3163,0,335,-464,1062,-1810,1810,-3163,0.0022333333333333333,-0.0030933333333333334,0.00708,-0.012066666666666667,0.012066666666666667,-0.021086666666666667,-6
6587,160000,1,1,2,32,-2,-2,-2,-2,-2,-2,162,-2,-2,499,284,1248,0,0,501,285,1254,99,0,162,-2,-503,214,-970,1149,0.0010125,-1.25e-05,-0.00314375,0.0013375,-0.0060625,0.00718125,-12
6588,50000,1,3,2,22,2,2,0,0,0,0,22719,18408,19330,19561,19815,18574,0,1573,804,675,738,1000,0,22719,16835,18526,18886,19077,17574,0.45438,0.3367,0.37052,0.37772,0.38154,0.35148,4
6589,130000,0,2,2,26,2,2,2,0,0,0,137204,139189,133521,133182,103161,103031,7000,0,5133,5000,5000,5000,0,130204,139189,128388,128182,98161,98031,1.0015692307692308,1.0706846153846155,0.9876,0.9860153846153846,0.7550846153846154,0.7540846153846154,6
6590,230000,1,2,1,28,-2,-2,-2,-2,-2,-2,0,0,0,0,0,0,0,0,0,0,0,0,1,0,0,0,0,0,0,0.0,0.0,0.0,0.0,0.0,0.0,-12
6591,120000,0,2,2,30,-1,-1,-1,-1,-1,-1,2494,1991,1497,998,697,-103,1997,1506,1001,699,0,897,0,497,485,496,299,697,-1000,0.004141666666666667,0.0040416666666666665,0.0041333333333333335,0.0024916666666666668,0.005808333333333334,-0.008333333333333333,-6
6592,500000,1,1,1,32,-1,-1,-1,-1,0,0,185419,10573,0,282562,288459,293233,10573,0,282562,11000,9572,8928,1,174846,10573,-282562,271562,278887,284305,0.349692,0.021146,-0.565124,0.543124,0.557774,0.56861,-4
6593,80000,1,3,1,52,0,0,0,0,0,0,18100,6826,7582,8082,8082,8082,1244,1000,500,0,0,0,1,16856,5826,7082,8082,8082,8082,0.2107,0.072825,0.088525,0.101025,0.101025,0.101025,0
6594,310000,1,1,1,47,0,0,2,0,0,0,131559,135970,121016,111214,101957,92805,17839,0,5000,4000,4000,3000,1,113720,135970,116016,107214,97957,89805,0.36683870967741933,0.4386129032258064,0.3742451612903226,0.3458516129032258,0.3159903225806452,0.28969354838709677,2
6595,270000,1,1,2,32,0,0,0,0,0,0,54914,55423,57875,57456,33334,31723,3000,5000,3300,1337,1500,1000,0,51914,50423,54575,56119,31834,30723,0.19227407407407407,0.18675185185185186,0.20212962962962963,0.20784814814814814,0.1179037037037037,0.11378888888888888,0
6596,10000,1,2,2,22,0,0,-1,0,0,-2,7418,8080,780,780,0,0,1000,780,0,600,0,0,0,6418,7300,780,180,0,0,0.6418,0.73,0.078,0.018,0.0,0.0,-3
6597,290000,1,3,1,48,-1,0,0,-1,-1,-1,284990,274764,225000,16635,15000,47143,10000,25000,16635,15000,47143,2088,1,274990,249764,208365,1635,-32143,45055,0.9482413793103448,0.8612551724137931,0.7185,0.005637931034482758,-0.11083793103448276,0.15536206896551724,-4
6598,360000,0,3,2,30,1,-2,-2,-2,-2,-2,0,0,0,0,0,0,0,0,0,0,0,0,0,0,0,0,0,0,0,0.0,0.0,0.0,0.0,0.0,0.0,-9
6599,30000,1,1,2,26,-1,2,2,2,0,0,9600,8805,10534,8240,7027,7034,0,2399,0,388,260,478,0,9600,6406,10534,7852,6767,6556,0.32,0.21353333333333332,0.35113333333333335,0.2617333333333333,0.22556666666666667,0.21853333333333333,5
6600,120000,1,1,2,30,-1,2,-1,-1,-1,-1,330,165,165,0,165,0,0,165,0,165,0,0,0,330,0,165,-165,165,0,0.00275,0.0,0.001375,-0.001375,0.001375,0.0,-3
6601,150000,1,2,1,37,-1,0,0,0,0,0,104460,101914,103297,100603,98188,101441,6000,4573,5000,5000,5000,4100,1,98460,97341,98297,95603,93188,97341,0.6564,0.64894,0.6553133333333333,0.6373533333333333,0.6212533333333333,0.64894,-1
6602,50000,1,1,2,29,-1,-1,-1,-1,-1,-1,2000,5743,1134,3067,5496,1194,5934,1134,3067,5496,1194,6499,0,-3934,4609,-1933,-2429,4302,-5305,-0.07868,0.09218,-0.03866,-0.04858,0.08604,-0.1061,-6
6603,30000,0,2,2,27,1,2,0,0,2,2,22284,21637,22981,24996,24309,26980,0,1682,2697,0,3219,0,0,22284,19955,20284,24996,21090,26980,0.7428,0.6651666666666667,0.6761333333333334,0.8332,0.703,0.8993333333333333,7
6604,170000,1,2,2,27,0,0,0,0,0,0,19269,20313,20852,17560,17918,9100,1661,1200,351,358,182,0,0,17608,19113,20501,17202,17736,9100,0.1035764705882353,0.11242941176470589,0.12059411764705882,0.10118823529411765,0.10432941176470588,0.05352941176470588,0
6605,260000,1,3,1,59,0,0,0,0,0,0,258885,261183,262546,238614,195149,195771,10000,11000,13067,10003,8000,11488,1,248885,250183,249479,228611,187149,184283,0.95725,0.9622423076923077,0.9595346153846154,0.8792730769230769,0.7198038461538462,0.7087807692307693,0
6606,30000,1,2,1,22,2,2,2,0,0,0,30525,28574,14220,14188,7058,7976,1725,0,1230,1000,1000,0,1,28800,28574,12990,13188,6058,7976,0.96,0.9524666666666667,0.433,0.4396,0.20193333333333333,0.26586666666666664,6
6607,130000,1,2,2,40,2,0,0,2,0,0,8539,9559,12394,11883,9826,10167,1165,3000,0,500,500,2700,0,7374,6559,12394,11383,9326,7467,0.056723076923076925,0.050453846153846155,0.09533846153846154,0.08756153846153847,0.07173846153846154,0.057438461538461535,4
6608,50000,1,3,2,23,2,2,2,2,2,2,42304,45327,46294,47147,46272,49050,3695,2000,1900,0,3700,0,0,38609,43327,44394,47147,42572,49050,0.77218,0.86654,0.88788,0.94294,0.85144,0.981,12
6609,50000,0,2,2,24,1,3,2,0,-1,-1,52935,50946,22740,2314,1823,18839,0,0,0,1823,18839,641,0,52935,50946,22740,491,-17016,18198,1.0587,1.01892,0.4548,0.00982,-0.34032,0.36396,4
6610,210000,1,1,2,32,-1,2,-1,-1,-1,-1,552,276,381,404,943,1909,0,381,404,943,1909,465,0,552,-105,-23,-539,-966,1444,0.0026285714285714285,-0.0005,-0.00010952380952380952,-0.0025666666666666667,-0.0046,0.006876190476190476,-3
6611,150000,1,3,1,35,-2,-1,2,-1,-1,-1,600,660,330,330,330,740,660,0,330,330,740,0,1,-60,660,0,0,-410,740,-0.0004,0.0044,0.0,0.0,-0.0027333333333333333,0.004933333333333333,-4
6612,40000,0,1,2,34,0,0,2,0,0,2,38849,40315,38401,39224,40364,38391,3600,0,2100,3226,0,1531,0,35249,40315,36301,35998,40364,36860,0.881225,1.007875,0.907525,0.89995,1.0091,0.9215,4
6613,50000,0,2,2,24,0,0,0,0,0,0,50628,50705,50328,19542,19439,19683,2235,1858,823,838,702,687,0,48393,48847,49505,18704,18737,18996,0.96786,0.97694,0.9901,0.37408,0.37474,0.37992,0
6614,30000,0,2,2,34,0,0,0,0,0,0,28509,29739,29372,29514,27226,25408,2003,1504,2017,2000,1000,1100,0,26506,28235,27355,27514,26226,24308,0.8835333333333333,0.9411666666666667,0.9118333333333334,0.9171333333333334,0.8742,0.8102666666666667,0
6615,20000,0,2,2,23,0,-1,-1,-1,0,0,6321,4813,595,18628,19324,19208,6000,597,21722,1000,697,860,0,321,4216,-21127,17628,18627,18348,0.01605,0.2108,-1.05635,0.8814,0.93135,0.9174,-3
6616,150000,1,1,2,29,-2,-2,-2,-2,-2,-1,0,5067,131,987,0,14001,5067,131,987,400,14001,0,0,-5067,4936,-856,587,-14001,14001,-0.03378,0.03290666666666667,-0.005706666666666666,0.003913333333333333,-0.09334,0.09334,-11
6617,50000,1,2,1,49,0,0,2,0,0,0,48501,51105,39094,19476,19483,19634,3500,0,680,693,851,700,1,45001,51105,38414,18783,18632,18934,0.90002,1.0221,0.76828,0.37566,0.37264,0.37868,2
6618,50000,1,2,1,31,-2,-2,-2,-2,-2,-2,0,323,0,0,0,0,323,0,0,0,0,0,1,-323,323,0,0,0,0,-0.00646,0.00646,0.0,0.0,0.0,0.0,-12
6619,140000,1,3,1,46,0,0,0,0,0,0,132586,135165,125427,128016,127323,130020,4800,4500,4600,4800,4800,4500,1,127786,130665,120827,123216,122523,125520,0.9127571428571428,0.9333214285714285,0.86305,0.8801142857142857,0.8751642857142857,0.8965714285714286,0
6620,140000,1,2,1,46,-1,-1,-1,-1,-1,-1,264,1024,264,1024,264,264,1024,528,1024,264,264,414,1,-760,496,-760,760,0,-150,-0.0054285714285714284,0.0035428571428571427,-0.0054285714285714284,0.0054285714285714284,0.0,-0.0010714285714285715,-6
6621,50000,1,2,2,28,0,0,0,0,2,0,23318,24327,25360,27929,27184,27752,1398,1431,3000,0,1155,1025,0,21920,22896,22360,27929,26029,26727,0.4384,0.45792,0.4472,0.55858,0.52058,0.53454,2
6622,410000,1,1,2,30,0,-1,-1,0,0,-1,6972,3188,15106,15313,10959,8341,3188,15106,6000,0,8341,17331,0,3784,-11918,9106,15313,2618,-8990,0.009229268292682927,-0.02906829268292683,0.022209756097560977,0.03734878048780488,0.006385365853658537,-0.02192682926829268,-3
6623,230000,1,1,2,26,-1,-1,-2,-2,-2,-2,3741,0,0,0,0,0,0,0,0,0,0,1010,0,3741,0,0,0,0,-1010,0.01626521739130435,0.0,0.0,0.0,0.0,-0.004391304347826087,-10
6624,50000,1,2,2,35,0,0,0,0,0,0,48848,49988,45434,34688,24124,21072,2000,2000,1900,1032,3000,907,0,46848,47988,43534,33656,21124,20165,0.93696,0.95976,0.87068,0.67312,0.42248,0.4033,0
6625,120000,0,1,1,34,2,2,2,2,2,2,97463,99018,100493,101937,104159,102324,4000,4000,4000,4000,0,8000,1,93463,95018,96493,97937,104159,94324,0.7788583333333333,0.7918166666666666,0.8041083333333333,0.8161416666666667,0.8679916666666667,0.7860333333333334,12
6626,260000,0,1,1,43,1,-2,-2,-1,0,0,0,0,0,14855,13650,0,0,0,15055,0,0,0,1,0,0,-15055,14855,13650,0,0.0,0.0,-0.05790384615384615,0.05713461538461539,0.0525,0.0,-4
6627,400000,1,3,1,50,2,-1,-1,-1,-1,-2,5523,8033,0,550,0,0,8037,0,550,0,0,0,1,-2514,8033,-550,550,0,0,-0.006285,0.0200825,-0.001375,0.001375,0.0,0.0,-4
6628,80000,1,2,1,55,0,0,0,0,0,0,79816,29536,28870,25049,23881,23668,1600,1514,1505,1005,2026,2000,1,78216,28022,27365,24044,21855,21668,0.9777,0.350275,0.3420625,0.30055,0.2731875,0.27085,0
6629,50000,0,2,2,28,0,0,0,2,0,0,26538,27592,30627,28999,29607,29285,1500,3500,0,1051,1100,1040,0,25038,24092,30627,27948,28507,28245,0.50076,0.48184,0.61254,0.55896,0.57014,0.5649,2
6630,360000,0,3,1,53,-2,-2,-2,-2,-2,-2,0,0,0,0,0,0,0,0,0,0,0,0,1,0,0,0,0,0,0,0.0,0.0,0.0,0.0,0.0,0.0,-12
6631,70000,1,2,1,44,0,0,0,0,0,0,4221,6642,8361,10208,11038,11848,2500,2000,2000,1000,1000,1000,1,1721,4642,6361,9208,10038,10848,0.024585714285714287,0.06631428571428571,0.09087142857142858,0.13154285714285716,0.1434,0.15497142857142857,0
6632,210000,0,2,1,41,1,2,0,0,0,0,149343,145319,86335,69670,59502,119494,0,5000,3600,2000,2000,5000,1,149343,140319,82735,67670,57502,114494,0.7111571428571428,0.6681857142857143,0.3939761904761905,0.3222380952380952,0.27381904761904763,0.5452095238095238,3
6633,140000,1,3,2,33,1,-2,-2,-1,-1,-1,0,0,0,4647,250,4654,0,0,4647,5423,4404,0,0,0,0,-4647,-776,-4154,4654,0.0,0.0,-0.03319285714285714,-0.005542857142857143,-0.02967142857142857,0.03324285714285714,-6
6634,90000,0,2,1,41,1,2,0,0,0,2,86699,84423,86173,87942,92756,91146,0,4008,4100,7200,0,3271,1,86699,80415,82073,80742,92756,87875,0.9633222222222222,0.8935,0.9119222222222222,0.8971333333333333,1.0306222222222223,0.9763888888888889,5
6635,50000,1,2,1,42,0,0,0,0,0,0,41077,42072,43414,44126,45004,46100,1681,2023,1735,1613,1823,2053,1,39396,40049,41679,42513,43181,44047,0.78792,0.80098,0.83358,0.85026,0.86362,0.88094,0
6636,170000,0,2,1,34,0,0,0,0,0,0,35923,37323,38420,40468,41793,43952,2000,2000,3000,2000,3000,2000,1,33923,35323,35420,38468,38793,41952,0.1995470588235294,0.20778235294117647,0.2083529411764706,0.22628235294117646,0.22819411764705883,0.2467764705882353,0
6637,20000,0,2,1,47,0,0,0,0,0,0,14835,16605,19160,14506,12839,8495,3000,3000,5000,5000,3000,511,1,11835,13605,14160,9506,9839,7984,0.59175,0.68025,0.708,0.4753,0.49195,0.3992,0
6638,120000,1,1,2,26,0,0,0,0,0,0,11513,12227,13321,15090,16836,18554,1206,1300,2000,2000,2000,2000,0,10307,10927,11321,13090,14836,16554,0.08589166666666667,0.09105833333333334,0.09434166666666667,0.10908333333333334,0.12363333333333333,0.13795,0
6639,300000,1,2,1,39,0,0,0,0,0,0,145138,148586,151878,123417,104922,107005,5785,6163,4728,3811,3830,3970,1,139353,142423,147150,119606,101092,103035,0.46451,0.47474333333333335,0.4905,0.3986866666666667,0.33697333333333335,0.34345,0
6640,220000,0,2,2,30,-2,-2,-2,-2,-2,-2,18301,20161,24621,17125,18378,1344,2026,10040,1000,1253,1350,4416,0,16275,10121,23621,15872,17028,-3072,0.07397727272727272,0.04600454545454546,0.10736818181818182,0.07214545454545454,0.0774,-0.013963636363636364,-12
6641,200000,1,1,1,27,2,2,2,0,0,0,191406,201756,197185,146021,147473,147669,15100,3028,5169,5400,5306,5232,1,176306,198728,192016,140621,142167,142437,0.88153,0.99364,0.96008,0.703105,0.710835,0.712185,6
6642,210000,0,4,2,27,0,0,0,0,0,0,196963,201741,219122,223267,227841,228377,7000,20000,8200,7100,6800,7000,0,189963,181741,210922,216167,221041,221377,0.9045857142857143,0.8654333333333334,1.0043904761904763,1.0293666666666668,1.0525761904761906,1.0541761904761904,0
6643,130000,0,1,2,26,1,-1,2,2,-1,-1,-888,5806,888,0,5087,3103,6694,0,0,5087,3103,2490,0,-7582,5806,888,-5087,1984,613,-0.05832307692307692,0.04466153846153846,0.0068307692307692305,-0.03913076923076923,0.015261538461538462,0.004715384615384615,2
6644,40000,1,3,1,44,1,2,2,0,0,0,35544,36664,35800,36839,35967,36586,2000,0,2000,2000,3000,0,1,33544,36664,33800,34839,32967,36586,0.8386,0.9166,0.845,0.870975,0.824175,0.91465,5
6645,500000,0,1,1,43,1,-2,-2,-2,-1,-1,0,0,0,0,177,4716,0,0,0,177,4716,1000,1,0,0,0,-177,-4539,3716,0.0,0.0,0.0,-0.000354,-0.009078,0.007432,-7
6646,210000,1,2,2,27,-2,-1,0,0,0,0,542,22366,23816,24303,16742,3187,22366,1816,1303,0,0,0,0,-21824,20550,22513,24303,16742,3187,-0.10392380952380953,0.09785714285714285,0.1072047619047619,0.11572857142857143,0.07972380952380953,0.015176190476190477,-3
6647,260000,1,2,1,34,-2,-2,-2,-2,-2,-2,0,0,0,167,-810,-810,0,0,167,810,0,3310,1,0,0,-167,-643,-810,-4120,0.0,0.0,-0.0006423076923076923,-0.002473076923076923,-0.0031153846153846153,-0.015846153846153847,-12
6648,210000,1,3,1,55,-1,-1,-2,-1,0,0,3857,0,0,95438,96317,98400,0,0,95438,3393,3580,3998,1,3857,0,-95438,92045,92737,94402,0.018366666666666667,0.0,-0.4544666666666667,0.4383095238095238,0.4416047619047619,0.44953333333333334,-5
6649,350000,1,3,1,64,0,0,0,0,0,0,30726,27639,28890,31090,32265,33737,3000,2000,3000,2000,2000,2000,1,27726,25639,25890,29090,30265,31737,0.07921714285714286,0.07325428571428572,0.07397142857142858,0.08311428571428571,0.08647142857142857,0.09067714285714286,0
6650,140000,1,1,2,27,0,0,0,0,0,0,128656,126785,129752,132554,268084,137061,6000,6500,6500,5000,5000,5568,0,122656,120285,123252,127554,263084,131493,0.8761142857142857,0.8591785714285715,0.8803714285714286,0.9111,1.8791714285714285,0.9392357142857143,0
6651,100000,0,3,2,35,1,2,0,-1,-1,-1,23704,21774,21818,1261,1261,1261,0,2000,1261,1261,1261,1651,0,23704,19774,20557,0,0,-390,0.23704,0.19774,0.20557,0.0,0.0,-0.0039,0
6652,100000,1,1,1,41,1,-2,-2,-2,-2,-1,0,0,0,0,0,18149,0,0,0,0,18149,0,1,0,0,0,0,-18149,18149,0.0,0.0,0.0,0.0,-0.18149,0.18149,-8
6653,60000,1,1,2,30,-2,-2,-2,-2,-2,-2,0,0,0,0,0,0,0,0,0,0,0,3789,0,0,0,0,0,0,-3789,0.0,0.0,0.0,0.0,0.0,-0.06315,-12
6654,50000,1,2,1,42,0,0,0,0,0,0,38516,28604,28089,27864,27173,27457,1754,1500,1500,1000,1100,1208,1,36762,27104,26589,26864,26073,26249,0.73524,0.54208,0.53178,0.53728,0.52146,0.52498,0
6655,240000,0,1,2,35,0,0,0,0,0,0,241499,236556,229622,202296,165639,159245,8500,10200,8366,6070,10000,6043,0,232999,226356,221256,196226,155639,153202,0.9708291666666666,0.94315,0.9219,0.8176083333333334,0.6484958333333334,0.6383416666666667,0
6656,500000,1,3,1,48,-1,-1,0,0,0,-1,485,6342,6390,5477,1060,23726,6342,1228,1000,1060,23726,1084,1,-5857,5114,5390,4417,-22666,22642,-0.011714,0.010228,0.01078,0.008834,-0.045332,0.045284,-3
6657,50000,0,2,2,42,0,0,0,0,0,0,47282,47535,46578,17029,10575,9478,2500,2000,2500,500,500,500,0,44782,45535,44078,16529,10075,8978,0.89564,0.9107,0.88156,0.33058,0.2015,0.17956,0
6658,130000,1,2,2,24,0,0,0,0,0,0,10071,50961,44362,43359,39010,36546,46034,1800,1659,1200,1150,1158,0,-35963,49161,42703,42159,37860,35388,-0.27663846153846156,0.37816153846153844,0.3284846153846154,0.3243,0.29123076923076924,0.27221538461538464,0
6659,120000,0,2,2,45,1,2,2,2,2,2,63911,62286,67259,67659,68937,70674,0,6000,2100,3000,3000,2500,0,63911,56286,65159,64659,65937,68174,0.5325916666666667,0.46905,0.5429916666666667,0.538825,0.549475,0.5681166666666667,11
6660,360000,1,1,2,26,-2,-2,-2,-1,0,0,0,0,0,23707,25233,23504,0,0,23707,2000,3391,4217,0,0,0,-23707,21707,21842,19287,0.0,0.0,-0.06585277777777777,0.060297222222222224,0.060672222222222225,0.053575,-7
6661,30000,0,2,2,30,0,0,0,0,0,0,27020,27985,28782,24082,17060,0,1703,1500,1000,1000,0,0,0,25317,26485,27782,23082,17060,0,0.8439,0.8828333333333334,0.9260666666666667,0.7694,0.5686666666666667,0.0,0
6662,50000,0,1,2,32,1,2,2,2,2,2,45997,47003,46468,47198,49634,48708,2064,500,1800,3528,0,3000,0,43933,46503,44668,43670,49634,45708,0.87866,0.93006,0.89336,0.8734,0.99268,0.91416,11
6663,180000,1,2,2,44,0,0,0,0,-2,-1,25706,30251,30900,0,0,5386,5000,1900,0,0,5386,1103,0,20706,28351,30900,0,-5386,4283,0.11503333333333333,0.15750555555555557,0.17166666666666666,0.0,-0.02992222222222222,0.023794444444444444,-3
6664,320000,0,2,2,36,0,0,2,0,0,0,289508,302561,283356,275361,268871,256974,21041,1514,9122,9518,9209,10213,0,268467,301047,274234,265843,259662,246761,0.838959375,0.940771875,0.85698125,0.830759375,0.81144375,0.771128125,2
6665,60000,1,3,1,61,0,0,0,0,0,0,28208,29230,30739,30841,28069,27941,1495,2004,2009,1211,2000,1201,1,26713,27226,28730,29630,26069,26740,0.44521666666666665,0.45376666666666665,0.47883333333333333,0.49383333333333335,0.43448333333333333,0.44566666666666666,0
6666,230000,0,1,1,44,1,-1,-1,0,-1,-1,-213,2302,22049,20756,8035,10766,5000,22068,2014,9000,10766,7721,1,-5213,-19766,20035,11756,-2731,3045,-0.022665217391304348,-0.08593913043478262,0.08710869565217391,0.05111304347826087,-0.01187391304347826,0.01323913043478261,-3
6667,50000,1,3,1,45,1,2,0,0,0,0,49768,47191,49422,49586,30023,28373,0,3000,1500,5000,2000,2000,1,49768,44191,47922,44586,28023,26373,0.99536,0.88382,0.95844,0.89172,0.56046,0.52746,3
6668,120000,0,1,2,32,0,0,0,0,0,0,45117,45607,46247,45974,45854,45191,3000,3000,2000,2000,1500,1500,0,42117,42607,44247,43974,44354,43691,0.350975,0.3550583333333333,0.368725,0.36645,0.36961666666666665,0.36409166666666665,0
6669,70000,0,2,3,34,-2,-2,-1,0,0,0,58875,0,72772,39980,40126,39788,0,72772,1400,1500,1500,1600,0,58875,-72772,71372,38480,38626,38188,0.8410714285714286,-1.0396,1.0196,0.5497142857142857,0.5518,0.5455428571428571,-5
6670,140000,1,1,2,36,-1,-1,-1,0,0,-1,780,177,1170,390,0,930,177,1170,0,0,930,0,0,603,-993,1170,390,-930,930,0.0043071428571428575,-0.007092857142857143,0.008357142857142856,0.002785714285714286,-0.006642857142857143,0.006642857142857143,-4
6671,260000,1,2,2,28,-1,-1,-1,-1,-1,-1,500,10500,10500,10500,10500,10500,10500,10500,10500,10500,10500,10500,0,-10000,0,0,0,0,0,-0.038461538461538464,0.0,0.0,0.0,0.0,0.0,-6
6672,320000,0,1,1,40,-1,-1,-1,-1,-1,0,22155,10853,33968,86024,232017,15622,10908,34151,86466,232242,3199,7500,1,11247,-23298,-52498,-146218,228818,8122,0.035146875,-0.07280625,-0.16405625,-0.45693125,0.71505625,0.02538125,-5
6673,160000,0,2,2,30,-2,-2,-2,-2,-2,-2,750,370,-20,780,0,1470,400,0,800,0,1470,0,0,350,370,-820,780,-1470,1470,0.0021875,0.0023125,-0.005125,0.004875,-0.0091875,0.0091875,-12
6674,320000,0,1,2,30,0,0,0,0,0,0,95526,97737,101151,104203,108867,40411,5000,5000,5000,5364,5010,5013,0,90526,92737,96151,98839,103857,35398,0.28289375,0.289803125,0.300471875,0.308871875,0.324553125,0.11061875,0
6675,80000,1,2,1,35,0,0,-2,-2,-2,-2,76978,0,0,0,0,0,0,0,0,0,0,0,1,76978,0,0,0,0,0,0.962225,0.0,0.0,0.0,0.0,0.0,-8
6676,450000,1,1,1,49,1,-1,-1,-1,-1,0,0,557,0,2481,13716,19584,557,0,2481,13716,7100,812,1,-557,557,-2481,-11235,6616,18772,-0.0012377777777777777,0.0012377777777777777,-0.005513333333333334,-0.024966666666666668,0.014702222222222222,0.041715555555555554,-3
6677,30000,0,2,1,40,1,2,0,0,-1,-1,15526,14923,10936,11436,1520,0,0,1000,500,1520,0,0,1,15526,13923,10436,9916,1520,0,0.5175333333333333,0.4641,0.34786666666666666,0.33053333333333335,0.050666666666666665,0.0,1
6678,150000,1,3,1,34,0,0,0,-1,-1,-1,28210,19130,10000,8000,0,10000,1130,1000,8000,2000,10000,0,1,27080,18130,2000,6000,-10000,10000,0.18053333333333332,0.12086666666666666,0.013333333333333334,0.04,-0.06666666666666667,0.06666666666666667,-3
6679,350000,1,1,2,48,-2,-2,-2,-2,-2,-2,0,7900,7620,790,0,0,7900,0,790,0,0,1948,0,-7900,7900,6830,790,0,-1948,-0.022571428571428572,0.022571428571428572,0.019514285714285713,0.0022571428571428573,0.0,-0.005565714285714286,-12
6680,150000,1,1,2,40,-1,-1,-1,-2,-1,-1,800,2400,0,0,1000,0,2400,0,0,1000,0,0,0,-1600,2400,0,-1000,1000,0,-0.010666666666666666,0.016,0.0,-0.006666666666666667,0.006666666666666667,0.0,-7
6681,50000,0,2,1,31,0,0,0,0,0,0,51319,52214,50260,32502,27697,25940,5000,2300,1100,1000,1000,1500,1,46319,49914,49160,31502,26697,24440,0.92638,0.99828,0.9832,0.63004,0.53394,0.4888,0
6682,50000,1,2,1,50,0,0,0,2,0,0,12699,13734,17634,17053,17394,18563,1247,4147,0,624,1451,0,1,11452,9587,17634,16429,15943,18563,0.22904,0.19174,0.35268,0.32858,0.31886,0.37126,2
6683,80000,1,1,2,28,1,-2,-2,-2,-2,-2,0,0,0,0,0,0,0,0,0,0,0,0,0,0,0,0,0,0,0,0.0,0.0,0.0,0.0,0.0,0.0,-9
6684,200000,1,2,2,36,-1,-1,-1,-1,-1,-1,694,2695,660,2315,1290,5745,2721,660,2315,1290,5745,0,0,-2027,2035,-1655,1025,-4455,5745,-0.010135,0.010175,-0.008275,0.005125,-0.022275,0.028725,-6
6685,130000,1,2,1,25,0,-1,-1,-1,0,0,61223,4003,3223,23264,20582,18182,4003,3223,43264,2000,1000,2000,1,57220,780,-40041,21264,19582,16182,0.4401538461538462,0.006,-0.3080076923076923,0.16356923076923077,0.15063076923076923,0.12447692307692308,-3
6686,150000,1,1,2,28,0,0,0,0,0,0,66296,61916,39614,39863,26379,22081,3000,3005,5000,3000,5000,1000,0,63296,58911,34614,36863,21379,21081,0.4219733333333333,0.39274,0.23076,0.24575333333333332,0.14252666666666666,0.14054,0
6687,470000,0,1,1,40,1,2,0,0,0,0,276880,241153,204223,151253,138087,109094,5014,10000,5214,4500,5000,4200,1,271866,231153,199009,146753,133087,104894,0.5784382978723405,0.4918148936170213,0.42342340425531916,0.3122404255319149,0.28316382978723403,0.22317872340425532,3
6688,360000,0,1,1,39,-2,-2,-2,-2,-2,-2,0,0,0,0,0,0,0,0,0,0,0,0,1,0,0,0,0,0,0,0.0,0.0,0.0,0.0,0.0,0.0,-12
6689,60000,0,1,2,27,0,0,-1,-1,0,0,20567,11937,1536,59038,54586,56375,4000,1536,59038,1300,3000,2000,0,16567,10401,-57502,57738,51586,54375,0.2761166666666667,0.17335,-0.9583666666666667,0.9623,0.8597666666666667,0.90625,-2
6690,500000,1,1,1,41,-2,-2,-2,-2,-2,-2,4513,4342,3321,6760,5788,12633,4375,3337,6789,5816,12696,4348,1,138,1005,-3468,944,-6908,8285,0.000276,0.00201,-0.006936,0.001888,-0.013816,0.01657,-12
6691,250000,1,1,1,44,-2,-2,-2,-2,-2,-1,4976,5417,7948,1797,1580,12573,5417,7948,1797,1580,12573,4338,1,-441,-2531,6151,217,-10993,8235,-0.001764,-0.010124,0.024604,0.000868,-0.043972,0.03294,-11
6692,360000,1,2,1,49,-1,-1,-2,-2,-2,-2,15000,0,0,0,0,0,0,0,0,0,0,780,1,15000,0,0,0,0,-780,0.041666666666666664,0.0,0.0,0.0,0.0,-0.0021666666666666666,-10
6693,170000,1,1,1,38,0,0,-2,-2,-2,-2,5556,0,0,0,0,0,0,0,0,0,0,0,1,5556,0,0,0,0,0,0.03268235294117647,0.0,0.0,0.0,0.0,0.0,-8
6694,150000,1,2,2,40,1,-1,-1,-1,-1,-2,-19,3894,5570,10516,-3,-3,3913,5606,10568,0,0,2379,0,-3932,-1712,-4998,10516,-3,-2382,-0.026213333333333335,-0.011413333333333333,-0.03332,0.07010666666666666,-2e-05,-0.01588,-5
6695,140000,1,2,1,45,0,0,0,0,2,2,53951,55444,57549,60971,61374,63243,3000,3000,5000,2000,3000,2500,1,50951,52444,52549,58971,58374,60743,0.3639357142857143,0.3746,0.37535,0.4212214285714286,0.41695714285714286,0.43387857142857145,4
6696,180000,1,2,1,39,-1,-1,-1,-1,-1,-1,5360,6176,398,629,0,978,6207,398,629,0,978,2198,1,-847,5778,-231,629,-978,-1220,-0.004705555555555556,0.0321,-0.0012833333333333334,0.0034944444444444446,-0.005433333333333333,-0.0067777777777777775,-6
6697,20000,0,3,1,50,2,2,2,0,0,0,15089,17037,17457,17868,18428,19120,2200,1000,1000,1000,1000,900,1,12889,16037,16457,16868,17428,18220,0.64445,0.80185,0.82285,0.8434,0.8714,0.911,6
6698,50000,1,2,2,41,1,2,0,0,0,0,49487,48282,39490,27835,23391,24507,0,2000,2537,1500,1500,1500,0,49487,46282,36953,26335,21891,23007,0.98974,0.92564,0.73906,0.5267,0.43782,0.46014,3
6699,300000,1,3,2,30,-2,-2,-2,-2,-2,-2,0,0,0,0,0,0,0,0,0,0,0,0,0,0,0,0,0,0,0,0.0,0.0,0.0,0.0,0.0,0.0,-12
6700,70000,0,1,2,51,0,0,0,2,0,0,43048,43257,44115,41112,39922,40150,3000,4000,0,1500,3000,5000,0,40048,39257,44115,39612,36922,35150,0.5721142857142857,0.5608142857142857,0.6302142857142857,0.5658857142857143,0.5274571428571428,0.5021428571428571,2
6701,340000,1,1,2,35,-1,-1,0,0,0,0,484,15904,44852,41971,81011,38472,15904,30000,20000,50000,20000,10000,0,-15420,-14096,24852,-8029,61011,28472,-0.04535294117647059,-0.04145882352941176,0.07309411764705882,-0.02361470588235294,0.17944411764705884,0.08374117647058824,-2
6702,320000,1,2,1,29,-1,-1,-1,0,0,0,3196,7655,204787,122501,63816,17257,7655,205211,6100,5000,2000,8000,1,-4459,-197556,198687,117501,61816,9257,-0.013934375,-0.6173625,0.620896875,0.367190625,0.193175,0.028928125,-3
6703,500000,0,2,1,49,-1,-1,-1,-1,-1,0,371,3523,483,12988,92539,94292,3540,485,13052,92539,3160,1910,1,-3169,3038,-12569,-79551,89379,92382,-0.006338,0.006076,-0.025138,-0.159102,0.178758,0.184764,-5
6704,90000,1,2,2,25,0,0,2,0,0,0,86830,94016,88477,87820,88444,91198,9000,0,4100,3000,4000,4500,0,77830,94016,84377,84820,84444,86698,0.8647777777777778,1.0446222222222221,0.9375222222222223,0.9424444444444444,0.9382666666666667,0.9633111111111111,2
6705,220000,1,2,1,34,-1,-1,-1,-1,-1,-1,51565,15683,1381,3300,2452,2728,15683,1381,3300,2452,2728,0,1,35882,14302,-1919,848,-276,2728,0.1631,0.0650090909090909,-0.008722727272727273,0.0038545454545454547,-0.0012545454545454546,0.0124,-6
6706,420000,0,1,1,53,-1,-1,-1,-1,-1,-1,1936,3473,12230,13682,1695,712,3489,12290,13749,1706,714,584,1,-1553,-8817,-1519,11976,981,128,-0.0036976190476190477,-0.020992857142857143,-0.0036166666666666665,0.028514285714285714,0.0023357142857142856,0.00030476190476190474,-6
6707,120000,1,2,1,36,1,-2,-1,-1,-2,-2,0,0,1100,0,0,0,0,1100,0,0,0,0,1,0,-1100,1100,0,0,0,0.0,-0.009166666666666667,0.009166666666666667,0.0,0.0,0.0,-7
6708,170000,1,1,2,34,0,0,0,0,0,0,172095,160914,103021,99219,99179,99902,6317,3632,3494,3620,3800,4000,0,165778,157282,99527,95599,95379,95902,0.9751647058823529,0.9251882352941176,0.5854529411764706,0.5623470588235294,0.5610529411764706,0.5641294117647059,0
6709,90000,1,3,1,55,0,0,0,0,0,0,39731,38272,36858,35447,33465,31680,2000,2000,2000,1400,1400,1712,1,37731,36272,34858,34047,32065,29968,0.41923333333333335,0.4030222222222222,0.3873111111111111,0.3783,0.3562777777777778,0.33297777777777776,0
6710,130000,0,2,1,52,0,0,2,2,0,0,82399,89003,90160,87817,89746,98655,7931,3500,0,3499,10648,0,1,74468,85503,90160,84318,79098,98655,0.5728307692307693,0.6577153846153846,0.6935384615384615,0.6486,0.6084461538461539,0.7588846153846154,4
6711,50000,0,2,1,46,0,0,0,2,0,0,15220,16961,19930,19328,37113,19165,2000,3258,0,679,1528,587,1,13220,13703,19930,18649,35585,18578,0.2644,0.27406,0.3986,0.37298,0.7117,0.37156,2
6712,160000,1,3,1,35,-1,-1,-1,-1,0,0,335,0,312,7736,7278,7278,0,312,7736,0,0,1470,1,335,-312,-7424,7736,7278,5808,0.00209375,-0.00195,-0.0464,0.04835,0.0454875,0.0363,-4
6713,500000,0,1,2,33,-1,-1,-1,-1,0,0,1025,1691,1316,4941,8539,3842,2000,1316,5000,5000,2000,1223,0,-975,375,-3684,-59,6539,2619,-0.00195,0.00075,-0.007368,-0.000118,0.013078,0.005238,-4
6714,60000,1,3,2,32,0,0,0,0,0,0,59143,58612,59017,59220,26607,29719,2100,3000,3008,6000,4000,1000,0,57043,55612,56009,53220,22607,28719,0.9507166666666667,0.9268666666666666,0.9334833333333333,0.887,0.37678333333333336,0.47865,0
6715,60000,0,2,2,42,1,2,0,0,0,0,60560,56471,36057,35077,69251,71478,2065,1988,2500,62731,3600,1600,0,58495,54483,33557,-27654,65651,69878,0.9749166666666667,0.90805,0.5592833333333334,-0.4609,1.0941833333333333,1.1646333333333334,3
6716,420000,0,1,1,47,-1,-1,-1,-1,-1,-1,10517,15571,9090,9622,10223,3942,15585,9100,9628,10223,3942,3754,1,-5068,6471,-538,-601,6281,188,-0.012066666666666667,0.015407142857142857,-0.0012809523809523809,-0.001430952380952381,0.014954761904761905,0.0004476190476190476,-6
6717,150000,0,1,2,32,0,-1,-1,-1,-1,-2,46272,1079,0,41147,-3,-3,1082,0,41147,0,0,0,0,45190,1079,-41147,41147,-3,-3,0.3012666666666667,0.007193333333333334,-0.27431333333333335,0.27431333333333335,-2e-05,-2e-05,-6
6718,100000,0,2,2,30,2,4,4,4,3,2,89898,92422,95979,93580,91181,93563,4900,5900,0,0,4000,3200,0,84998,86522,95979,93580,87181,90363,0.84998,0.86522,0.95979,0.9358,0.87181,0.90363,19
6719,100000,1,2,1,28,0,0,0,0,0,0,94245,95268,96620,97938,78126,65680,3500,3800,3900,3000,2300,2300,1,90745,91468,92720,94938,75826,63380,0.90745,0.91468,0.9272,0.94938,0.75826,0.6338,0
6720,20000,1,2,2,23,0,0,0,0,2,0,4561,6474,8353,13192,14871,11536,2000,2000,5000,2000,1000,2000,0,2561,4474,3353,11192,13871,9536,0.12805,0.2237,0.16765,0.5596,0.69355,0.4768,2
6721,220000,1,1,1,42,2,2,2,2,2,2,2500,2500,2500,2500,2500,2500,0,0,0,0,0,0,1,2500,2500,2500,2500,2500,2500,0.011363636363636364,0.011363636363636364,0.011363636363636364,0.011363636363636364,0.011363636363636364,0.011363636363636364,12
6722,200000,0,3,2,36,-2,-2,-2,-2,-2,-2,45810,0,0,0,0,0,0,0,0,0,0,40714,0,45810,0,0,0,0,-40714,0.22905,0.0,0.0,0.0,0.0,-0.20357,-12
6723,20000,0,2,1,32,0,0,0,0,2,2,8768,9622,10974,14963,15123,14741,1159,1511,4500,700,0,1000,1,7609,8111,6474,14263,15123,13741,0.38045,0.40555,0.3237,0.71315,0.75615,0.68705,4
6724,20000,0,3,2,31,3,2,2,2,0,0,11358,10884,13109,12602,13093,13433,0,2716,0,700,700,500,0,11358,8168,13109,11902,12393,12933,0.5679,0.4084,0.65545,0.5951,0.61965,0.64665,9
6725,420000,1,2,1,29,0,0,0,0,0,0,48455,34993,35340,54763,59037,60290,2011,3000,20000,5000,2000,3000,1,46444,31993,15340,49763,57037,57290,0.11058095238095238,0.07617380952380952,0.03652380952380952,0.11848333333333333,0.13580238095238095,0.13640476190476192,0
6726,240000,1,1,1,38,-1,-1,-1,0,0,-1,8213,20000,44384,28734,13200,43791,20000,44384,750,2000,81800,1050,1,-11787,-24384,43634,26734,-68600,42741,-0.0491125,-0.1016,0.18180833333333332,0.11139166666666667,-0.28583333333333333,0.1780875,-4
6727,40000,1,3,1,40,1,-1,2,2,2,-2,-531,2661,3871,1488,0,0,3383,2000,0,0,0,431,1,-3914,661,3871,1488,0,-431,-0.09785,0.016525,0.096775,0.0372,0.0,-0.010775,4
6728,230000,1,1,2,28,0,0,0,-2,-2,-1,231591,102650,0,0,0,915,4650,0,0,0,915,4306,0,226941,102650,0,0,-915,-3391,0.9867,0.44630434782608697,0.0,0.0,-0.0039782608695652175,-0.014743478260869565,-5
6729,20000,1,3,1,37,1,2,0,0,2,0,15829,15283,16429,19764,19140,6420,0,1700,4000,0,1000,0,1,15829,13583,12429,19764,18140,6420,0.79145,0.67915,0.62145,0.9882,0.907,0.321,5
6730,210000,1,2,2,38,0,0,0,0,0,0,76418,78798,82525,84353,87835,79481,5000,5000,3200,5000,3000,2500,0,71418,73798,79325,79353,84835,76981,0.34008571428571427,0.35141904761904763,0.37773809523809526,0.3778714285714286,0.4039761904761905,0.3665761904761905,0
6731,60000,1,2,2,24,0,0,0,0,0,0,58143,60221,50135,19553,11896,15241,3044,1123,7553,474,3586,305,0,55099,59098,42582,19079,8310,14936,0.9183166666666667,0.9849666666666667,0.7097,0.31798333333333334,0.1385,0.24893333333333334,0
6732,110000,1,3,2,41,0,0,0,0,0,0,90599,60949,62235,63499,64877,66230,2213,2300,2300,2400,2431,8700,0,88386,58649,59935,61099,62446,57530,0.803509090909091,0.5331727272727272,0.5448636363636363,0.5554454545454546,0.5676909090909091,0.523,0
6733,390000,0,1,1,31,0,0,-1,-1,-1,-1,54007,62761,10373,6803,2601,2979,49188,10411,6830,2608,2987,2236,1,4819,52350,3543,4195,-386,743,0.012356410256410256,0.13423076923076924,0.009084615384615385,0.010756410256410257,-0.0009897435897435896,0.001905128205128205,-4
6734,200000,1,1,2,39,-1,-1,0,0,-1,-1,2277,16002,13207,8738,6471,2723,16021,1005,185,6482,2731,3974,0,-13744,14997,13022,2256,3740,-1251,-0.06872,0.074985,0.06511,0.01128,0.0187,-0.006255,-4
6735,500000,1,1,2,38,0,0,0,0,0,0,74615,74399,68761,70260,70143,68506,4010,6720,5000,5000,4000,5000,0,70605,67679,63761,65260,66143,63506,0.14121,0.135358,0.127522,0.13052,0.132286,0.127012,0
6736,220000,0,1,1,35,-1,-1,-1,-1,0,-1,753,6213,762,5106,700,1364,6220,762,5806,0,1364,500,1,-5467,5451,-5044,5106,-664,864,-0.02485,0.024777272727272728,-0.022927272727272727,0.02320909090909091,-0.0030181818181818183,0.003927272727272727,-5
6737,100000,1,3,1,38,0,0,0,0,0,0,62427,63922,65864,66578,69503,72346,2500,3000,2400,4000,4000,4000,1,59927,60922,63464,62578,65503,68346,0.59927,0.60922,0.63464,0.62578,0.65503,0.68346,0
6738,80000,1,2,1,41,0,0,0,2,0,0,78480,77063,76720,74651,57109,46703,3100,6300,0,1743,1588,1628,1,75380,70763,76720,72908,55521,45075,0.94225,0.8845375,0.959,0.91135,0.6940125,0.5634375,2
6739,170000,1,2,1,23,2,0,0,0,0,0,160189,150377,138779,129548,121625,108462,5936,4584,4002,4093,4187,4335,1,154253,145793,134777,125455,117438,104127,0.9073705882352942,0.8576058823529412,0.7928058823529411,0.7379705882352942,0.6908117647058823,0.6125117647058823,2
6740,170000,0,4,1,28,0,0,0,-1,-1,-1,171098,166176,169759,11760,0,4902,14000,5695,11760,0,4902,6000,1,157098,160481,157999,11760,-4902,-1098,0.9241058823529412,0.9440058823529411,0.9294058823529412,0.0691764705882353,-0.02883529411764706,-0.006458823529411765,-3
6741,90000,1,3,2,27,2,0,0,0,0,0,92290,90719,39902,39200,38531,32991,4183,1600,1280,1310,1432,1088,0,88107,89119,38622,37890,37099,31903,0.9789666666666667,0.9902111111111112,0.4291333333333333,0.421,0.4122111111111111,0.3544777777777778,2
6742,30000,1,3,1,58,0,0,0,0,0,0,9819,10873,9646,9995,10371,5139,1230,1100,419,600,500,500,1,8589,9773,9227,9395,9871,4639,0.2863,0.32576666666666665,0.30756666666666665,0.31316666666666665,0.32903333333333334,0.15463333333333334,0
6743,170000,1,3,2,29,-1,-1,-1,-2,-2,-2,14460,738,0,0,0,0,738,0,0,0,0,0,0,13722,738,0,0,0,0,0.08071764705882353,0.0043411764705882355,0.0,0.0,0.0,0.0,-9
6744,280000,1,1,1,32,0,0,0,0,0,0,137630,116209,117118,116689,117757,118432,6000,6000,5000,5000,4012,4779,1,131630,110209,112118,111689,113745,113653,0.47010714285714283,0.39360357142857144,0.4004214285714286,0.3988892857142857,0.4062321428571429,0.4059035714285714,0
6745,50000,0,2,1,35,0,0,0,0,0,0,20274,44996,21147,21964,21405,20297,2600,1800,1500,1000,1000,1000,1,17674,43196,19647,20964,20405,19297,0.35348,0.86392,0.39294,0.41928,0.4081,0.38594,0
6746,230000,1,2,1,45,0,0,0,0,0,0,71149,71922,77500,72851,72860,48758,3000,11261,10000,2100,5000,5000,1,68149,60661,67500,70751,67860,43758,0.2963,0.2637434782608696,0.29347826086956524,0.30761304347826085,0.2950434782608696,0.19025217391304347,0
6747,50000,0,2,2,25,0,0,-1,-1,0,0,48517,37071,5181,8548,50678,48220,5204,5196,8557,48011,2040,2121,0,43313,31875,-3376,-39463,48638,46099,0.86626,0.6375,-0.06752,-0.78926,0.97276,0.92198,-2
6748,20000,0,2,2,33,3,2,8,7,6,5,14513,22232,21936,21631,21026,20130,8000,0,0,0,0,0,0,6513,22232,21936,21631,21026,20130,0.32565,1.1116,1.0968,1.08155,1.0513,1.0065,31
6749,500000,1,2,1,31,0,0,0,0,0,0,348526,345128,337816,316739,167616,364940,15210,15022,20121,5925,35069,35110,1,333316,330106,317695,310814,132547,329830,0.666632,0.660212,0.63539,0.621628,0.265094,0.65966,0
6750,360000,0,1,1,45,-1,-1,-1,-1,0,-1,2369,1367,8570,5625,3684,2804,1367,8570,5625,0,2804,2473,1,1002,-7203,2945,5625,880,331,0.0027833333333333334,-0.020008333333333333,0.008180555555555555,0.015625,0.0024444444444444444,0.0009194444444444444,-5
6751,150000,1,4,1,28,0,0,0,0,0,0,152105,137472,118583,95094,50999,35383,6300,4500,2524,2000,2000,92000,1,145805,132972,116059,93094,48999,-56617,0.9720333333333333,0.88648,0.7737266666666667,0.6206266666666667,0.32666,-0.37744666666666665,0
6752,60000,1,1,2,24,0,0,0,0,0,0,59267,60042,59225,59947,60107,57338,2694,2800,2300,2250,2081,2120,0,56573,57242,56925,57697,58026,55218,0.9428833333333333,0.9540333333333333,0.94875,0.9616166666666667,0.9671,0.9203,0
6753,260000,1,2,2,31,0,0,0,0,0,0,69957,72727,73562,65954,30948,0,3945,2764,5431,633,0,0,0,66012,69963,68131,65321,30948,0,0.2538923076923077,0.26908846153846155,0.2620423076923077,0.2512346153846154,0.11903076923076923,0.0,0
6754,140000,0,2,2,44,0,0,0,0,0,0,85119,86901,89583,90432,92332,94197,3153,4126,3231,3351,3400,3494,0,81966,82775,86352,87081,88932,90703,0.5854714285714285,0.59125,0.6168,0.6220071428571429,0.6352285714285715,0.6478785714285714,0
6755,60000,1,2,2,31,-1,-1,2,-1,-1,-1,326,1152,826,22662,38211,19671,1152,0,22662,38211,19671,12245,0,-826,1152,-21836,-15549,18540,7426,-0.013766666666666667,0.0192,-0.36393333333333333,-0.25915,0.309,0.12376666666666666,-3
6756,220000,1,1,1,54,1,-2,-1,-1,-1,-1,0,0,788,0,349,600,0,788,0,349,600,0,1,0,-788,788,-349,-251,600,0.0,-0.0035818181818181817,0.0035818181818181817,-0.0015863636363636364,-0.0011409090909090909,0.0027272727272727275,-5
6757,50000,0,2,2,24,0,0,-1,0,0,0,44687,39137,39877,28471,29309,28409,2138,44447,2202,2004,1202,1051,0,42549,-5310,37675,26467,28107,27358,0.85098,-0.1062,0.7535,0.52934,0.56214,0.54716,-1
6758,340000,0,1,1,38,-1,-1,-1,-1,-1,-1,325,325,325,580,9664,29200,325,325,580,9664,29200,5260,1,0,0,-255,-9084,-19536,23940,0.0,0.0,-0.00075,-0.02671764705882353,-0.057458823529411764,0.07041176470588235,-6
6759,200000,1,2,1,40,-2,-2,-2,-2,-2,-2,1521,-5,-5,-5,-5,1028,0,0,0,0,1033,12857,1,1521,-5,-5,-5,-1038,-11829,0.007605,-2.5e-05,-2.5e-05,-2.5e-05,-0.00519,-0.059145,-12
6760,60000,1,2,1,39,0,0,0,0,0,0,58017,59481,60360,38307,35519,35356,2396,2110,1272,1257,1245,1138,1,55621,57371,59088,37050,34274,34218,0.9270166666666667,0.9561833333333334,0.9848,0.6175,0.5712333333333334,0.5703,0
6761,230000,1,1,2,40,-2,-2,-2,-2,-2,-2,360,0,0,0,0,0,0,0,0,0,0,0,0,360,0,0,0,0,0,0.001565217391304348,0.0,0.0,0.0,0.0,0.0,-12
6762,180000,1,2,2,37,-1,-1,-2,-2,-2,-2,491,0,0,0,0,0,0,0,0,0,0,3738,0,491,0,0,0,0,-3738,0.0027277777777777778,0.0,0.0,0.0,0.0,-0.020766666666666666,-10
6763,50000,1,3,1,31,0,0,0,0,0,0,50734,43406,44333,44577,44501,11614,1700,2016,1600,2100,1000,47000,1,49034,41390,42733,42477,43501,-35386,0.98068,0.8278,0.85466,0.84954,0.87002,-0.70772,0
6764,150000,1,2,1,33,0,0,0,0,0,0,37794,39240,40653,41249,42356,43278,2000,2000,1500,1700,1700,1668,1,35794,37240,39153,39549,40656,41610,0.23862666666666665,0.24826666666666666,0.26102,0.26366,0.27104,0.2774,0
6765,360000,0,2,1,34,0,0,0,0,0,0,31580,32618,33610,34281,34944,35498,1549,1541,1212,1200,1000,1000,1,30031,31077,32398,33081,33944,34498,0.08341944444444445,0.086325,0.08999444444444445,0.09189166666666666,0.0942888888888889,0.09582777777777778,0
6766,120000,0,1,1,52,2,2,2,2,3,2,112593,112623,115258,119620,118928,121619,3300,6000,7800,1500,4800,0,1,109293,106623,107458,118120,114128,121619,0.910775,0.888525,0.8954833333333333,0.9843333333333333,0.9510666666666666,1.0134916666666667,13
6767,60000,1,2,3,39,1,1,-2,-2,-2,-2,58574,-1540,-1930,-2320,-1220,0,0,0,0,2000,2000,0,0,58574,-1540,-1930,-4320,-3220,0,0.9762333333333333,-0.025666666666666667,-0.03216666666666667,-0.072,-0.05366666666666667,0.0,-6
6768,230000,1,3,2,39,-2,-2,-2,-2,-2,-2,1876,1876,1876,2848,1876,4634,1876,1876,2848,1876,4634,1876,0,0,0,-972,972,-2758,2758,0.0,0.0,-0.004226086956521739,0.004226086956521739,-0.011991304347826087,0.011991304347826087,-12
6769,50000,0,3,1,50,0,0,0,2,0,0,63889,65512,68764,14353,16110,17832,2800,4000,0,2000,2000,1000,1,61089,61512,68764,12353,14110,16832,1.22178,1.23024,1.37528,0.24706,0.2822,0.33664,2
6770,80000,1,2,2,33,0,-1,-1,0,-1,-1,17254,811,1533,722,811,337,1000,1533,0,900,337,1000,0,16254,-722,1533,-178,474,-663,0.203175,-0.009025,0.0191625,-0.002225,0.005925,-0.0082875,-4
6771,200000,0,2,1,36,-1,-1,-1,-1,-1,-1,4670,4670,4670,4670,4670,4670,4670,4670,4670,4670,4670,4670,1,0,0,0,0,0,0,0.0,0.0,0.0,0.0,0.0,0.0,-6
6772,280000,1,1,2,35,-1,-1,-2,-2,-2,-2,3072,0,0,0,0,0,0,0,0,0,0,0,0,3072,0,0,0,0,0,0.010971428571428571,0.0,0.0,0.0,0.0,0.0,-10
6773,120000,0,2,2,29,1,2,0,0,2,2,87376,85135,86024,91380,93263,95079,0,3200,6800,3500,3500,0,0,87376,81935,79224,87880,89763,95079,0.7281333333333333,0.6827916666666667,0.6602,0.7323333333333333,0.748025,0.792325,7
6774,30000,1,2,1,38,1,2,2,0,0,0,29803,30766,29918,29071,29527,30480,1734,0,1148,1034,2667,0,1,28069,30766,28770,28037,26860,30480,0.9356333333333333,1.0255333333333334,0.959,0.9345666666666667,0.8953333333333333,1.016,5
6775,130000,1,4,2,28,0,0,0,0,0,0,36108,34256,36357,37878,39489,41833,3000,3000,2500,3000,3000,2000,0,33108,31256,33857,34878,36489,39833,0.2546769230769231,0.24043076923076923,0.26043846153846156,0.2682923076923077,0.28068461538461537,0.3064076923076923,0
6776,230000,1,3,1,58,-2,-2,-2,-2,-2,-2,316,316,2310,316,316,316,316,2310,316,316,316,316,1,0,-1994,1994,0,0,0,0.0,-0.008669565217391305,0.008669565217391305,0.0,0.0,0.0,-12
6777,350000,1,1,1,36,-2,-2,-2,-2,-2,-2,1133,0,1342,2195,0,37800,0,1342,2195,0,37800,1000,1,1133,-1342,-853,2195,-37800,36800,0.0032371428571428573,-0.003834285714285714,-0.0024371428571428573,0.006271428571428571,-0.108,0.10514285714285715,-12
6778,90000,1,2,1,45,0,0,0,0,-1,0,63049,71245,70819,20301,87497,86938,10000,1612,0,87497,10000,20000,1,53049,69633,70819,-67196,77497,66938,0.5894333333333334,0.7737,0.7868777777777778,-0.7466222222222222,0.8610777777777778,0.7437555555555555,-1
6779,50000,1,1,2,31,-1,0,-1,-1,-1,-2,12725,34526,12787,3995,0,0,30018,12787,3995,0,0,0,0,-17293,21739,8792,3995,0,0,-0.34586,0.43478,0.17584,0.0799,0.0,0.0,-6
6780,230000,1,3,2,26,-2,-1,0,0,0,0,1200,990,9079,11186,10159,11734,990,8089,2186,1159,1734,1200,0,210,-7099,6893,10027,8425,10534,0.0009130434782608696,-0.030865217391304347,0.029969565217391303,0.04359565217391304,0.036630434782608697,0.0458,-3
6781,390000,0,2,2,33,0,0,0,0,0,0,30209,31193,31440,38001,48301,28131,1804,2561,8122,11000,20015,1002,0,28405,28632,23318,27001,28286,27129,0.07283333333333333,0.07341538461538462,0.05978974358974359,0.06923333333333333,0.07252820512820513,0.06956153846153847,0
6782,140000,1,2,1,42,1,-2,-1,-1,-1,-1,0,0,1497,1039,1139,0,0,1497,1039,1139,0,5023,1,0,-1497,458,-100,1139,-5023,0.0,-0.010692857142857143,0.0032714285714285714,-0.0007142857142857143,0.008135714285714286,-0.035878571428571426,-5
6783,150000,1,1,2,30,0,0,2,0,-1,-1,14883,12683,2700,1500,18439,1381,4908,0,0,18439,1381,0,0,9975,12683,2700,-16939,17058,1381,0.0665,0.08455333333333333,0.018,-0.11292666666666666,0.11372,0.009206666666666667,0
6784,20000,0,3,1,27,0,0,2,0,0,0,20184,20702,20057,19583,19991,20446,2950,2,687,709,965,559,1,17234,20700,19370,18874,19026,19887,0.8617,1.035,0.9685,0.9437,0.9513,0.99435,2
6785,30000,1,2,2,27,2,2,2,2,2,2,15191,16144,16383,16518,16907,17279,1500,800,700,800,800,800,0,13691,15344,15683,15718,16107,16479,0.45636666666666664,0.5114666666666666,0.5227666666666667,0.5239333333333334,0.5369,0.5493,12
6786,230000,1,3,1,36,1,2,0,0,0,0,232115,225086,222286,222884,220876,221496,22,9005,9037,7519,8018,8100,1,232093,216081,213249,215365,212858,213396,1.0091,0.9394826086956521,0.9271695652173914,0.9363695652173913,0.9254695652173913,0.9278086956521739,3
6787,160000,0,1,2,29,-1,-1,-1,-1,-1,0,554,-78,622,-10,326,326,0,700,0,652,0,0,0,554,-778,622,-662,326,326,0.0034625,-0.0048625,0.0038875,-0.0041375,0.0020375,0.0020375,-5
6788,450000,1,1,1,33,1,-1,2,0,0,-1,621,11368,2370,2823,2243,4322,11420,0,2243,0,4322,0,1,-10799,11368,127,2823,-2079,4322,-0.023997777777777778,0.02526222222222222,0.00028222222222222223,0.006273333333333333,-0.00462,0.009604444444444445,1
6789,20000,1,2,2,43,-1,2,0,0,0,0,6483,6233,7254,8106,8418,8440,0,1283,1135,447,306,307,0,6483,4950,6119,7659,8112,8133,0.32415,0.2475,0.30595,0.38295,0.4056,0.40665,1
6790,160000,1,2,1,29,-1,-1,-1,-1,-1,-1,3617,2091,5816,5414,615,25072,2122,5822,5524,615,25139,2100,1,1495,-3731,292,4799,-24524,22972,0.00934375,-0.02331875,0.001825,0.02999375,-0.153275,0.143575,-6
6791,240000,1,2,1,37,-1,0,0,0,0,0,12365,92184,86507,89138,91118,93229,90500,3000,3000,2500,2500,3000,1,-78135,89184,83507,86638,88618,90229,-0.3255625,0.3716,0.34794583333333334,0.36099166666666666,0.3692416666666667,0.37595416666666664,-1
6792,320000,0,1,2,25,0,0,0,0,0,0,146183,148703,169920,174315,173032,176016,6206,25006,10025,6506,7006,8006,0,139977,123697,159895,167809,166026,168010,0.437428125,0.386553125,0.499671875,0.524403125,0.51883125,0.52503125,0
6793,80000,1,2,1,42,0,0,-2,-2,-2,-2,30900,0,0,0,0,0,0,0,0,0,0,0,1,30900,0,0,0,0,0,0.38625,0.0,0.0,0.0,0.0,0.0,-8
6794,60000,1,2,1,45,0,-1,-1,0,0,0,56965,2495,57899,30345,30244,25474,3000,61000,3000,3000,3000,9000,1,53965,-58505,54899,27345,27244,16474,0.8994166666666666,-0.9750833333333333,0.9149833333333334,0.45575,0.4540666666666667,0.2745666666666667,-2
6795,20000,1,2,1,23,2,0,0,0,2,0,16219,17626,18398,19052,15429,9199,1674,1446,1100,0,379,1085,1,14545,16180,17298,19052,15050,8114,0.72725,0.809,0.8649,0.9526,0.7525,0.4057,4
6796,340000,1,1,1,38,-1,-1,0,0,0,-1,15065,41951,86114,82049,57667,80767,41951,50000,30000,5000,80767,10000,1,-26886,-8049,56114,77049,-23100,70767,-0.07907647058823529,-0.023673529411764704,0.16504117647058825,0.22661470588235294,-0.06794117647058824,0.20813823529411765,-3
6797,90000,1,3,2,28,2,0,0,0,2,0,63869,65212,66627,70652,69397,70842,2368,2500,5140,0,2600,3000,0,61501,62712,61487,70652,66797,67842,0.6833444444444444,0.6968,0.6831888888888888,0.7850222222222222,0.7421888888888889,0.7538,4
6798,50000,0,2,2,25,0,0,0,0,0,0,49899,35200,29447,19980,10400,0,1679,2438,1700,1000,0,0,0,48220,32762,27747,18980,10400,0,0.9644,0.65524,0.55494,0.3796,0.208,0.0,0
6799,90000,0,2,1,32,0,0,0,0,0,0,36081,37802,29985,28447,24775,25498,3002,1600,1500,1000,1500,1500,1,33079,36202,28485,27447,23275,23998,0.36754444444444445,0.40224444444444446,0.3165,0.30496666666666666,0.2586111111111111,0.26664444444444446,0
6800,140000,0,2,1,37,0,0,0,0,0,0,64372,64937,59133,53193,47352,41627,2300,2200,2000,2000,2000,1500,1,62072,62737,57133,51193,45352,40127,0.4433714285714286,0.44812142857142856,0.40809285714285715,0.3656642857142857,0.32394285714285714,0.2866214285714286,0
6801,30000,1,1,2,24,0,0,0,0,0,0,4848,6524,6290,4440,4531,1300,3000,1108,1000,91,26,0,0,1848,5416,5290,4349,4505,1300,0.0616,0.18053333333333332,0.17633333333333334,0.14496666666666666,0.15016666666666667,0.043333333333333335,0
6802,150000,1,4,1,34,0,0,0,0,0,0,83000,88000,93000,98000,100000,0,5000,5000,5000,2000,0,0,1,78000,83000,88000,96000,100000,0,0.52,0.5533333333333333,0.5866666666666667,0.64,0.6666666666666666,0.0,0
6803,160000,1,1,2,29,-1,2,-1,0,-1,2,2599,1302,1852,736,3542,1852,0,1852,0,3542,0,1116,0,2599,-550,1852,-2806,3542,736,0.01624375,-0.0034375,0.011575,-0.0175375,0.0221375,0.0046,1
6804,60000,0,1,2,24,-1,-1,-1,-2,-1,-1,390,780,0,0,371,18239,780,0,0,371,18239,650,0,-390,780,0,-371,-17868,17589,-0.0065,0.013,0.0,-0.006183333333333333,-0.2978,0.29315,-7
6805,130000,1,2,1,34,0,0,0,0,-1,-1,9383,9380,7350,3488,3991,3077,1317,1268,1010,4003,3086,2406,1,8066,8112,6340,-515,905,671,0.06204615384615385,0.0624,0.048769230769230766,-0.003961538461538462,0.006961538461538462,0.005161538461538461,-2
6806,170000,1,2,2,30,0,0,0,0,0,0,92626,90727,93345,93812,95613,95972,5000,5000,5000,5000,4400,3000,0,87626,85727,88345,88812,91213,92972,0.5154470588235294,0.5042764705882353,0.5196764705882353,0.5224235294117647,0.5365470588235294,0.5468941176470589,0
6807,80000,1,2,2,43,0,0,0,0,0,0,77057,78102,58501,51042,19036,19414,3177,2600,3000,1691,695,882,0,73880,75502,55501,49351,18341,18532,0.9235,0.943775,0.6937625,0.6168875,0.2292625,0.23165,0
6808,120000,0,2,2,37,1,2,0,0,0,0,21786,22126,23763,25059,25641,26228,1000,2000,2000,1000,1000,1000,0,20786,20126,21763,24059,24641,25228,0.17321666666666666,0.16771666666666665,0.18135833333333334,0.20049166666666668,0.20534166666666667,0.21023333333333333,3
6809,50000,1,2,1,33,0,0,0,0,2,2,40738,43923,45409,47718,46480,48756,4200,2500,3500,0,2800,1400,1,36538,41423,41909,47718,43680,47356,0.73076,0.82846,0.83818,0.95436,0.8736,0.94712,4
6810,20000,1,2,1,58,-1,-1,-1,-1,-2,-1,17895,13576,18286,-200,0,18486,13605,19352,0,200,18486,5656,1,4290,-5776,18286,-400,-18486,12830,0.2145,-0.2888,0.9143,-0.02,-0.9243,0.6415,-7
6811,120000,1,2,2,28,0,0,0,0,-2,-2,48499,48684,6344,0,0,0,1621,1000,1326,0,0,0,0,46878,47684,5018,0,0,0,0.39065,0.39736666666666665,0.04181666666666667,0.0,0.0,0.0,-4
6812,50000,1,2,1,47,0,0,0,0,0,0,49571,37680,31932,25300,18902,18920,2000,1812,2000,664,700,709,1,47571,35868,29932,24636,18202,18211,0.95142,0.71736,0.59864,0.49272,0.36404,0.36422,0
6813,150000,1,2,1,50,-2,-2,-2,-2,-2,-2,0,0,0,0,0,0,0,0,0,0,0,0,1,0,0,0,0,0,0,0.0,0.0,0.0,0.0,0.0,0.0,-12
6814,230000,1,3,1,52,-2,-2,-2,-2,-2,-2,986,3915,2233,1410,0,0,3939,2244,1421,0,0,236,1,-2953,1671,812,1410,0,-236,-0.012839130434782608,0.0072652173913043475,0.0035304347826086956,0.0061304347826086954,0.0,-0.001026086956521739,-12
6815,50000,1,2,1,31,0,0,0,2,0,0,45074,46546,48945,47994,48704,41189,2201,3600,0,1500,1500,1531,1,42873,42946,48945,46494,47204,39658,0.85746,0.85892,0.9789,0.92988,0.94408,0.79316,2
6816,80000,0,2,2,39,3,2,0,0,0,0,75635,73830,74968,23867,23130,0,0,2968,1867,463,0,0,0,75635,70862,73101,23404,23130,0,0.9454375,0.885775,0.9137625,0.29255,0.289125,0.0,5
6817,160000,1,2,1,25,4,3,2,0,0,0,103398,100925,97701,99434,99527,16331,0,0,2321,432,546,550,1,103398,100925,95380,99002,98981,15781,0.6462375,0.63078125,0.596125,0.6187625,0.61863125,0.09863125,9
6818,460000,1,1,2,41,0,-1,-1,-2,-2,-1,6302,31293,0,0,0,18165,31321,0,0,0,18165,2008,0,-25019,31293,0,0,-18165,16157,-0.05438913043478261,0.06802826086956522,0.0,0.0,-0.03948913043478261,0.03512391304347826,-7
6819,260000,0,1,1,36,0,0,0,0,0,0,239206,212271,191813,193555,197090,200841,9029,9000,7100,7509,8000,6888,1,230177,203271,184713,186046,189090,193953,0.8852961538461539,0.7818115384615385,0.7104346153846154,0.7155615384615385,0.7272692307692308,0.7459730769230769,0
6820,240000,0,2,1,56,-1,-1,-1,-1,-1,-1,390,390,390,390,390,390,390,780,390,390,390,540,1,0,-390,0,0,0,-150,0.0,-0.001625,0.0,0.0,0.0,-0.000625,-6
6821,20000,1,2,1,29,0,0,0,2,3,3,14757,16196,17825,20234,20510,19897,2000,2200,3000,900,0,500,1,12757,13996,14825,19334,20510,19397,0.63785,0.6998,0.74125,0.9667,1.0255,0.96985,8
6822,140000,0,1,2,56,0,0,0,0,0,0,140630,142166,51334,51533,52233,53826,6100,2411,2000,2041,3000,1874,0,134530,139755,49334,49492,49233,51952,0.9609285714285715,0.99825,0.3523857142857143,0.3535142857142857,0.3516642857142857,0.3710857142857143,0
6823,30000,1,1,2,23,1,4,4,3,2,3,26185,29944,29399,28632,30363,29594,4518,206,0,2500,0,2000,0,21667,29738,29399,26132,30363,27594,0.7222333333333333,0.9912666666666666,0.9799666666666667,0.8710666666666667,1.0121,0.9198,17
6824,190000,1,1,2,33,0,0,0,0,0,0,153962,161376,162437,117364,100765,112095,10000,6000,30000,5000,13000,34000,0,143962,155376,132437,112364,87765,78095,0.7576947368421053,0.8177684210526316,0.6970368421052632,0.5913894736842106,0.46192105263157895,0.4110263157894737,0
6825,500000,0,1,1,34,-1,-1,-1,-1,-1,-1,1895,1086,740,0,1868,1883,1086,740,0,1868,1883,621,1,809,346,740,-1868,-15,1262,0.001618,0.000692,0.00148,-0.003736,-3e-05,0.002524,-6
6826,20000,1,3,2,26,1,2,0,0,0,0,18025,17443,18117,17040,17763,17666,0,1277,1300,1000,799,2000,0,18025,16166,16817,16040,16964,15666,0.90125,0.8083,0.84085,0.802,0.8482,0.7833,3
6827,70000,1,3,1,26,0,0,0,0,0,0,71147,72227,71078,50777,50841,50682,3800,3200,1950,2000,1828,2200,1,67347,69027,69128,48777,49013,48482,0.9621,0.9861,0.9875428571428572,0.6968142857142857,0.7001857142857143,0.6926,0
6828,50000,0,1,1,25,0,0,2,0,0,0,5472,5891,6595,8400,4041,4815,1500,1000,2000,1000,1000,2000,1,3972,4891,4595,7400,3041,2815,0.07944,0.09782,0.0919,0.148,0.06082,0.0563,2
6829,140000,0,1,2,30,-1,-1,-1,2,2,-1,1800,1885,4158,2021,-372,628,1885,4158,0,0,2000,0,0,-85,-2273,4158,2021,-2372,628,-0.0006071428571428571,-0.016235714285714287,0.0297,0.014435714285714286,-0.01694285714285714,0.004485714285714286,0
6830,80000,0,3,1,42,0,0,0,-2,-1,0,6959,3959,-41,-41,1759,4703,3000,0,0,1800,3000,3000,1,3959,3959,-41,-1841,-1241,1703,0.0494875,0.0494875,-0.0005125,-0.0230125,-0.0155125,0.0212875,-3
6831,30000,0,2,2,49,-1,-1,-1,-1,-1,-1,1659,1473,390,390,390,1320,1473,390,390,390,1320,0,0,186,1083,0,0,-930,1320,0.0062,0.0361,0.0,0.0,-0.031,0.044,-6
6832,50000,0,3,2,57,0,0,0,0,0,0,47917,48455,48120,28450,29046,29647,1988,1989,1018,1054,1084,1048,0,45929,46466,47102,27396,27962,28599,0.91858,0.92932,0.94204,0.54792,0.55924,0.57198,0
6833,140000,1,1,2,27,0,0,0,0,0,0,16437,18848,21209,25503,27918,37186,3000,3000,5000,3000,10000,4000,0,13437,15848,16209,22503,17918,33186,0.09597857142857143,0.1132,0.11577857142857143,0.1607357142857143,0.12798571428571429,0.23704285714285714,0
6834,200000,1,1,2,25,0,0,0,0,0,-1,1698,2751,3665,4665,6665,150,1086,1000,1000,2000,150,776,0,612,1751,2665,2665,6515,-626,0.00306,0.008755,0.013325,0.013325,0.032575,-0.00313,-1
6835,230000,1,2,1,32,-1,-1,-1,-1,-1,-1,1680,1535,1836,2274,0,21166,1535,1836,2283,0,21166,1000,1,145,-301,-447,2274,-21166,20166,0.0006304347826086957,-0.001308695652173913,-0.0019434782608695653,0.00988695652173913,-0.09202608695652174,0.08767826086956522,-6
6836,140000,1,3,2,23,0,0,0,0,0,0,100448,103990,104462,43810,44434,45251,5450,4200,1810,1765,2000,1665,0,94998,99790,102652,42045,42434,43586,0.6785571428571429,0.7127857142857142,0.7332285714285715,0.3003214285714286,0.3031,0.31132857142857145,0
6837,200000,1,2,1,36,-1,-1,-1,-1,-1,-1,390,1308,1662,14490,34902,390,1308,1662,14987,34902,390,7500,1,-918,-354,-13325,-20412,34512,-7110,-0.00459,-0.00177,-0.066625,-0.10206,0.17256,-0.03555,-6
6838,380000,0,1,1,34,0,0,0,0,0,0,124486,106065,97979,100599,81087,82793,3563,3385,4074,2592,2696,3569,1,120923,102680,93905,98007,78391,79224,0.3182184210526316,0.27021052631578946,0.24711842105263157,0.25791315789473684,0.2062921052631579,0.2084842105263158,0
6839,300000,1,4,1,54,1,-2,-2,-2,-2,-2,0,0,1702,0,0,0,0,1702,0,0,0,0,1,0,-1702,1702,0,0,0,0.0,-0.005673333333333333,0.005673333333333333,0.0,0.0,0.0,-9
6840,190000,0,1,2,37,0,0,0,0,0,0,98588,80559,81481,75853,68074,64941,4007,4051,5013,3000,3000,3500,0,94581,76508,76468,72853,65074,61441,0.4977947368421053,0.4026736842105263,0.40246315789473686,0.38343684210526313,0.34249473684210524,0.3233736842105263,0
6841,90000,1,2,2,24,-1,-1,-2,-2,-2,-2,520,0,0,0,0,0,0,0,0,0,0,0,0,520,0,0,0,0,0,0.0057777777777777775,0.0,0.0,0.0,0.0,0.0,-10
6842,20000,1,2,2,23,0,0,0,0,0,0,16575,17629,18552,15562,16308,17034,1327,1250,800,1000,1000,1000,0,15248,16379,17752,14562,15308,16034,0.7624,0.81895,0.8876,0.7281,0.7654,0.8017,0
6843,180000,1,2,1,44,-1,-1,-1,-1,-1,-1,816,803,2599,0,2311,2194,803,2800,0,2311,2542,236,1,13,-1997,2599,-2311,-231,1958,7.222222222222222e-05,-0.011094444444444445,0.014438888888888888,-0.01283888888888889,-0.0012833333333333334,0.010877777777777778,-6
6844,50000,0,2,3,30,0,0,0,0,0,0,97538,49187,17518,17710,18079,18302,2454,1588,780,803,673,637,0,95084,47599,16738,16907,17406,17665,1.90168,0.95198,0.33476,0.33814,0.34812,0.3533,0
6845,330000,1,2,1,27,1,-2,-2,-2,-2,-2,0,0,0,0,0,0,0,0,0,0,0,0,1,0,0,0,0,0,0,0.0,0.0,0.0,0.0,0.0,0.0,-9
6846,20000,0,2,1,40,-1,-1,-1,-1,-1,-1,836,836,390,390,390,390,836,390,390,390,390,30500,1,0,446,0,0,0,-30110,0.0,0.0223,0.0,0.0,0.0,-1.5055,-6
6847,210000,1,2,1,46,-1,2,-1,-1,-2,-2,594,594,21445,0,0,0,0,21451,0,0,0,0,1,594,-20857,21445,0,0,0,0.0028285714285714286,-0.09931904761904761,0.10211904761904762,0.0,0.0,0.0,-5
6848,350000,0,1,2,33,-1,-1,-1,-1,-1,-1,148341,8095,15047,3220,20461,3249,8405,15052,3805,20467,3253,27168,0,139936,-6957,11242,-17247,17208,-23919,0.39981714285714287,-0.019877142857142857,0.03212,-0.04927714285714286,0.049165714285714285,-0.06834,-6
6849,190000,0,1,2,32,0,0,2,0,0,0,5484,6192,4988,3440,3341,3228,2450,0,200,1000,1000,1000,0,3034,6192,4788,2440,2341,2228,0.01596842105263158,0.03258947368421053,0.0252,0.012842105263157894,0.012321052631578948,0.011726315789473684,2
6850,170000,1,2,2,39,0,0,0,0,0,0,161277,162706,166677,167049,38377,33668,5856,7424,7169,1241,1187,1396,0,155421,155282,159508,165808,37190,32272,0.9142411764705882,0.9134235294117647,0.9382823529411765,0.9753411764705883,0.21876470588235294,0.18983529411764705,0
6851,50000,0,2,2,52,0,0,-1,0,0,0,47595,28491,3642,12291,16674,17331,8080,15012,10000,8000,2000,2000,0,39515,13479,-6358,4291,14674,15331,0.7903,0.26958,-0.12716,0.08582,0.29348,0.30662,-1
6852,60000,1,2,2,31,0,0,0,2,2,2,36434,39925,43350,42057,26877,26493,4100,4073,0,1600,0,1100,0,32334,35852,43350,40457,26877,25393,0.5389,0.5975333333333334,0.7225,0.6742833333333333,0.44795,0.4232166666666667,6
6853,190000,0,1,1,54,0,0,0,0,0,0,205824,201269,197129,192803,161324,156576,7154,7385,7520,5593,6000,5516,1,198670,193884,189609,187210,155324,151060,1.0456315789473685,1.0204421052631578,0.9979421052631579,0.9853157894736843,0.8174947368421053,0.7950526315789473,0
6854,300000,1,1,2,30,-2,-2,-2,-2,-2,-2,0,0,0,0,0,0,0,0,0,0,0,0,0,0,0,0,0,0,0,0.0,0.0,0.0,0.0,0.0,0.0,-12
6855,50000,1,3,2,45,0,0,-2,-2,-2,-2,51400,0,0,0,0,0,0,0,0,0,0,0,0,51400,0,0,0,0,0,1.028,0.0,0.0,0.0,0.0,0.0,-8
6856,240000,1,1,1,33,-1,0,0,0,0,0,30973,32008,32889,33410,34327,34500,1537,1418,939,1193,690,0,1,29436,30590,31950,32217,33637,34500,0.12265,0.12745833333333334,0.133125,0.1342375,0.14015416666666666,0.14375,-1
6857,240000,1,1,2,36,-1,-1,-1,-1,-1,-1,330,3152,5400,3799,574,4899,3152,5416,3799,577,4899,1450,0,-2822,-2264,1601,3222,-4325,3449,-0.011758333333333334,-0.009433333333333334,0.006670833333333333,0.013425,-0.018020833333333333,0.014370833333333333,-6
6858,300000,0,1,2,32,-1,-1,-1,-1,-1,-1,2144,2085,2431,2198,14487,725,2085,2431,2198,14487,725,7818,0,59,-346,233,-12289,13762,-7093,0.00019666666666666666,-0.0011533333333333333,0.0007766666666666667,-0.04096333333333333,0.045873333333333335,-0.023643333333333332,-6
6859,150000,1,2,2,26,0,0,0,0,0,0,153070,149027,151632,151855,150713,148958,6000,6000,7000,5480,5400,5300,0,147070,143027,144632,146375,145313,143658,0.9804666666666667,0.9535133333333333,0.9642133333333334,0.9758333333333333,0.9687533333333334,0.95772,0
6860,200000,1,3,2,49,-1,-1,0,0,0,-1,7697,18951,27974,30596,38109,22170,20071,20036,15022,15113,22235,3919,0,-12374,-1085,12952,15483,15874,18251,-0.06187,-0.005425,0.06476,0.077415,0.07937,0.091255,-3
6861,60000,1,3,1,43,0,0,0,0,0,0,49340,49116,48220,39595,29899,28722,4570,5348,4035,8804,3000,3000,1,44770,43768,44185,30791,26899,25722,0.7461666666666666,0.7294666666666667,0.7364166666666667,0.5131833333333333,0.44831666666666664,0.4287,0
6862,40000,1,2,1,38,0,0,0,0,0,0,38491,36881,37968,36155,36933,37666,3000,2000,1500,1500,1500,2000,1,35491,34881,36468,34655,35433,35666,0.887275,0.872025,0.9117,0.866375,0.885825,0.89165,0
6863,420000,1,2,1,46,0,0,0,0,0,0,347531,345620,344364,202241,196082,189064,13503,15031,7011,7010,7013,7015,1,334028,330589,337353,195231,189069,182049,0.795304761904762,0.7871166666666667,0.8032214285714285,0.4648357142857143,0.45016428571428574,0.43345,0
6864,160000,1,2,2,44,0,0,0,0,0,0,118809,125323,170449,96739,126139,154884,10000,50000,20000,30000,30000,5000,0,108809,75323,150449,66739,96139,149884,0.68005625,0.47076875,0.94030625,0.41711875,0.60086875,0.936775,0
6865,180000,0,2,2,37,-1,-1,0,0,0,-1,8788,40927,28306,31578,21195,11776,40970,1210,10015,10009,11783,110306,0,-32182,39717,18291,21569,9412,-98530,-0.17878888888888889,0.22065,0.10161666666666666,0.11982777777777778,0.05228888888888889,-0.5473888888888889,-3
6866,180000,0,1,1,48,-1,-1,-1,-1,-1,0,325,1260,325,1000,1100,1100,1260,325,1000,1100,0,0,1,-935,935,-675,-100,1100,1100,-0.005194444444444444,0.005194444444444444,-0.00375,-0.0005555555555555556,0.006111111111111111,0.006111111111111111,-5
6867,210000,1,2,1,52,0,0,-1,0,-1,-1,5723,3386,8964,2241,2241,2241,1237,4482,0,2241,2241,2241,1,4486,-1096,8964,0,0,0,0.021361904761904763,-0.005219047619047619,0.042685714285714285,0.0,0.0,0.0,-3
6868,150000,1,1,1,37,-1,-1,-2,-1,-1,0,58337,0,0,14515,8758,6882,0,0,14515,8758,6880,8267,1,58337,0,-14515,5757,1878,-1385,0.38891333333333333,0.0,-0.09676666666666667,0.03838,0.01252,-0.009233333333333333,-6
6869,50000,0,2,2,30,2,2,2,2,2,2,21839,22771,23700,24016,23332,24849,1600,1600,1000,0,1896,0,0,20239,21171,22700,24016,21436,24849,0.40478,0.42342,0.454,0.48032,0.42872,0.49698,12
6870,340000,1,1,2,50,1,-2,-2,-2,-2,-2,2728,15650,11550,11058,6912,4125,15650,11554,11058,6917,4125,4850,0,-12922,4096,492,4141,2787,-725,-0.038005882352941174,0.012047058823529412,0.0014470588235294117,0.012179411764705883,0.008197058823529411,-0.0021323529411764706,-9
6871,140000,1,2,1,31,0,0,0,0,0,0,98250,100319,102231,95852,94005,93177,4600,4523,4300,3300,3400,3600,1,93650,95796,97931,92552,90605,89577,0.6689285714285714,0.6842571428571429,0.6995071428571429,0.6610857142857143,0.6471785714285714,0.6398357142857143,0
6872,20000,0,2,2,40,8,7,6,5,4,3,20753,20496,19930,19434,18577,18011,0,0,70,0,0,0,0,20753,20496,19860,19434,18577,18011,1.03765,1.0248,0.993,0.9717,0.92885,0.90055,33
6873,120000,0,2,1,47,-1,-1,-1,0,0,-1,2486,151,2853,2896,1149,1758,260,5753,1153,3,1759,4084,1,2226,-5602,1700,2893,-610,-2326,0.01855,-0.046683333333333334,0.014166666666666666,0.024108333333333332,-0.005083333333333333,-0.019383333333333332,-4
6874,30000,0,2,2,26,0,0,0,0,0,-2,25993,6296,17223,18305,0,0,1183,11500,2000,0,0,0,0,24810,-5204,15223,18305,0,0,0.827,-0.17346666666666666,0.5074333333333333,0.6101666666666666,0.0,0.0,-2
6875,320000,0,2,2,30,0,0,0,0,0,0,29668,30282,30737,26875,26318,25880,1353,1224,739,742,751,703,0,28315,29058,29998,26133,25567,25177,0.088484375,0.09080625,0.09374375,0.081665625,0.079896875,0.078678125,0
6876,100000,1,2,1,58,0,0,0,0,0,0,101249,101476,94893,101301,101451,99319,3642,4230,10000,3582,5000,4133,1,97607,97246,84893,97719,96451,95186,0.97607,0.97246,0.84893,0.97719,0.96451,0.95186,0
6877,420000,1,1,2,29,0,0,0,0,0,0,105582,97913,75353,78322,77048,23007,23004,20002,7096,20261,3068,10009,0,82578,77911,68257,58061,73980,12998,0.1966142857142857,0.18550238095238095,0.16251666666666667,0.1382404761904762,0.17614285714285716,0.030947619047619047,0
6878,280000,1,3,1,37,-1,-1,2,-1,-1,-1,4591,38854,15287,14201,26133,4504,38979,16,14201,26133,4504,10748,1,-34388,38838,1086,-11932,21629,-6244,-0.12281428571428571,0.13870714285714286,0.0038785714285714287,-0.042614285714285716,0.07724642857142858,-0.0223,-3
6879,150000,1,1,2,28,-1,-1,-2,-2,-2,-2,3470,0,0,0,0,0,0,0,0,0,0,0,0,3470,0,0,0,0,0,0.023133333333333332,0.0,0.0,0.0,0.0,0.0,-10
6880,430000,1,2,1,42,0,0,0,0,0,0,89756,89395,90052,90604,91200,92134,3169,3243,3200,3185,3500,3500,1,86587,86152,86852,87419,87700,88634,0.20136511627906978,0.20035348837209302,0.20198139534883722,0.2033,0.203953488372093,0.20612558139534884,0
6881,140000,0,1,2,44,0,0,0,0,2,0,72763,75064,76892,79522,79623,80895,3905,4025,4924,2381,2926,3108,0,68858,71039,71968,77141,76697,77787,0.49184285714285714,0.5074214285714286,0.5140571428571429,0.5510071428571428,0.5478357142857143,0.5556214285714286,2
6882,150000,0,2,2,22,-1,0,0,0,0,0,82791,82533,77002,45340,36352,36499,3187,2381,1579,1265,1584,597,0,79604,80152,75423,44075,34768,35902,0.5306933333333334,0.5343466666666666,0.50282,0.29383333333333334,0.23178666666666667,0.23934666666666668,-1
6883,140000,0,3,1,37,2,2,2,2,2,2,136184,138932,140185,136438,144979,139314,6400,5000,0,10800,0,5300,1,129784,133932,140185,125638,144979,134014,0.9270285714285714,0.9566571428571429,1.0013214285714285,0.8974142857142857,1.0355642857142857,0.9572428571428572,12
6884,80000,0,2,2,30,0,0,0,-2,-2,-2,79813,82150,0,0,0,0,3750,0,0,0,0,0,0,76063,82150,0,0,0,0,0.9507875,1.026875,0.0,0.0,0.0,0.0,-6
6885,350000,0,1,1,30,-2,-2,-2,-2,-2,-2,51672,31250,29178,29180,52550,43538,13113,12110,15044,32244,40218,112406,1,38559,19140,14134,-3064,12332,-68868,0.11016857142857144,0.05468571428571429,0.040382857142857144,-0.008754285714285714,0.03523428571428571,-0.1967657142857143,-12
6886,260000,1,1,1,42,-1,-1,-1,-1,-1,-1,2788,4046,2800,2800,2979,8247,4058,2800,2800,2979,8247,0,1,-1270,1246,0,-179,-5268,8247,-0.004884615384615385,0.004792307692307692,0.0,-0.0006884615384615385,-0.020261538461538463,0.03171923076923077,-6
6887,160000,0,1,2,30,-1,-1,-1,-1,-1,-1,4180,7781,1256,14160,6180,2000,7781,1276,14160,6180,2000,290,0,-3601,6505,-12904,7980,4180,1710,-0.02250625,0.04065625,-0.08065,0.049875,0.026125,0.0106875,-6
6888,180000,0,1,2,29,0,0,0,0,0,0,85069,85434,116352,55698,37315,16696,5344,3013,3034,4069,3018,3069,0,79725,82421,113318,51629,34297,13627,0.4429166666666667,0.45789444444444444,0.6295444444444445,0.2868277777777778,0.1905388888888889,0.07570555555555555,0
6889,120000,1,1,1,60,-2,-2,-2,-2,-2,-2,3956,0,2216,2550,9246,8307,0,2216,2557,9246,8307,10000,1,3956,-2216,-341,-6696,939,-1693,0.032966666666666665,-0.018466666666666666,-0.002841666666666667,-0.0558,0.007825,-0.014108333333333334,-12
6890,50000,0,2,2,25,0,0,0,2,0,0,17826,18620,19722,19305,19409,20221,1400,2200,806,1000,2000,1000,0,16426,16420,18916,18305,17409,19221,0.32852,0.3284,0.37832,0.3661,0.34818,0.38442,2
6891,360000,1,4,1,39,-1,-1,-1,-1,0,-1,3102,552,31029,7731,1154,799,552,31051,7731,0,799,3238,1,2550,-30499,23298,7731,355,-2439,0.007083333333333333,-0.08471944444444444,0.06471666666666667,0.021475,0.0009861111111111112,-0.006775,-5
6892,130000,1,2,1,41,0,0,0,0,0,0,8920,9538,10174,11036,10552,9934,1161,1187,1439,345,346,487,1,7759,8351,8735,10691,10206,9447,0.059684615384615385,0.06423846153846154,0.06719230769230769,0.08223846153846154,0.0785076923076923,0.07266923076923076,0
6893,130000,0,3,1,48,0,0,2,-1,-1,-1,11926,18095,5552,3038,11094,8670,10840,3,3041,11202,8671,6485,1,1086,18092,2511,-8164,2423,2185,0.008353846153846154,0.13916923076923077,0.019315384615384616,-0.0628,0.018638461538461538,0.016807692307692308,-1
6894,210000,1,1,1,36,1,-1,-1,-1,-1,-1,0,1690,0,5619,4090,581,1690,0,5619,4090,581,0,1,-1690,1690,-5619,1529,3509,581,-0.008047619047619048,0.008047619047619048,-0.026757142857142858,0.007280952380952381,0.01670952380952381,0.002766666666666667,-4
6895,230000,1,1,1,24,-1,-1,-1,0,0,-1,35000,35000,44884,10086,6905,237,35000,44884,202,405,237,3566,1,0,-9884,44682,9681,6668,-3329,0.0,-0.04297391304347826,0.1942695652173913,0.04209130434782609,0.028991304347826086,-0.01447391304347826,-4
6896,160000,1,1,2,26,0,0,0,0,0,0,118204,121695,125724,129157,130567,144266,6000,5030,6000,4000,15000,5000,0,112204,116665,119724,125157,115567,139266,0.701275,0.72915625,0.748275,0.78223125,0.72229375,0.8704125,0
6897,380000,0,2,1,43,0,-1,-1,0,0,0,112118,96297,243301,259176,47494,129274,96778,243301,21066,2137,110000,50110,1,15340,-147004,222235,257039,-62506,79164,0.04036842105263158,-0.3868526315789474,0.5848289473684211,0.6764184210526316,-0.16448947368421052,0.2083263157894737,-2
6898,220000,1,4,1,35,-2,-2,-2,-2,-2,-2,0,319,10567,319,319,319,319,10567,319,319,319,2420,1,-319,-10248,10248,0,0,-2101,-0.00145,-0.04658181818181818,0.04658181818181818,0.0,0.0,-0.00955,-12
6899,230000,0,1,1,47,0,0,0,0,0,0,143083,130011,83545,82638,26332,25425,6500,4579,4500,3000,1000,3000,1,136583,125432,79045,79638,25332,22425,0.5938391304347826,0.5453565217391304,0.3436739130434783,0.34625217391304347,0.11013913043478261,0.0975,0
6900,50000,0,2,2,26,0,0,0,0,0,2,42695,43679,44757,45703,48476,47603,2000,1781,1727,3500,0,3600,0,40695,41898,43030,42203,48476,44003,0.8139,0.83796,0.8606,0.84406,0.96952,0.88006,2
6901,80000,0,3,1,55,0,0,0,0,0,0,82567,84221,80041,19000,15178,14717,3121,8443,1582,548,531,479,1,79446,75778,78459,18452,14647,14238,0.993075,0.947225,0.9807375,0.23065,0.1830875,0.177975,0
6902,50000,0,2,1,25,1,-1,0,0,0,0,-8,37230,10496,3614,2254,1494,18631,1000,0,0,0,0,1,-18639,36230,10496,3614,2254,1494,-0.37278,0.7246,0.20992,0.07228,0.04508,0.02988,0
6903,260000,1,1,1,41,1,-1,-1,-1,-1,-1,0,5848,0,8839,62140,6647,5848,0,8839,62140,6647,7573,1,-5848,5848,-8839,-53301,55493,-926,-0.022492307692307693,0.022492307692307693,-0.03399615384615385,-0.20500384615384615,0.2134346153846154,-0.0035615384615384615,-4
6904,360000,1,2,1,33,0,0,0,0,0,0,325839,300726,252603,253759,255424,253826,11083,8948,8727,9118,9026,8997,1,314756,291778,243876,244641,246398,244829,0.8743222222222222,0.8104944444444444,0.6774333333333333,0.6795583333333334,0.6844388888888889,0.6800805555555556,0
6905,20000,1,2,2,23,-1,-1,-1,-1,-1,-1,390,390,390,390,390,390,390,390,390,390,390,390,0,0,0,0,0,0,0,0.0,0.0,0.0,0.0,0.0,0.0,-6
6906,150000,1,2,1,36,2,2,2,2,2,2,100247,109909,112453,113318,114268,116688,12924,5800,4200,4300,4400,4700,1,87323,104109,108253,109018,109868,111988,0.5821533333333333,0.69406,0.7216866666666667,0.7267866666666667,0.7324533333333333,0.7465866666666666,12
6907,160000,1,2,1,27,0,0,0,0,0,0,31666,31865,32691,31490,28324,30798,3000,3000,3000,3000,3000,3000,1,28666,28865,29691,28490,25324,27798,0.1791625,0.18040625,0.18556875,0.1780625,0.158275,0.1737375,0
6908,80000,1,1,1,45,0,0,0,0,0,0,81133,81466,80822,79207,79652,81165,3502,3000,4000,3100,3000,3000,1,77631,78466,76822,76107,76652,78165,0.9703875,0.980825,0.960275,0.9513375,0.95815,0.9770625,0
6909,260000,1,1,2,29,0,0,0,0,0,0,203896,196219,188608,172722,159826,146891,7282,6486,5712,5647,5386,5000,0,196614,189733,182896,167075,154440,141891,0.7562076923076924,0.7297423076923077,0.7034461538461538,0.6425961538461539,0.594,0.5457346153846154,0
6910,300000,1,1,1,34,2,0,0,2,0,0,74917,70878,68463,52987,46867,16335,3028,4560,78,3171,5015,5047,1,71889,66318,68385,49816,41852,11288,0.23963,0.22106,0.22795,0.16605333333333333,0.13950666666666667,0.03762666666666667,4
6911,50000,1,3,2,23,-1,-1,-1,-1,0,0,3237,5365,8263,14054,22071,20506,5389,8276,14075,15022,3012,3018,0,-2152,-2911,-5812,-968,19059,17488,-0.04304,-0.05822,-0.11624,-0.01936,0.38118,0.34976,-4
6912,200000,1,1,2,30,-1,-1,-1,-1,0,0,200,200,200,959,759,1317,200,200,959,0,931,0,0,0,0,-759,959,-172,1317,0.0,0.0,-0.003795,0.004795,-0.00086,0.006585,-4
6913,320000,0,1,1,41,0,0,0,0,0,0,321281,324449,254293,206521,202697,203332,27000,17000,7030,7000,10000,30000,1,294281,307449,247263,199521,192697,173332,0.919628125,0.960778125,0.772696875,0.623503125,0.602178125,0.5416625,0
6914,50000,1,1,2,22,0,0,0,0,0,0,49077,47610,46490,21056,20425,20632,2610,2609,715,930,2000,770,0,46467,45001,45775,20126,18425,19862,0.92934,0.90002,0.9155,0.40252,0.3685,0.39724,0
6915,160000,1,2,1,27,-1,0,0,0,0,0,86772,71275,54769,39137,26971,3426,2805,1487,958,539,1000,390,1,83967,69788,53811,38598,25971,3036,0.52479375,0.436175,0.33631875,0.2412375,0.16231875,0.018975,-1
6916,120000,0,2,2,28,0,0,0,0,0,0,92677,92809,93392,93609,95055,96761,4516,5005,5006,5014,5008,4008,0,88161,87804,88386,88595,90047,92753,0.734675,0.7317,0.73655,0.7382916666666667,0.7503916666666667,0.7729416666666666,0
6917,210000,1,1,2,28,1,-2,-2,-2,-2,-2,0,0,0,0,0,0,0,0,0,0,0,0,0,0,0,0,0,0,0,0.0,0.0,0.0,0.0,0.0,0.0,-9
6918,160000,1,2,2,28,0,0,0,0,0,0,84668,88294,91784,108310,103166,104677,5000,5000,20000,5000,5400,6100,0,79668,83294,71784,103310,97766,98577,0.497925,0.5205875,0.44865,0.6456875,0.6110375,0.61610625,0
6919,210000,0,2,2,41,0,0,0,2,0,0,114953,88428,96993,94537,97968,100387,5000,10000,0,5000,4000,5000,0,109953,78428,96993,89537,93968,95387,0.5235857142857143,0.37346666666666667,0.46187142857142854,0.42636666666666667,0.4474666666666667,0.45422380952380953,2
6920,150000,0,2,1,41,0,0,0,0,0,0,19350,20703,10403,10927,11598,13235,2000,3000,1000,1000,2000,2000,1,17350,17703,9403,9927,9598,11235,0.11566666666666667,0.11802,0.06268666666666667,0.06618,0.06398666666666666,0.0749,0
6921,130000,0,3,1,54,3,3,2,0,0,0,131139,132596,127906,86109,81941,84545,6000,0,3029,4000,5000,3300,1,125139,132596,124877,82109,76941,81245,0.9626076923076923,1.0199692307692307,0.9605923076923077,0.6316076923076923,0.5918538461538462,0.6249615384615385,8
6922,340000,0,2,2,44,0,0,0,0,0,0,327058,335584,330510,272220,269629,266723,16004,312723,9748,9800,9569,12500,0,311054,22861,320762,262420,260060,254223,0.9148647058823529,0.06723823529411764,0.9434176470588236,0.7718235294117647,0.7648823529411765,0.7477147058823529,0
6923,250000,1,1,1,42,0,0,-2,-2,-2,-2,25298,0,0,0,0,0,0,0,0,0,0,0,1,25298,0,0,0,0,0,0.101192,0.0,0.0,0.0,0.0,0.0,-8
6924,20000,1,3,1,50,0,0,2,0,0,0,8612,8862,8992,9452,10520,11320,2202,500,1000,2000,800,0,1,6410,8362,7992,7452,9720,11320,0.3205,0.4181,0.3996,0.3726,0.486,0.566,2
6925,30000,0,2,2,26,0,0,0,0,0,0,24079,25848,22299,23615,23933,24901,2500,2000,2000,1000,1500,1500,0,21579,23848,20299,22615,22433,23401,0.7193,0.7949333333333334,0.6766333333333333,0.7538333333333334,0.7477666666666667,0.7800333333333334,0
6926,200000,0,1,1,42,-1,-1,-1,-1,-1,0,3664,718,2946,390,390,390,718,2946,390,390,0,1313,1,2946,-2228,2556,0,390,-923,0.01473,-0.01114,0.01278,0.0,0.00195,-0.004615,-5
6927,210000,1,2,1,49,2,0,0,0,0,0,114273,115302,111906,111423,92394,93321,6000,6000,5000,3000,3500,3000,1,108273,109302,106906,108423,88894,90321,0.5155857142857143,0.5204857142857143,0.5090761904761905,0.5163,0.4233047619047619,0.4301,2
6928,280000,1,1,1,37,1,-2,-2,-1,-1,-1,449,12487,-10,3090,240,2010,12611,0,3100,240,2010,212,1,-12162,12487,-3110,2850,-1770,1798,-0.043435714285714286,0.04459642857142857,-0.011107142857142857,0.01017857142857143,-0.006321428571428572,0.006421428571428572,-6
6929,70000,1,1,2,28,0,0,0,0,0,0,44397,44923,46189,39327,38618,38404,3000,3000,3000,2000,2000,1800,0,41397,41923,43189,37327,36618,36604,0.5913857142857143,0.5989,0.6169857142857142,0.5332428571428571,0.5231142857142858,0.5229142857142857,0
6930,280000,0,2,1,48,0,0,0,0,-2,-2,74267,54500,5520,0,0,0,3110,1200,0,0,0,0,1,71157,53300,5520,0,0,0,0.25413214285714286,0.19035714285714286,0.019714285714285715,0.0,0.0,0.0,-4
6931,200000,1,1,1,31,-1,-1,-1,0,0,-1,11715,5209,10634,10982,1966,4883,5289,10641,2011,9,4890,15,1,6426,-5432,8623,10973,-2924,4868,0.03213,-0.02716,0.043115,0.054865,-0.01462,0.02434,-4
6932,110000,0,3,1,45,0,0,0,0,0,0,66820,36002,37484,38935,40633,41393,4400,3900,3900,4000,3100,1600,1,62420,32102,33584,34935,37533,39793,0.5674545454545454,0.2918363636363636,0.3053090909090909,0.3175909090909091,0.3412090909090909,0.36175454545454544,0
6933,70000,0,2,1,45,0,0,0,0,0,0,43050,43410,36226,29369,25873,26101,1888,1225,856,6000,1097,604,1,41162,42185,35370,23369,24776,25497,0.5880285714285715,0.6026428571428571,0.5052857142857143,0.33384285714285716,0.35394285714285717,0.36424285714285715,0
6934,180000,1,2,1,33,0,0,0,0,0,0,165839,153828,158050,149023,135798,112666,20064,30032,20027,40000,10000,0,1,145775,123796,138023,109023,125798,112666,0.8098611111111111,0.6877555555555556,0.7667944444444444,0.6056833333333334,0.6988777777777778,0.6259222222222223,0
6935,170000,1,3,1,41,-1,-1,-1,-1,-1,-1,1000,0,978,1009,1101,0,0,978,1009,1101,0,912,1,1000,-978,-31,-92,1101,-912,0.0058823529411764705,-0.005752941176470588,-0.0001823529411764706,-0.0005411764705882352,0.0064764705882352945,-0.005364705882352942,-6
6936,10000,0,2,3,37,0,0,-1,0,0,-2,8634,3192,1352,13352,0,0,1000,676,6000,120,0,0,0,7634,2516,-4648,13232,0,0,0.7634,0.2516,-0.4648,1.3232,0.0,0.0,-3
6937,80000,0,1,2,28,0,0,0,2,0,0,47933,39695,42372,41393,42275,43418,2100,3650,0,1700,2000,3000,0,45833,36045,42372,39693,40275,40418,0.5729125,0.4505625,0.52965,0.4961625,0.5034375,0.505225,2
6938,100000,1,2,2,25,0,0,0,0,0,0,59219,60464,61956,63228,64561,66025,2197,2500,2300,2350,2540,4920,0,57022,57964,59656,60878,62021,61105,0.57022,0.57964,0.59656,0.60878,0.62021,0.61105,0
6939,150000,1,1,1,49,-1,-1,-2,-1,-1,-1,850,0,0,31106,0,1505,0,0,31106,0,1505,997,1,850,0,-31106,31106,-1505,508,0.005666666666666667,0.0,-0.20737333333333333,0.20737333333333333,-0.010033333333333333,0.0033866666666666667,-7
6940,170000,1,2,2,23,-1,0,0,0,0,0,32192,32555,32292,32372,31202,31688,1608,2301,2379,2202,2688,2110,0,30584,30254,29913,30170,28514,29578,0.17990588235294117,0.17796470588235294,0.17595882352941175,0.17747058823529413,0.16772941176470588,0.17398823529411764,-1
6941,50000,0,2,1,44,2,2,0,0,3,2,127510,123969,128267,139912,136604,134705,0,6300,15300,0,0,9500,1,127510,117669,112967,139912,136604,125205,2.5502,2.35338,2.25934,2.79824,2.73208,2.5041,9
6942,30000,1,2,2,50,0,0,2,0,0,0,27284,29001,28201,28763,29383,28987,4664,0,994,1047,1412,756,0,22620,29001,27207,27716,27971,28231,0.754,0.9667,0.9069,0.9238666666666666,0.9323666666666667,0.9410333333333334,2
6943,50000,0,1,2,30,0,0,0,0,2,2,29994,30756,23618,26009,24731,46882,2000,1300,3000,0,25000,0,0,27994,29456,20618,26009,-269,46882,0.55988,0.58912,0.41236,0.52018,-0.00538,0.93764,4
6944,20000,0,2,2,37,-1,-1,0,0,0,0,830,17597,17840,16342,16428,18167,17597,1332,1134,1000,2000,0,0,-16767,16265,16706,15342,14428,18167,-0.83835,0.81325,0.8353,0.7671,0.7214,0.90835,-2
6945,240000,0,1,2,32,0,0,0,0,0,0,240790,224497,213580,191771,166239,146584,6892,7866,5602,6118,6023,27064,0,233898,216631,207978,185653,160216,119520,0.974575,0.9026291666666667,0.866575,0.7735541666666667,0.6675666666666666,0.498,0
6946,180000,1,1,2,26,0,0,0,0,0,0,51699,48469,49553,49772,50829,51234,2200,2200,2000,2000,2100,1600,0,49499,46269,47553,47772,48729,49634,0.27499444444444443,0.25705,0.2641833333333333,0.2654,0.27071666666666666,0.27574444444444446,0
6947,50000,1,3,1,50,0,0,0,-2,-2,-2,43140,43496,0,0,0,0,2500,0,0,0,0,0,1,40640,43496,0,0,0,0,0.8128,0.86992,0.0,0.0,0.0,0.0,-6
6948,500000,1,1,2,30,0,0,0,0,0,0,137243,129722,128006,125294,92276,96112,5000,5116,5000,5000,5000,5000,0,132243,124606,123006,120294,87276,91112,0.264486,0.249212,0.246012,0.240588,0.174552,0.182224,0
6949,160000,0,1,1,46,-2,-2,-2,-2,-2,-2,0,0,0,0,0,0,0,0,0,0,0,0,1,0,0,0,0,0,0,0.0,0.0,0.0,0.0,0.0,0.0,-12
6950,140000,1,2,2,27,1,2,2,-1,0,0,28332,27464,-1116,90558,92530,83880,0,28,92000,3800,3600,2604,0,28332,27436,-93116,86758,88930,81276,0.20237142857142856,0.19597142857142857,-0.6651142857142858,0.6197,0.6352142857142857,0.5805428571428571,4
6951,10000,1,3,2,22,1,2,0,0,2,0,8846,8560,9706,10406,10109,10057,0,1300,1000,0,1000,1000,0,8846,7260,8706,10406,9109,9057,0.8846,0.726,0.8706,1.0406,0.9109,0.9057,5
6952,450000,1,1,2,35,1,2,2,0,0,0,131351,132453,128901,132982,141298,137347,4723,0,6270,12000,16309,5000,0,126628,132453,122631,120982,124989,132347,0.28139555555555557,0.29434,0.27251333333333333,0.2688488888888889,0.27775333333333335,0.29410444444444445,5
6953,230000,1,2,2,28,0,0,0,0,0,0,33057,33698,36652,38421,37459,54778,1500,4767,3000,3092,17411,5000,0,31557,28931,33652,35329,20048,49778,0.13720434782608695,0.12578695652173913,0.14631304347826088,0.15360434782608695,0.08716521739130435,0.21642608695652174,0
6954,140000,1,2,1,46,0,0,0,0,0,0,82497,83206,85862,86676,88948,54312,2978,3997,3140,3707,2104,1946,1,79519,79209,82722,82969,86844,52366,0.5679928571428572,0.5657785714285715,0.5908714285714286,0.5926357142857143,0.6203142857142857,0.3740428571428571,0
6955,120000,1,1,2,27,-1,-1,-1,-1,-1,-1,1026,1026,1026,1026,1026,1026,1026,1026,1026,1026,1026,1026,0,0,0,0,0,0,0,0.0,0.0,0.0,0.0,0.0,0.0,-6
6956,500000,1,1,1,39,-2,-2,-2,-2,-2,-2,3220,0,15040,35498,19508,21199,0,15040,35498,19508,21199,10894,1,3220,-15040,-20458,15990,-1691,10305,0.00644,-0.03008,-0.040916,0.03198,-0.003382,0.02061,-12
6957,120000,1,1,2,23,0,0,0,0,0,0,117035,115624,117204,116835,77926,76993,6000,6000,4000,4000,3000,3500,0,111035,109624,113204,112835,74926,73493,0.9252916666666666,0.9135333333333333,0.9433666666666667,0.9402916666666666,0.6243833333333333,0.6124416666666667,0
6958,390000,1,1,1,28,0,0,0,0,0,0,60697,64440,67503,68566,65411,66597,5000,5000,5007,5000,5000,5000,1,55697,59440,62496,63566,60411,61597,0.14281282051282052,0.1524102564102564,0.16024615384615384,0.16298974358974358,0.1549,0.15794102564102563,0
6959,50000,0,1,2,34,1,2,2,2,2,2,22746,22099,24121,23437,25101,24549,0,2700,0,2200,0,1030,0,22746,19399,24121,21237,25101,23519,0.45492,0.38798,0.48242,0.42474,0.50202,0.47038,11
6960,60000,1,1,2,26,1,2,0,0,0,0,29649,21657,28736,42733,46404,37993,0,8000,15000,9000,10000,0,0,29649,13657,13736,33733,36404,37993,0.49415,0.22761666666666666,0.22893333333333332,0.5622166666666667,0.6067333333333333,0.6332166666666666,3
6961,290000,1,1,1,35,1,-2,-2,-2,-2,-2,0,0,0,0,0,0,0,0,0,0,0,0,1,0,0,0,0,0,0,0.0,0.0,0.0,0.0,0.0,0.0,-9
6962,210000,1,1,1,40,1,2,2,2,0,0,66635,56729,73783,58144,27617,14695,0,20012,24,33,0,223,1,66635,36717,73759,58111,27617,14472,0.3173095238095238,0.17484285714285713,0.35123333333333334,0.27671904761904764,0.1315095238095238,0.06891428571428572,7
6963,360000,1,1,2,36,-1,-1,-1,-1,0,0,4279,9398,26510,50810,20800,0,9398,26510,51109,2080,0,10080,0,-5119,-17112,-24599,48730,20800,-10080,-0.014219444444444444,-0.04753333333333333,-0.06833055555555556,0.1353611111111111,0.057777777777777775,-0.028,-4
6964,50000,0,2,2,37,0,0,0,0,0,0,16029,17039,18064,19076,19453,19862,1281,1306,1318,695,721,1018,0,14748,15733,16746,18381,18732,18844,0.29496,0.31466,0.33492,0.36762,0.37464,0.37688,0
6965,230000,0,1,2,32,-2,-2,-2,-2,-2,-2,489,0,1257,0,1169,641,0,1257,0,1169,641,0,0,489,-1257,1257,-1169,528,641,0.002126086956521739,-0.005465217391304348,0.005465217391304348,-0.005082608695652174,0.0022956521739130433,0.0027869565217391304,-12
6966,60000,1,1,2,26,-1,-1,-1,-1,-1,-1,959,0,849,1120,327,531,0,849,1120,327,531,188,0,959,-849,-271,793,-204,343,0.015983333333333332,-0.01415,-0.004516666666666667,0.013216666666666666,-0.0034,0.005716666666666667,-6
6967,350000,1,1,2,32,-2,-1,-1,-1,0,0,24522,18876,5571,10978,9326,13255,18970,5594,11024,9317,13321,4019,0,5552,13282,-5453,1661,-3995,9236,0.015862857142857144,0.03794857142857143,-0.01558,0.004745714285714285,-0.011414285714285714,0.026388571428571428,-5
6968,20000,1,2,1,22,0,0,0,0,0,0,16366,17385,18142,17245,17657,18370,1600,1600,1600,1000,1000,1000,1,14766,15785,16542,16245,16657,17370,0.7383,0.78925,0.8271,0.81225,0.83285,0.8685,0
6969,80000,0,3,2,27,1,-2,-2,-2,-2,-2,0,0,0,0,0,0,0,0,0,0,0,0,0,0,0,0,0,0,0,0.0,0.0,0.0,0.0,0.0,0.0,-9
6970,150000,0,1,2,26,-2,-1,0,0,-1,-1,600,360,1401,2360,70,420,360,1041,1000,70,660,0,0,240,-681,401,2290,-590,420,0.0016,-0.00454,0.002673333333333333,0.015266666666666666,-0.003933333333333333,0.0028,-5
6971,100000,1,2,1,36,0,0,0,0,0,0,25945,21237,16723,15868,8275,5954,4021,3013,4031,3012,2006,3121,1,21924,18224,12692,12856,6269,2833,0.21924,0.18224,0.12692,0.12856,0.06269,0.02833,0
6972,130000,1,2,1,28,0,0,0,-1,-1,-1,71983,71514,73274,3541,3333,3333,4000,7000,3600,3333,3333,3110,1,67983,64514,69674,208,0,223,0.5229461538461538,0.4962615384615385,0.5359538461538461,0.0016,0.0,0.0017153846153846154,-3
6973,50000,0,2,2,28,-2,-2,-2,-2,-2,-2,49703,50237,26924,27458,28036,28772,1761,1448,982,1020,1200,1155,0,47942,48789,25942,26438,26836,27617,0.95884,0.97578,0.51884,0.52876,0.53672,0.55234,-12
6974,200000,1,1,1,38,-2,-2,-2,-2,-2,-2,-3,687,2740,2044,1614,2066,690,2753,2054,1622,2076,578,1,-693,-2066,686,422,-462,1488,-0.003465,-0.01033,0.00343,0.00211,-0.00231,0.00744,-12
6975,250000,0,1,1,40,0,0,0,0,0,0,7351,6225,3645,3090,3700,1190,3039,2000,1000,1000,0,90403,1,4312,4225,2645,2090,3700,-89213,0.017248,0.0169,0.01058,0.00836,0.0148,-0.356852,0
6976,150000,1,2,2,36,-1,-1,-2,-1,-1,-1,1374,-4,-4,6340,4998,5710,0,0,6344,4998,5712,5000,0,1374,-4,-6348,1342,-714,710,0.00916,-2.6666666666666667e-05,-0.04232,0.008946666666666667,-0.00476,0.004733333333333333,-7
6977,200000,1,1,2,39,-2,-2,-2,-2,-1,-1,0,0,0,0,2330,0,0,0,0,2330,0,0,0,0,0,0,-2330,2330,0,0.0,0.0,0.0,-0.01165,0.01165,0.0,-10
6978,50000,1,1,2,22,1,2,0,0,0,0,4112,3900,7737,3406,1470,1500,0,4019,2500,0,30,0,0,4112,-119,5237,3406,1440,1500,0.08224,-0.00238,0.10474,0.06812,0.0288,0.03,3
6979,50000,1,1,1,34,-1,-1,-1,-1,-1,-1,2531,14504,22553,14900,6758,3727,14608,22730,14911,6758,3727,2440,1,-12077,-8226,7642,8142,3031,1287,-0.24154,-0.16452,0.15284,0.16284,0.06062,0.02574,-6
6980,100000,1,1,2,26,0,0,0,0,0,2,2405,3420,4286,5302,6829,6574,1214,1080,1096,1623,0,394,0,1191,2340,3190,3679,6829,6180,0.01191,0.0234,0.0319,0.03679,0.06829,0.0618,2
6981,380000,1,2,2,30,0,0,0,0,0,0,305489,299641,256345,258936,228387,203931,11687,12160,12434,8651,8531,6974,0,293802,287481,243911,250285,219856,196957,0.7731631578947369,0.756528947368421,0.641871052631579,0.6586447368421052,0.5785684210526316,0.5183078947368421,0
6982,20000,1,2,3,47,1,2,2,0,0,0,17624,18342,17750,18102,18485,19175,1300,0,647,674,1000,582,0,16324,18342,17103,17428,17485,18593,0.8162,0.9171,0.85515,0.8714,0.87425,0.92965,5
6983,180000,1,2,2,34,1,2,0,0,0,0,180373,176063,175324,177197,181041,180044,0,7632,6083,6671,7515,6413,0,180373,168431,169241,170526,173526,173631,1.0020722222222223,0.9357277777777778,0.9402277777777778,0.9473666666666667,0.9640333333333333,0.9646166666666667,3
6984,230000,1,2,1,35,0,0,0,0,0,0,160560,158782,150844,151623,148261,153161,10012,10010,10000,7000,10000,10000,1,150548,148772,140844,144623,138261,143161,0.6545565217391305,0.6468347826086956,0.6123652173913043,0.6287956521739131,0.6011347826086957,0.6224391304347826,0
6985,260000,1,2,1,35,0,0,0,0,2,0,70098,70972,77604,82681,81244,83268,2598,7835,6386,0,3795,4000,1,67500,63137,71218,82681,77449,79268,0.25961538461538464,0.24283461538461537,0.2739153846153846,0.31800384615384614,0.2978807692307692,0.3048769230769231,2
6986,50000,1,1,1,29,0,0,0,0,0,0,50737,50486,50035,49388,10275,9598,1818,2200,1192,1000,2000,1000,1,48919,48286,48843,48388,8275,8598,0.97838,0.96572,0.97686,0.96776,0.1655,0.17196,0
6987,60000,1,1,2,26,0,0,0,0,0,0,41525,33907,27517,27506,28115,28815,1815,1760,1100,1052,1200,1100,0,39710,32147,26417,26454,26915,27715,0.6618333333333334,0.5357833333333333,0.44028333333333336,0.4409,0.44858333333333333,0.46191666666666664,0
6988,240000,0,1,2,47,2,2,-2,-2,-2,-2,2500,0,0,0,0,0,0,0,0,0,0,0,0,2500,0,0,0,0,0,0.010416666666666666,0.0,0.0,0.0,0.0,0.0,-4
6989,20000,0,3,1,62,2,3,2,2,2,2,17072,16505,17242,16668,17972,18316,0,1300,0,1586,780,800,1,17072,15205,17242,15082,17192,17516,0.8536,0.76025,0.8621,0.7541,0.8596,0.8758,13
6990,240000,1,2,1,37,0,0,0,0,-1,0,51277,51999,52613,21696,22807,22877,10006,10000,10000,22807,10000,11109,1,41271,41999,42613,-1111,12807,11768,0.1719625,0.17499583333333332,0.17755416666666668,-0.004629166666666667,0.0533625,0.04903333333333333,-1
6991,260000,1,2,2,38,-2,-2,-2,-2,-2,-2,-2,-2,725,2074,0,585,0,727,2074,0,585,0,0,-2,-729,-1349,2074,-585,585,-7.692307692307692e-06,-0.0028038461538461537,-0.0051884615384615385,0.007976923076923078,-0.00225,0.00225,-12
6992,470000,1,1,1,37,-1,0,0,0,0,0,12572,5363,5660,42003,39994,41816,5305,3500,38007,3000,3507,2500,1,7267,1863,-32347,39003,36487,39316,0.015461702127659575,0.003963829787234042,-0.06882340425531915,0.08298510638297872,0.07763191489361702,0.08365106382978724,-1
6993,20000,0,2,1,42,0,0,0,0,2,2,14310,15665,16706,18214,18626,18196,1600,1600,2100,1000,0,1500,1,12710,14065,14606,17214,18626,16696,0.6355,0.70325,0.7303,0.8607,0.9313,0.8348,4
6994,80000,1,2,2,34,1,-1,-1,-2,-2,-2,0,7400,-600,-600,-600,-600,7400,0,0,0,0,0,0,-7400,7400,-600,-600,-600,-600,-0.0925,0.0925,-0.0075,-0.0075,-0.0075,-0.0075,-7
6995,50000,0,2,2,28,0,0,0,0,0,0,49417,48104,49348,28433,53718,27084,1966,2210,1946,983,1950,946,0,47451,45894,47402,27450,51768,26138,0.94902,0.91788,0.94804,0.549,1.03536,0.52276,0
6996,270000,0,1,2,27,0,0,0,0,0,0,176380,188744,194534,199524,203514,208396,15000,10000,7841,6930,7800,7730,0,161380,178744,186693,192594,195714,200666,0.5977037037037037,0.6620148148148148,0.6914555555555556,0.7133111111111111,0.7248666666666667,0.7432074074074074,0
6997,80000,0,1,2,42,0,0,0,0,0,0,74380,68820,59079,30289,27415,28447,2619,2036,1215,1500,1504,1200,0,71761,66784,57864,28789,25911,27247,0.8970125,0.8348,0.7233,0.3598625,0.3238875,0.3405875,0
6998,240000,0,1,1,29,-1,-1,-1,-2,-1,-1,17882,367,-4661,-23,4638,2500,403,4838,4638,4661,2500,0,1,17479,-4471,-9299,-4684,2138,2500,0.07282916666666667,-0.018629166666666665,-0.038745833333333334,-0.01951666666666667,0.008908333333333334,0.010416666666666666,-7
6999,240000,1,2,2,26,0,0,0,0,0,0,150886,141315,128940,124226,113133,113966,6537,6349,5834,3870,4000,3825,0,144349,134966,123106,120356,109133,110141,0.6014541666666666,0.5623583333333333,0.5129416666666666,0.5014833333333333,0.45472083333333335,0.45892083333333333,0
7000,500000,0,2,1,39,-1,-1,-1,-1,-1,-1,23800,297,9342,3518,5597,717,297,9342,3518,5597,717,25349,1,23503,-9045,5824,-2079,4880,-24632,0.047006,-0.01809,0.011648,-0.004158,0.00976,-0.049264,-6
7001,140000,1,1,2,28,0,0,0,0,0,0,9598,10631,11349,12661,12606,12869,1500,1195,1507,452,467,470,0,8098,9436,9842,12209,12139,12399,0.05784285714285714,0.0674,0.0703,0.08720714285714286,0.08670714285714286,0.08856428571428572,0
7002,260000,1,1,1,40,-1,-1,-1,-1,-1,-1,63273,49857,75036,96787,16576,6844,49857,75038,96793,16576,6844,8954,1,13416,-25181,-21757,80211,9732,-2110,0.0516,-0.09685,-0.08368076923076923,0.30850384615384613,0.03743076923076923,-0.008115384615384615,-6
7003,50000,0,2,1,26,1,4,3,2,2,3,13294,12799,12311,11816,14014,13506,0,0,0,2394,0,0,1,13294,12799,12311,9422,14014,13506,0.26588,0.25598,0.24622,0.18844,0.28028,0.27012,15
7004,80000,1,3,1,54,0,0,0,0,0,0,75267,54889,56949,35684,10400,0,3000,4000,3000,1000,0,0,1,72267,50889,53949,34684,10400,0,0.9033375,0.6361125,0.6743625,0.43355,0.13,0.0,0
7005,90000,1,1,1,38,-1,-1,-1,-1,-1,-1,380,2132,0,1066,1752,569,2132,0,1066,1752,569,2132,1,-1752,2132,-1066,-686,1183,-1563,-0.019466666666666667,0.023688888888888888,-0.011844444444444444,-0.007622222222222222,0.013144444444444445,-0.017366666666666666,-6
7006,200000,1,3,1,42,-1,-1,-1,2,-1,0,390,742,4352,390,780,390,742,4000,0,780,0,1757,1,-352,-3258,4352,-390,780,-1367,-0.00176,-0.01629,0.02176,-0.00195,0.0039,-0.006835,-2
7007,80000,1,2,1,35,1,2,2,2,0,0,78959,76699,81477,79035,28503,29711,0,6800,0,1000,2000,1500,1,78959,69899,81477,78035,26503,28211,0.9869875,0.8737375,1.0184625,0.9754375,0.3312875,0.3526375,7
7008,500000,1,2,1,43,0,0,0,0,0,0,374802,355323,352868,353297,377371,365278,14000,14500,13000,13000,15000,15000,1,360802,340823,339868,340297,362371,350278,0.721604,0.681646,0.679736,0.680594,0.724742,0.700556,0
7009,80000,1,3,3,37,-2,-2,-2,-2,-2,-2,600,0,0,0,0,0,0,0,0,0,0,0,0,600,0,0,0,0,0,0.0075,0.0,0.0,0.0,0.0,0.0,-12
7010,20000,1,1,2,23,-1,-1,-1,-1,-1,-2,292,780,0,593,0,0,780,0,593,0,0,0,0,-488,780,-593,593,0,0,-0.0244,0.039,-0.02965,0.02965,0.0,0.0,-7
7011,430000,1,2,1,36,1,-2,-2,-2,-2,-2,1821,2324,2250,3004,1074,1623,2324,2250,3004,1074,1623,2493,1,-503,74,-754,1930,-549,-870,-0.001169767441860465,0.00017209302325581395,-0.0017534883720930232,0.004488372093023256,-0.0012767441860465115,-0.0020232558139534882,-9
7012,90000,0,2,1,34,0,0,0,0,0,0,106053,101023,97045,102372,100794,98277,3547,3580,13000,7000,6000,7000,1,102506,97443,84045,95372,94794,91277,1.1389555555555555,1.0827,0.9338333333333333,1.059688888888889,1.0532666666666666,1.0141888888888888,0
7013,220000,1,2,2,31,2,2,2,2,0,0,182176,176797,187033,171021,167789,168417,0,14179,0,7000,10000,12000,0,182176,162618,187033,164021,157789,156417,0.8280727272727273,0.7391727272727273,0.85015,0.74555,0.7172227272727273,0.7109863636363636,8
7014,180000,1,1,2,25,-1,0,0,0,0,0,62798,51923,51935,47383,32876,28915,1867,2501,1271,926,876,3004,0,60931,49422,50664,46457,32000,25911,0.33850555555555556,0.2745666666666667,0.28146666666666664,0.25809444444444446,0.17777777777777778,0.14395,-1
7015,50000,0,2,2,25,0,0,-1,0,0,-2,17355,5934,16637,4000,0,0,1000,24677,0,0,0,0,0,16355,-18743,16637,4000,0,0,0.3271,-0.37486,0.33274,0.08,0.0,0.0,-3
7016,230000,1,2,1,30,2,0,-1,-1,-1,-1,9636,10152,1817,-828,6153,12663,1222,1837,0,7863,12675,2959,1,8414,8315,1817,-8691,-6522,9704,0.03658260869565218,0.03615217391304348,0.0079,-0.03778695652173913,-0.028356521739130433,0.042191304347826086,-2
7017,120000,0,1,2,27,0,0,0,0,0,0,20874,21930,22165,20502,19030,15119,1700,1500,700,1000,1000,1000,0,19174,20430,21465,19502,18030,14119,0.15978333333333333,0.17025,0.178875,0.16251666666666667,0.15025,0.11765833333333334,0
7018,70000,1,3,1,46,0,0,0,2,2,2,11332,12093,13891,13371,14654,14271,1250,2000,0,1500,0,600,1,10082,10093,13891,11871,14654,13671,0.14402857142857142,0.14418571428571428,0.19844285714285714,0.16958571428571428,0.20934285714285714,0.1953,6
7019,30000,1,2,1,42,2,2,0,0,0,0,30149,28117,27761,28053,28249,23580,0,2000,1507,3100,3100,3100,1,30149,26117,26254,24953,25149,20480,1.0049666666666666,0.8705666666666667,0.8751333333333333,0.8317666666666667,0.8383,0.6826666666666666,4
7020,550000,0,3,1,50,2,2,2,0,0,2,491810,534289,494690,504929,501474,446605,51500,0,19067,35696,0,18169,1,440310,534289,475623,469233,501474,428436,0.8005636363636364,0.9714345454545454,0.8647690909090909,0.8531509090909091,0.9117709090909091,0.7789745454545455,8
7021,50000,1,2,2,25,0,0,0,0,0,0,28428,27383,12620,6730,6872,7057,2000,1110,240,250,300,2335,0,26428,26273,12380,6480,6572,4722,0.52856,0.52546,0.2476,0.1296,0.13144,0.09444,0
7022,100000,1,2,2,29,0,0,2,0,0,2,95205,102039,99504,94453,99711,97944,9300,0,3400,6800,0,3500,0,85905,102039,96104,87653,99711,94444,0.85905,1.02039,0.96104,0.87653,0.99711,0.94444,4
7023,20000,0,2,1,53,-2,-2,-2,-2,-2,-2,35419,31195,26849,23060,23060,-129,0,0,0,0,129,18143,1,35419,31195,26849,23060,22931,-18272,1.77095,1.55975,1.34245,1.153,1.14655,-0.9136,-12
7024,300000,1,3,1,50,-2,-2,-2,-2,-2,-2,0,0,0,0,0,0,0,0,0,0,0,4886,1,0,0,0,0,0,-4886,0.0,0.0,0.0,0.0,0.0,-0.016286666666666668,-12
7025,50000,1,2,1,27,1,2,2,2,2,2,15345,14812,16696,16134,17380,16958,0,2137,0,1503,0,800,1,15345,12675,16696,14631,17380,16158,0.3069,0.2535,0.33392,0.29262,0.3476,0.32316,11
7026,30000,0,1,1,45,0,0,0,0,0,-2,29029,27381,28945,29373,0,0,2000,2138,1102,0,0,0,1,27029,25243,27843,29373,0,0,0.9009666666666667,0.8414333333333334,0.9281,0.9791,0.0,0.0,-2
7027,500000,0,1,2,36,-1,-1,0,-1,-1,-1,15401,23032,54759,52030,71797,93159,23128,40105,52221,71852,93218,179568,0,-7727,-17073,2538,-19822,-21421,-86409,-0.015454,-0.034146,0.005076,-0.039644,-0.042842,-0.172818,-5
7028,20000,0,2,1,34,1,2,2,0,0,0,16112,16851,16292,18010,18411,19455,1300,0,2000,1000,1500,1010,1,14812,16851,14292,17010,16911,18445,0.7406,0.84255,0.7146,0.8505,0.84555,0.92225,5
7029,290000,0,3,1,41,-2,-2,-2,-2,-2,-2,-4,-4,798,-2,494,-6,0,802,0,496,0,1292,1,-4,-806,798,-498,494,-1298,-1.3793103448275862e-05,-0.0027793103448275863,0.0027517241379310343,-0.0017172413793103448,0.001703448275862069,-0.004475862068965517,-12
7030,20000,1,2,2,22,0,0,0,0,0,0,19248,20054,19133,19397,19702,20506,2000,1300,678,706,2037,0,0,17248,18754,18455,18691,17665,20506,0.8624,0.9377,0.92275,0.93455,0.88325,1.0253,0
7031,130000,1,2,1,33,-1,-1,-1,-1,-1,-1,2454,1456,382,1043,2835,-184,1500,382,2000,3000,0,2000,1,954,1074,-1618,-1957,2835,-2184,0.0073384615384615385,0.00826153846153846,-0.012446153846153846,-0.015053846153846154,0.02180769230769231,-0.0168,-6
7032,170000,1,1,2,33,0,0,0,2,0,0,144031,147135,158528,138030,139444,148093,5500,14000,0,5200,11100,0,0,138531,133135,158528,132830,128344,148093,0.8148882352941177,0.7831470588235294,0.9325176470588236,0.7813529411764706,0.754964705882353,0.871135294117647,2
7033,500000,0,2,2,33,0,0,0,0,0,0,134503,114682,124240,131006,137911,119343,20031,20029,20058,20127,10000,10027,0,114472,94653,104182,110879,127911,109316,0.228944,0.189306,0.208364,0.221758,0.255822,0.218632,0
7034,20000,1,2,1,36,1,-2,-2,-2,-2,-2,-25,-25,-25,-25,-25,-25,0,0,0,0,0,0,1,-25,-25,-25,-25,-25,-25,-0.00125,-0.00125,-0.00125,-0.00125,-0.00125,-0.00125,-9
7035,80000,0,1,2,30,-1,0,-1,0,0,0,5504,6187,100,600,1438,1919,1004,504,500,1000,500,3500,0,4500,5683,-400,-400,938,-1581,0.05625,0.0710375,-0.005,-0.005,0.011725,-0.0197625,-2
7036,200000,0,3,3,48,-1,-1,-1,-1,0,0,7331,4760,3529,11711,38079,0,4780,3529,11726,35000,0,0,0,2551,1231,-8197,-23289,38079,0,0.012755,0.006155,-0.040985,-0.116445,0.190395,0.0,-4
7037,280000,1,1,2,32,-1,-1,-1,-1,-1,-1,45536,11509,2110,2121,6789,14959,11509,5000,2121,6789,14959,16067,0,34027,6509,-11,-4668,-8170,-1108,0.121525,0.02324642857142857,-3.928571428571428e-05,-0.016671428571428573,-0.02917857142857143,-0.003957142857142857,-6
7038,360000,0,1,2,28,-2,-2,-2,-2,-2,-2,8840,4951,-17,1815,1035,460,4951,0,1832,1035,460,635,0,3889,4951,-1849,780,575,-175,0.010802777777777777,0.013752777777777777,-0.005136111111111111,0.0021666666666666666,0.0015972222222222223,-0.0004861111111111111,-12
7039,230000,1,2,2,24,0,0,0,0,0,0,78737,63494,55284,42693,42541,34197,2300,2000,1535,1183,1500,2000,0,76437,61494,53749,41510,41041,32197,0.33233478260869564,0.26736521739130437,0.2336913043478261,0.18047826086956523,0.1784391304347826,0.13998695652173912,0
7040,80000,1,3,1,54,0,0,0,0,0,0,12158,13956,14382,15631,16080,17327,2000,1500,1500,1000,1500,2005,1,10158,12456,12882,14631,14580,15322,0.126975,0.1557,0.161025,0.1828875,0.18225,0.191525,0
7041,130000,1,2,1,45,2,-1,-1,-1,-1,-1,990,990,990,990,1130,990,990,990,990,1130,1000,9880,1,0,0,0,-140,130,-8890,0.0,0.0,0.0,-0.0010769230769230769,0.001,-0.06838461538461539,-3
7042,140000,0,2,1,32,0,0,0,0,2,0,86627,78142,68336,64648,58319,55251,3455,3110,5000,0,2100,2602,1,83172,75032,63336,64648,56219,52649,0.5940857142857143,0.5359428571428572,0.4524,0.46177142857142855,0.4015642857142857,0.37606428571428574,2
7043,160000,0,2,2,27,-2,-2,-2,-2,-2,-2,2161,1672,2579,2313,2287,3442,1681,2717,2324,2298,3462,2637,0,480,-1045,255,15,-1175,805,0.003,-0.00653125,0.00159375,9.375e-05,-0.00734375,0.00503125,-12
7044,150000,1,1,2,28,0,-1,-1,0,0,0,6121,4391,6269,8992,4314,11131,4391,6269,8914,4300,11100,52900,0,1730,-1878,-2645,4692,-6786,-41769,0.011533333333333333,-0.01252,-0.017633333333333334,0.03128,-0.04524,-0.27846,-2
7045,120000,1,2,1,40,0,0,0,0,0,0,105124,109399,109397,36850,37739,38381,6020,3900,1700,1500,1400,1400,1,99104,105499,107697,35350,36339,36981,0.8258666666666666,0.8791583333333334,0.897475,0.2945833333333333,0.302825,0.308175,0
7046,20000,0,2,1,43,2,2,2,2,4,3,14301,17069,17818,20251,19657,19072,3000,1300,3000,0,0,0,1,11301,15769,14818,20251,19657,19072,0.56505,0.78845,0.7409,1.01255,0.98285,0.9536,15
7047,50000,0,3,1,39,0,0,0,0,0,0,23257,22938,21583,22453,21618,19525,1333,1500,1274,700,700,688,1,21924,21438,20309,21753,20918,18837,0.43848,0.42876,0.40618,0.43506,0.41836,0.37674,0
7048,230000,1,1,1,45,-2,-2,-2,-2,-2,-2,0,0,0,0,0,136,0,0,0,0,136,1233,1,0,0,0,0,-136,-1097,0.0,0.0,0.0,0.0,-0.0005913043478260869,-0.0047695652173913045,-12
7049,50000,1,1,2,23,-1,-1,-2,-2,-2,-2,2332,0,0,0,0,0,0,0,0,0,0,0,0,2332,0,0,0,0,0,0.04664,0.0,0.0,0.0,0.0,0.0,-10
7050,280000,0,2,1,29,-2,-2,-1,2,2,-2,-650,-650,2057,650,3072,3330,0,2707,3,3072,3330,499,1,-650,-3357,2054,-2422,-258,2831,-0.0023214285714285715,-0.011989285714285714,0.007335714285714286,-0.00865,-0.0009214285714285714,0.010110714285714285,-3
7051,140000,1,1,2,27,2,2,2,2,2,2,94903,96912,98015,99155,100979,99251,4400,3600,3600,3500,0,3470,0,90503,93312,94415,95655,100979,95781,0.64645,0.6665142857142857,0.6743928571428571,0.68325,0.7212785714285714,0.68415,12
7052,240000,1,2,1,30,-1,-1,-1,-1,-1,-1,17047,15188,11366,14231,11135,7774,15188,11366,14231,11135,7774,7785,1,1859,3822,-2865,3096,3361,-11,0.007745833333333334,0.015925,-0.0119375,0.0129,0.014004166666666666,-4.5833333333333334e-05,-6
7053,100000,0,2,2,27,0,0,0,0,0,0,99668,100181,99156,80234,80090,79494,4850,3740,2798,2865,3020,2377,0,94818,96441,96358,77369,77070,77117,0.94818,0.96441,0.96358,0.77369,0.7707,0.77117,0
7054,500000,1,2,1,31,0,0,0,0,0,0,21008,17863,15219,14044,14191,13650,1500,2000,1100,505,700,2000,1,19508,15863,14119,13539,13491,11650,0.039016,0.031726,0.028238,0.027078,0.026982,0.0233,0
7055,30000,0,2,1,38,1,-1,-1,-1,-1,-2,0,2281,3666,2713,0,0,2281,3666,2713,0,0,0,1,-2281,-1385,953,2713,0,0,-0.07603333333333333,-0.04616666666666667,0.031766666666666665,0.09043333333333334,0.0,0.0,-5
7056,300000,0,2,1,30,-2,-1,-1,-1,-2,-1,900,195,1442,1740,3871,606,195,1542,1748,3890,608,4059,1,705,-1347,-306,-2150,3263,-3453,0.00235,-0.00449,-0.00102,-0.007166666666666667,0.010876666666666666,-0.01151,-8
7057,190000,0,2,2,26,-1,0,0,0,0,0,2204,3479,4886,6258,8969,9009,1800,1797,1785,3142,490,2000,0,404,1682,3101,3116,8479,7009,0.002126315789473684,0.008852631578947369,0.016321052631578948,0.0164,0.04462631578947369,0.03688947368421053,-1
7058,80000,1,1,1,44,-1,-1,-1,-1,-1,-1,14686,3673,11285,500,500,6155,3673,11285,500,500,6155,1440,1,11013,-7612,10785,0,-5655,4715,0.1376625,-0.09515,0.1348125,0.0,-0.0706875,0.0589375,-6
7059,240000,1,1,2,30,1,-2,-2,-2,-2,-2,0,0,0,0,0,0,0,0,0,0,0,0,0,0,0,0,0,0,0,0.0,0.0,0.0,0.0,0.0,0.0,-9
7060,70000,1,2,2,55,0,0,0,0,0,0,57867,53214,54571,42413,42946,43843,1920,2230,2004,1537,1589,1598,0,55947,50984,52567,40876,41357,42245,0.7992428571428571,0.7283428571428572,0.7509571428571429,0.5839428571428571,0.5908142857142857,0.6035,0
7061,30000,1,2,1,28,0,0,0,0,0,0,8704,9698,11022,12032,12134,12439,1300,1488,1498,600,500,750,1,7404,8210,9524,11432,11634,11689,0.2468,0.27366666666666667,0.3174666666666667,0.38106666666666666,0.3878,0.38963333333333333,0
7062,80000,1,3,2,26,0,0,2,0,0,0,40931,44374,43365,44143,45079,45977,4100,0,1800,1800,1800,2000,0,36831,44374,41565,42343,43279,43977,0.4603875,0.554675,0.5195625,0.5292875,0.5409875,0.5497125,2
7063,140000,1,1,2,27,0,0,0,0,-1,-1,10064,10551,11655,11377,735,1051,2000,2000,1000,735,1051,569,0,8064,8551,10655,10642,-316,482,0.0576,0.061078571428571427,0.07610714285714286,0.07601428571428571,-0.0022571428571428573,0.003442857142857143,-2
7064,190000,1,3,1,41,2,0,0,2,0,0,185738,187764,100526,94909,94804,94007,7762,7700,0,3545,3386,3575,1,177976,180064,100526,91364,91418,90432,0.9367157894736842,0.9477052631578947,0.5290842105263158,0.4808631578947368,0.48114736842105266,0.4759578947368421,4
7065,190000,0,1,2,33,0,0,0,0,0,0,144706,137502,127014,120826,112211,110396,6388,6112,4202,4200,4200,5000,0,138318,131390,122812,116626,108011,105396,0.7279894736842105,0.6915263157894737,0.646378947368421,0.6138210526315789,0.5684789473684211,0.5547157894736842,0
7066,140000,1,2,1,33,1,-1,-1,-1,-1,-1,-23,5742,0,1920,1180,0,5765,0,1920,1180,0,60000,1,-5788,5742,-1920,740,1180,-60000,-0.04134285714285714,0.04101428571428571,-0.013714285714285714,0.005285714285714286,0.00842857142857143,-0.42857142857142855,-4
7067,100000,1,3,1,35,-1,-1,-1,-1,-1,-2,390,390,0,780,0,0,390,0,780,0,0,0,1,0,390,-780,780,0,0,0.0,0.0039,-0.0078,0.0078,0.0,0.0,-7
7068,100000,0,3,1,35,0,0,0,0,0,0,94467,96521,98728,74239,75704,55704,3627,3938,2515,2516,4022,2032,1,90840,92583,96213,71723,71682,53672,0.9084,0.92583,0.96213,0.71723,0.71682,0.53672,0
7069,130000,0,2,2,31,3,2,2,3,3,2,300,300,300,300,300,150,0,0,0,0,0,1000,0,300,300,300,300,300,-850,0.002307692307692308,0.002307692307692308,0.002307692307692308,0.002307692307692308,0.002307692307692308,-0.006538461538461538,15
7070,320000,1,1,1,36,-1,-1,2,2,-2,-2,7225,9336,945,-37,-37,-37,9386,13,0,0,0,7445,1,-2161,9323,945,-37,-37,-7482,-0.006753125,0.029134375,0.002953125,-0.000115625,-0.000115625,-0.02338125,-2
7071,200000,1,1,1,34,-2,-1,-1,-2,-2,-1,16024,18168,10274,4726,4484,4745,18184,10274,4726,4490,4745,1283,1,-2160,7894,5548,236,-261,3462,-0.0108,0.03947,0.02774,0.00118,-0.001305,0.01731,-9
7072,190000,0,2,2,41,0,0,0,0,0,0,33798,34931,36064,37160,38237,39464,2000,2000,2000,2000,2000,2000,0,31798,32931,34064,35160,36237,37464,0.1673578947368421,0.17332105263157896,0.1792842105263158,0.18505263157894736,0.19072105263157896,0.19717894736842106,0
7073,420000,0,1,2,42,0,0,0,0,0,0,155814,155282,116385,106961,92331,89566,5397,5678,3577,3023,3026,3012,0,150417,149604,112808,103938,89305,86554,0.3581357142857143,0.3562,0.2685904761904762,0.24747142857142856,0.2126309523809524,0.2060809523809524,0
7074,310000,1,1,1,30,0,0,0,0,0,0,27289,28020,31140,27695,17338,17731,1489,4415,1084,491,540,4000,1,25800,23605,30056,27204,16798,13731,0.0832258064516129,0.07614516129032257,0.09695483870967742,0.08775483870967742,0.05418709677419355,0.04429354838709677,0
7075,200000,0,1,1,45,1,-1,-1,-2,-2,-2,0,479,0,0,0,0,479,0,0,0,0,0,1,-479,479,0,0,0,0,-0.002395,0.002395,0.0,0.0,0.0,0.0,-7
7076,20000,0,2,1,32,2,0,0,2,0,0,18390,19468,20844,19362,19402,19607,2000,3000,0,850,920,750,1,16390,16468,20844,18512,18482,18857,0.8195,0.8234,1.0422,0.9256,0.9241,0.94285,4
7077,360000,0,1,2,30,-1,-1,-1,-1,-1,-1,30627,4297,2720,2040,2722,5057,4318,2740,2050,2736,5273,5105,0,26309,1557,670,-696,-2551,-48,0.07308055555555555,0.004325,0.0018611111111111111,-0.0019333333333333333,-0.007086111111111111,-0.00013333333333333334,-6
7078,50000,1,1,2,22,2,2,2,0,0,0,8823,10606,4991,4461,2561,0,2000,300,200,0,0,0,0,6823,10306,4791,4461,2561,0,0.13646,0.20612,0.09582,0.08922,0.05122,0.0,6
7079,150000,0,1,2,34,2,3,2,0,0,0,32355,31549,30759,32764,36229,79827,0,0,2535,5000,5000,3000,0,32355,31549,28224,27764,31229,76827,0.2157,0.21032666666666666,0.18816,0.18509333333333333,0.20819333333333334,0.51218,7
7080,30000,1,1,2,26,0,0,0,0,0,-1,9417,4638,3617,3787,4820,914,3150,1000,1200,2000,914,7311,0,6267,3638,2417,1787,3906,-6397,0.2089,0.12126666666666666,0.08056666666666666,0.059566666666666664,0.1302,-0.21323333333333333,-1
7081,210000,1,1,1,53,0,0,0,0,0,0,180227,186423,169614,172297,177427,182399,11000,8000,7000,8000,8000,9000,1,169227,178423,162614,164297,169427,173399,0.8058428571428572,0.8496333333333334,0.7743523809523809,0.7823666666666667,0.8067952380952381,0.8257095238095238,0
7082,260000,1,1,1,49,1,-2,-2,-1,0,0,0,0,0,1180,1180,0,0,0,1180,0,0,0,1,0,0,-1180,1180,1180,0,0.0,0.0,-0.004538461538461538,0.004538461538461538,0.004538461538461538,0.0,-4
7083,80000,0,3,1,55,0,0,0,0,0,0,79788,81571,75814,49784,51408,48587,25000,7704,8700,3000,12900,3000,1,54788,73867,67114,46784,38508,45587,0.68485,0.9233375,0.838925,0.5848,0.48135,0.5698375,0
7084,430000,0,2,1,32,1,-1,-1,-2,-2,-2,0,2500,0,0,0,0,2500,0,0,0,0,0,1,-2500,2500,0,0,0,0,-0.005813953488372093,0.005813953488372093,0.0,0.0,0.0,0.0,-7
7085,100000,1,1,2,26,1,-2,-2,-2,-2,-2,0,0,0,0,0,0,0,0,0,0,0,150,0,0,0,0,0,0,-150,0.0,0.0,0.0,0.0,0.0,-0.0015,-9
7086,50000,1,3,1,22,2,2,2,2,2,2,40247,40189,43434,44316,45189,46214,900,3900,1900,1900,1900,3600,1,39347,36289,41534,42416,43289,42614,0.78694,0.72578,0.83068,0.84832,0.86578,0.85228,12
7087,370000,1,3,2,50,-1,0,-1,-1,-2,-2,48303,129317,1364,0,0,0,124174,2000,0,0,0,2463,0,-75871,127317,1364,0,0,-2463,-0.20505675675675675,0.3441,0.0036864864864864866,0.0,0.0,-0.006656756756756757,-7
7088,10000,0,2,1,37,-1,4,3,2,2,2,7501,7243,6988,6730,7463,7199,0,0,0,1000,0,3000,1,7501,7243,6988,5730,7463,4199,0.7501,0.7243,0.6988,0.573,0.7463,0.4199,12
7089,120000,1,2,1,33,0,0,0,0,0,0,46640,50865,54401,57873,61917,63880,5000,5000,5000,5000,3000,3000,1,41640,45865,49401,52873,58917,60880,0.347,0.3822083333333333,0.411675,0.4406083333333333,0.490975,0.5073333333333333,0
7090,400000,1,2,2,32,-2,-2,-2,-2,-2,-2,6464,-270,-770,-761,-2710,187552,1692,0,9,11,194541,7015,0,4772,-270,-779,-772,-197251,180537,0.01193,-0.000675,-0.0019475,-0.00193,-0.4931275,0.4513425,-12
7091,110000,1,1,2,25,2,2,2,-1,-1,0,2729,4382,1972,1426,5660,5660,4340,5,1426,5660,0,0,0,-1611,4377,546,-4234,5660,5660,-0.014645454545454545,0.03979090909090909,0.004963636363636364,-0.03849090909090909,0.051454545454545454,0.051454545454545454,4
7092,50000,0,3,2,25,1,2,2,0,0,2,43685,44694,43673,44659,49512,48454,2000,0,2000,6000,300,3000,0,41685,44694,41673,38659,49212,45454,0.8337,0.89388,0.83346,0.77318,0.98424,0.90908,7
7093,30000,0,2,3,53,1,-2,-1,2,0,0,0,0,4070,3825,3825,0,0,4070,0,0,0,0,0,0,-4070,4070,3825,3825,0,0.0,-0.13566666666666666,0.13566666666666666,0.1275,0.1275,0.0,0
7094,50000,1,1,2,25,0,0,0,0,0,0,50051,46768,48124,48171,19401,19412,1754,2500,1781,2000,695,1000,0,48297,44268,46343,46171,18706,18412,0.96594,0.88536,0.92686,0.92342,0.37412,0.36824,0
7095,300000,1,2,2,43,1,-2,-2,-1,-1,-1,499,0,0,507,0,629,0,0,507,0,629,0,0,499,0,-507,507,-629,629,0.0016633333333333333,0.0,-0.00169,0.00169,-0.002096666666666667,0.002096666666666667,-6
7096,580000,0,1,1,42,0,0,0,0,0,0,264482,267508,255409,256321,250358,236608,9431,8842,7663,7814,7794,7887,1,255051,258666,247746,248507,242564,228721,0.4397431034482759,0.4459758620689655,0.42714827586206894,0.4284603448275862,0.41821379310344825,0.3943465517241379,0
7097,100000,0,3,1,36,2,0,0,2,0,0,8674,10520,13337,12829,15446,17178,2000,3000,0,3000,2000,2000,1,6674,7520,13337,9829,13446,15178,0.06674,0.0752,0.13337,0.09829,0.13446,0.15178,4
7098,300000,1,2,1,44,0,-1,-1,-1,-1,-1,7948,576,2660,2319,1905,257,576,2684,2319,1905,257,3743,1,7372,-2108,341,414,1648,-3486,0.024573333333333332,-0.007026666666666666,0.0011366666666666667,0.00138,0.005493333333333334,-0.01162,-5
7099,110000,0,1,1,29,0,0,0,0,0,0,51499,50405,49156,46426,43765,41295,1887,1601,1500,1696,1658,1179,1,49612,48804,47656,44730,42107,40116,0.4510181818181818,0.4436727272727273,0.43323636363636364,0.40663636363636363,0.38279090909090907,0.36469090909090907,0
7100,200000,0,3,2,42,-1,0,0,0,0,0,2753,4520,7151,9641,14927,17345,3006,5019,5013,10007,5006,10003,0,-253,-499,2138,-366,9921,7342,-0.001265,-0.002495,0.01069,-0.00183,0.049605,0.03671,-1
7101,150000,0,2,2,32,0,0,0,0,0,0,146785,92750,73822,35706,28178,20782,3300,3114,2000,2000,2000,3700,0,143485,89636,71822,33706,26178,17082,0.9565666666666667,0.5975733333333333,0.4788133333333333,0.22470666666666667,0.17452,0.11388,0
7102,130000,1,2,2,33,0,0,0,0,0,0,127781,122319,107674,89780,90625,90492,4700,3500,3200,3200,3300,3100,0,123081,118819,104474,86580,87325,87392,0.9467769230769231,0.9139923076923077,0.8036461538461539,0.666,0.6717307692307692,0.6722461538461538,0
7103,150000,1,2,1,36,0,0,0,0,0,0,296846,301634,314201,84135,90500,0,7143,13700,15000,7500,0,0,1,289703,287934,299201,76635,90500,0,1.9313533333333333,1.91956,1.9946733333333333,0.5109,0.6033333333333334,0.0,0
7104,140000,0,2,2,25,-1,-1,-1,-1,-1,-1,1198,4656,1516,-660,249,-427,4660,2000,0,2200,1500,1400,0,-3462,2656,1516,-2860,-1251,-1827,-0.02472857142857143,0.018971428571428573,0.010828571428571429,-0.020428571428571428,-0.008935714285714286,-0.01305,-6
7105,20000,1,1,2,23,0,0,0,0,0,-2,17246,16988,15973,18773,0,0,2000,2000,3000,0,0,0,0,15246,14988,12973,18773,0,0,0.7623,0.7494,0.64865,0.93865,0.0,0.0,-2
7106,50000,0,1,2,25,0,0,0,0,0,0,18164,19456,20486,21241,21788,23281,1900,1645,1400,900,2000,0,0,16264,17811,19086,20341,19788,23281,0.32528,0.35622,0.38172,0.40682,0.39576,0.46562,0
7107,30000,1,2,2,22,0,0,0,2,2,2,26568,27556,29963,28835,30174,28603,1762,3500,0,2297,40,1755,0,24806,24056,29963,26538,30134,26848,0.8268666666666666,0.8018666666666666,0.9987666666666667,0.8846,1.0044666666666666,0.8949333333333334,6
7108,220000,0,1,2,35,0,0,0,0,0,0,158882,164258,161778,165741,175823,29765,8000,5669,7599,14800,2303,2000,0,150882,158589,154179,150941,173520,27765,0.6858272727272727,0.720859090909091,0.7008136363636364,0.6860954545454545,0.7887272727272727,0.12620454545454546,0
7109,150000,0,1,1,44,-1,-1,-1,-1,-1,0,4825,3003,6164,3370,7279,4445,3018,6201,3386,7299,1166,5,1,1807,-3198,2778,-3929,6113,4440,0.012046666666666667,-0.02132,0.01852,-0.026193333333333332,0.040753333333333336,0.0296,-5
7110,360000,1,2,2,35,2,2,2,0,0,0,360023,363239,350214,319960,260944,202686,14693,30,12302,10004,7506,19721,0,345330,363209,337912,309956,253438,182965,0.95925,1.0089138888888889,0.9386444444444444,0.8609888888888889,0.7039944444444445,0.5082361111111111,6
7111,60000,1,3,1,49,0,0,0,0,0,0,60335,52211,48293,49311,50290,51346,6751,6803,1821,1800,1866,1896,1,53584,45408,46472,47511,48424,49450,0.8930666666666667,0.7568,0.7745333333333333,0.79185,0.8070666666666667,0.8241666666666667,0
7112,320000,1,2,1,44,1,-2,-2,-2,-2,-2,0,0,0,0,0,0,0,0,0,0,0,0,1,0,0,0,0,0,0,0.0,0.0,0.0,0.0,0.0,0.0,-9
7113,40000,1,1,2,26,2,2,2,2,2,2,26487,27255,26532,29089,28522,28914,1500,0,3000,200,1000,1200,0,24987,27255,23532,28889,27522,27714,0.624675,0.681375,0.5883,0.722225,0.68805,0.69285,12
7114,20000,1,2,1,48,1,-2,-2,-2,-2,-2,0,0,0,0,0,0,0,0,0,0,0,0,1,0,0,0,0,0,0,0.0,0.0,0.0,0.0,0.0,0.0,-9
7115,60000,1,1,1,28,-1,-1,-1,-1,-1,-1,2848,1469,1647,1355,1458,1631,1469,1675,1355,1458,1631,1931,1,1379,-206,292,-103,-173,-300,0.022983333333333335,-0.0034333333333333334,0.004866666666666667,-0.0017166666666666667,-0.0028833333333333332,-0.005,-6
7116,200000,1,2,2,27,0,0,0,-1,-1,0,7886,7101,5378,5501,9402,9221,4500,3378,5501,9402,6000,5683,0,3386,3723,-123,-3901,3402,3538,0.01693,0.018615,-0.000615,-0.019505,0.01701,0.01769,-2
7117,400000,1,1,2,29,-1,0,0,0,0,0,5154,6016,7056,7310,9943,12849,1060,1100,310,3000,3000,6100,0,4094,4916,6746,4310,6943,6749,0.010235,0.01229,0.016865,0.010775,0.0173575,0.0168725,-1
7118,370000,1,2,1,45,0,0,0,0,2,2,162526,168389,338660,221808,222304,217704,10000,10000,114000,10000,0,9000,1,152526,158389,224660,211808,222304,208704,0.4122324324324324,0.42807837837837837,0.6071891891891892,0.572454054054054,0.6008216216216217,0.5640648648648648,4
7119,210000,1,2,1,37,0,0,-2,-2,-2,-2,22908,32513,6192,2885,8419,2810,32513,9,8,8444,3118,0,1,-9605,32504,6184,-5559,5301,2810,-0.04573809523809524,0.15478095238095238,0.02944761904761905,-0.026471428571428573,0.025242857142857143,0.01338095238095238,-8
7120,200000,1,1,1,39,1,-2,-2,-1,-1,-1,0,0,0,522,0,1073,0,0,522,0,1073,0,1,0,0,-522,522,-1073,1073,0.0,0.0,-0.00261,0.00261,-0.005365,0.005365,-6
7121,260000,1,2,2,26,0,0,0,0,0,0,264249,264434,263847,262723,222464,222837,9800,9800,9413,7114,7532,8427,0,254449,254634,254434,255609,214932,214410,0.97865,0.9793615384615385,0.9785923076923077,0.9831115384615384,0.8266615384615384,0.8246538461538462,0
7122,200000,0,1,1,34,-1,-1,-1,-1,-1,-2,3692,-16,1886,4700,0,0,0,1902,4723,0,0,0,1,3692,-1918,-2837,4700,0,0,0.01846,-0.00959,-0.014185,0.0235,0.0,0.0,-7
7123,210000,0,1,2,30,1,-2,-2,-2,-2,-2,0,0,0,0,0,0,0,0,0,0,0,0,0,0,0,0,0,0,0,0.0,0.0,0.0,0.0,0.0,0.0,-9
7124,20000,1,1,2,22,0,0,0,0,0,0,19760,18570,17604,11973,9517,6799,1376,1383,1000,455,1500,2200,0,18384,17187,16604,11518,8017,4599,0.9192,0.85935,0.8302,0.5759,0.40085,0.22995,0
7125,50000,0,2,2,39,1,2,2,2,2,2,39966,37584,38423,37212,39319,36082,0,3000,0,3007,7,3119,0,39966,34584,38423,34205,39312,32963,0.79932,0.69168,0.76846,0.6841,0.78624,0.65926,11
7126,230000,0,2,1,28,0,0,0,-1,0,0,231357,233543,99033,237008,184695,185116,10000,7000,237008,6488,6605,6800,1,221357,226543,-137975,230520,178090,178316,0.9624217391304348,0.9849695652173913,-0.5998913043478261,1.0022608695652173,0.7743043478260869,0.7752869565217392,-1
7127,100000,1,1,2,30,1,2,0,0,0,0,105033,102513,100693,71253,70206,71060,0,3509,3047,3500,3000,2500,0,105033,99004,97646,67753,67206,68560,1.05033,0.99004,0.97646,0.67753,0.67206,0.6856,3
7128,230000,0,2,2,28,-1,-1,-1,-1,-1,-1,651,651,651,0,651,1496,651,651,0,651,1496,1953,0,0,0,651,-651,-845,-457,0.0,0.0,0.0028304347826086955,-0.0028304347826086955,-0.003673913043478261,-0.0019869565217391304,-6
7129,30000,0,2,2,28,2,0,0,0,0,0,24104,25198,25988,27107,27450,29193,1800,1500,1600,1000,2100,1400,0,22304,23698,24388,26107,25350,27793,0.7434666666666667,0.7899333333333334,0.8129333333333333,0.8702333333333333,0.845,0.9264333333333333,2
7130,60000,0,1,3,47,0,-1,-1,0,0,0,49689,2497,59271,28101,29724,25664,3007,59274,1500,2013,1000,1000,0,46682,-56777,57771,26088,28724,24664,0.7780333333333334,-0.9462833333333334,0.96285,0.4348,0.47873333333333334,0.4110666666666667,-2
7131,20000,0,2,2,35,2,2,3,2,0,0,15087,16133,17174,16605,17029,17305,1600,1600,0,1000,700,1000,0,13487,14533,17174,15605,16329,16305,0.67435,0.72665,0.8587,0.78025,0.81645,0.81525,9
7132,30000,0,1,2,47,2,2,0,0,0,2,26413,25690,26719,27774,28809,30399,0,1445,1500,1500,2200,0,0,26413,24245,25219,26274,26609,30399,0.8804333333333333,0.8081666666666667,0.8406333333333333,0.8758,0.8869666666666667,1.0133,6
7133,100000,1,2,2,34,-1,-1,-1,-1,-1,-2,1919,1831,163,1028,0,0,1831,163,1028,0,0,0,0,88,1668,-865,1028,0,0,0.00088,0.01668,-0.00865,0.01028,0.0,0.0,-7
7134,490000,0,2,1,50,0,0,0,0,0,0,208353,205873,210880,215628,217883,223541,10000,10000,10000,10000,10000,8000,1,198353,195873,200880,205628,207883,215541,0.40480204081632654,0.39974081632653063,0.4099591836734694,0.4196489795918367,0.42425102040816326,0.4398795918367347,0
7135,320000,1,2,1,41,0,0,0,0,0,0,49846,53811,38717,35409,35036,35939,5000,2000,2000,3000,3000,1500,1,44846,51811,36717,32409,32036,34439,0.14014375,0.161909375,0.114740625,0.101278125,0.1001125,0.107621875,0
7136,140000,1,3,1,42,2,2,2,2,2,0,47556,48802,47722,50411,49473,50649,2300,0,3800,0,2000,2000,1,45256,48802,43922,50411,47473,48649,0.32325714285714285,0.3485857142857143,0.3137285714285714,0.3600785714285714,0.33909285714285714,0.34749285714285716,10
7137,50000,0,2,2,51,0,0,0,2,2,0,15096,16541,18356,18181,18285,10220,2000,2400,420,600,600,500,0,13096,14141,17936,17581,17685,9720,0.26192,0.28282,0.35872,0.35162,0.3537,0.1944,4
7138,240000,1,2,1,50,-2,-2,-2,-2,-2,-2,664,1086,7041,12208,790,2009,1086,7041,12208,1109,2009,1077,1,-422,-5955,-5167,11099,-1219,932,-0.0017583333333333333,-0.0248125,-0.021529166666666665,0.04624583333333333,-0.005079166666666667,0.0038833333333333333,-12
7139,80000,0,1,2,25,0,0,0,-1,0,0,20708,26286,18209,5471,6896,9506,6545,8807,5500,4000,3500,1000,0,14163,17479,12709,1471,3396,8506,0.1770375,0.2184875,0.1588625,0.0183875,0.04245,0.106325,-1
7140,50000,0,2,2,23,0,0,-2,-2,-2,-2,49276,0,0,0,0,0,0,0,0,0,0,0,0,49276,0,0,0,0,0,0.98552,0.0,0.0,0.0,0.0,0.0,-8
7141,30000,0,3,2,26,1,-1,2,0,-1,-1,-857,29237,1170,780,10500,0,30484,0,0,10500,0,0,0,-31341,29237,1170,-9720,10500,0,-1.0447,0.9745666666666667,0.039,-0.324,0.35,0.0,0
7142,220000,1,3,2,40,0,0,0,0,0,0,220091,203554,207953,156699,157883,161208,7797,8201,7302,5437,5651,5683,0,212294,195353,200651,151262,152232,155525,0.9649727272727273,0.8879681818181818,0.91205,0.6875545454545454,0.6919636363636363,0.7069318181818182,0
7143,150000,1,1,2,29,0,0,0,0,0,0,78044,43437,45132,39180,31422,32410,2000,2500,3300,2150,1500,6200,0,76044,40937,41832,37030,29922,26210,0.50696,0.27291333333333334,0.27888,0.24686666666666668,0.19948,0.17473333333333332,0
7144,50000,0,1,2,23,0,0,0,0,0,0,8003,9025,9868,9406,9605,9805,1310,1153,400,350,360,350,0,6693,7872,9468,9056,9245,9455,0.13386,0.15744,0.18936,0.18112,0.1849,0.1891,0
7145,180000,1,2,2,36,0,0,0,2,2,-1,14222,14701,17322,13137,0,2293,1300,2902,3047,0,2293,2000,0,12922,11799,14275,13137,-2293,293,0.07178888888888889,0.06555,0.07930555555555556,0.07298333333333333,-0.012738888888888888,0.0016277777777777777,3
7146,50000,0,2,1,30,0,0,0,0,0,0,48591,37944,50135,49526,19686,19374,12000,13000,5000,4010,6000,3000,1,36591,24944,45135,45516,13686,16374,0.73182,0.49888,0.9027,0.91032,0.27372,0.32748,0
7147,220000,1,1,2,28,0,0,-1,-1,-1,0,53342,56022,5806,5637,23054,10730,5000,5806,5637,23054,0,2406,0,48342,50216,169,-17417,23054,8324,0.21973636363636365,0.22825454545454546,0.0007681818181818181,-0.07916818181818182,0.10479090909090909,0.03783636363636363,-3
7148,200000,1,2,1,35,0,0,0,0,0,0,71561,74084,74770,75826,77741,79597,4000,3010,2600,3000,3000,3000,1,67561,71074,72170,72826,74741,76597,0.337805,0.35537,0.36085,0.36413,0.373705,0.382985,0
7149,150000,1,1,2,28,1,-1,-1,-1,-1,0,-89,13894,24782,1927,8200,3867,13983,24831,2358,8210,19,0,0,-14072,-10937,22424,-6283,8181,3867,-0.09381333333333333,-0.07291333333333333,0.14949333333333334,-0.04188666666666667,0.05454,0.02578,-3
7150,270000,1,2,2,34,-2,-2,-2,-2,-2,-2,128620,2222,9076,5424,9577,8130,2222,9076,5424,9577,8130,20177,0,126398,-6854,3652,-4153,1447,-12047,0.46814074074074075,-0.025385185185185184,0.013525925925925926,-0.015381481481481482,0.005359259259259259,-0.044618518518518516,-12
7151,170000,0,2,1,27,-1,-1,-1,-1,0,-1,2697,0,1409,1337,1337,53885,0,1409,1337,0,53885,2000,1,2697,-1409,72,1337,-52548,51885,0.01586470588235294,-0.008288235294117647,0.0004235294117647059,0.00786470588235294,-0.3091058823529412,0.30520588235294116,-5
7152,50000,1,2,1,31,0,0,0,0,0,0,48509,50724,50453,19703,19345,20106,3310,2039,1237,634,5000,844,1,45199,48685,49216,19069,14345,19262,0.90398,0.9737,0.98432,0.38138,0.2869,0.38524,0
7153,30000,1,2,2,22,2,2,0,0,0,2,31331,24544,28267,30470,29284,25762,0,5600,3005,1200,0,5000,0,31331,18944,25262,29270,29284,20762,1.0443666666666667,0.6314666666666666,0.8420666666666666,0.9756666666666667,0.9761333333333333,0.6920666666666667,6
7154,80000,1,2,2,25,1,-2,-2,-2,-2,-2,0,0,0,0,0,0,0,0,0,0,0,0,0,0,0,0,0,0,0,0.0,0.0,0.0,0.0,0.0,0.0,-9
7155,20000,0,3,3,47,0,0,0,0,0,0,18768,18795,19390,19464,18126,18827,1400,1400,1000,700,1600,0,0,17368,17395,18390,18764,16526,18827,0.8684,0.86975,0.9195,0.9382,0.8263,0.94135,0
7156,240000,1,2,1,32,1,-2,-1,-1,-1,-1,0,0,493,-5,574,3509,0,493,0,579,3509,1198,1,0,-493,493,-584,-2935,2311,0.0,-0.002054166666666667,0.002054166666666667,-0.0024333333333333334,-0.012229166666666666,0.009629166666666666,-5
7157,320000,1,2,1,53,0,0,0,0,0,0,319711,33589,34608,38544,44486,52319,3000,3000,6000,8000,10000,1900,1,316711,30589,28608,30544,34486,50419,0.989721875,0.095590625,0.0894,0.09545,0.10776875,0.157559375,0
7158,120000,1,2,1,26,0,0,0,0,0,0,4317,5240,5283,5444,6412,5121,2000,1000,1000,1000,1825,1272,1,2317,4240,4283,4444,4587,3849,0.019308333333333334,0.035333333333333335,0.03569166666666666,0.037033333333333335,0.038225,0.032075,0
7159,280000,1,1,2,29,0,0,0,0,0,0,149312,152323,155568,158775,162035,165522,5500,5700,5800,5900,6100,6100,0,143812,146623,149768,152875,155935,159422,0.5136142857142857,0.5236535714285714,0.5348857142857143,0.5459821428571429,0.5569107142857143,0.5693642857142858,0
7160,100000,1,2,2,39,0,0,0,0,0,0,100224,101236,101125,96765,99823,96165,4000,3544,3519,5000,3500,4000,0,96224,97692,97606,91765,96323,92165,0.96224,0.97692,0.97606,0.91765,0.96323,0.92165,0
7161,220000,0,1,1,39,0,0,0,0,0,0,75190,151004,152786,137946,118310,119147,100000,8000,6000,5000,5000,5000,1,-24810,143004,146786,132946,113310,114147,-0.11277272727272727,0.6500181818181818,0.6672090909090909,0.6043,0.5150454545454546,0.51885,0
7162,120000,1,2,1,50,0,0,0,0,0,0,118492,119637,102228,75558,47536,44749,6141,4474,2647,1367,1322,1500,1,112351,115163,99581,74191,46214,43249,0.9362583333333333,0.9596916666666667,0.8298416666666667,0.6182583333333334,0.38511666666666666,0.36040833333333333,0
7163,150000,1,2,1,36,0,0,2,0,0,0,141460,145408,142139,137453,139827,136320,8021,5066,6000,5029,5016,5100,1,133439,140342,136139,132424,134811,131220,0.8895933333333333,0.9356133333333333,0.9075933333333334,0.8828266666666666,0.89874,0.8748,2
7164,240000,0,1,2,27,0,0,0,0,-1,2,2961,4748,7013,7722,732,291,2000,2873,1000,882,0,0,0,961,1875,6013,6840,732,291,0.004004166666666666,0.0078125,0.025054166666666666,0.0285,0.00305,0.0012125,1
7165,110000,1,2,1,48,0,0,0,0,0,0,108668,111162,107172,107629,106628,106903,4322,5369,4003,3806,4050,3672,1,104346,105793,103169,103823,102578,103231,0.9486,0.9617545454545454,0.9379,0.9438454545454545,0.9325272727272728,0.9384636363636364,0
7166,50000,1,2,1,34,0,0,0,0,0,0,26149,26660,27637,22521,20533,14659,2000,1718,1210,1018,539,5001,1,24149,24942,26427,21503,19994,9658,0.48298,0.49884,0.52854,0.43006,0.39988,0.19316,0
7167,390000,1,2,2,41,0,0,-2,-2,-2,-2,10496,-23,-349,-675,-1001,-1327,0,0,0,0,0,2000,0,10496,-23,-349,-675,-1001,-3327,0.026912820512820512,-5.8974358974358975e-05,-0.0008948717948717949,-0.0017307692307692308,-0.0025666666666666667,-0.00853076923076923,-8
7168,260000,0,1,2,37,-2,-2,-2,-2,-2,-2,256,188,188,198,217,1825,188,188,198,217,1825,198,0,68,0,-10,-19,-1608,1627,0.00026153846153846154,0.0,-3.846153846153846e-05,-7.307692307692307e-05,-0.006184615384615385,0.006257692307692308,-12
7169,250000,0,1,2,28,-2,-1,-1,-2,-2,-2,4003,2527,1652,7734,3337,7866,2549,1715,8042,4023,9167,3036,0,1454,812,-6390,3711,-5830,4830,0.005816,0.003248,-0.02556,0.014844,-0.02332,0.01932,-10
7170,360000,1,3,1,43,-2,-2,-1,-1,-2,-2,4392,0,2050,754,0,0,0,2050,754,0,0,1738,1,4392,-2050,1296,754,0,-1738,0.0122,-0.005694444444444445,0.0036,0.0020944444444444443,0.0,-0.004827777777777778,-10
7171,80000,0,1,1,46,0,0,0,0,0,0,39115,40176,39681,29213,25356,22723,2000,2490,1522,1100,960,988,1,37115,37686,38159,28113,24396,21735,0.4639375,0.471075,0.4769875,0.3514125,0.30495,0.2716875,0
7172,50000,1,2,1,42,0,0,0,0,0,0,49401,47828,48416,20098,20130,20158,2100,2000,702,718,730,632,1,47301,45828,47714,19380,19400,19526,0.94602,0.91656,0.95428,0.3876,0.388,0.39052,0
7173,50000,1,3,1,55,0,0,0,0,0,0,37234,37942,38003,11625,18442,9743,1963,2025,562,339,1200,600,1,35271,35917,37441,11286,17242,9143,0.70542,0.71834,0.74882,0.22572,0.34484,0.18286,0
7174,150000,1,3,1,24,-2,-2,-2,-2,-2,-2,6479,1670,4330,8036,1505,974,1670,4330,8040,1505,974,0,1,4809,-2660,-3710,6531,531,974,0.03206,-0.017733333333333334,-0.024733333333333333,0.04354,0.00354,0.006493333333333334,-12
7175,180000,0,3,2,46,0,0,0,0,0,0,109114,71952,16765,14611,16209,25653,2835,1500,1000,2000,10000,20000,0,106279,70452,15765,12611,6209,5653,0.5904388888888888,0.3914,0.08758333333333333,0.07006111111111112,0.034494444444444446,0.031405555555555555,0
7176,410000,1,3,1,32,-2,-2,-2,-2,-1,0,388,388,388,388,110345,116128,388,388,388,110345,8000,4200,1,0,0,0,-109957,102345,111928,0.0,0.0,0.0,-0.2681878048780488,0.2496219512195122,0.2729951219512195,-9
7177,180000,1,2,2,28,1,2,2,0,0,0,172850,182810,169529,153501,136920,139506,14400,402,5166,5000,5030,5391,0,158450,182408,164363,148501,131890,134115,0.8802777777777778,1.0133777777777777,0.9131277777777778,0.8250055555555555,0.7327222222222223,0.7450833333333333,5
7178,100000,1,2,1,44,1,-2,-2,-2,-1,2,-1651,-5469,-7292,-10938,5887,3882,0,0,0,16825,0,1823,1,-1651,-5469,-7292,-27763,5887,2059,-0.01651,-0.05469,-0.07292,-0.27763,0.05887,0.02059,-4
7179,390000,1,2,2,33,0,0,0,0,0,0,45818,144656,148366,99008,69990,71935,100000,6000,3704,2741,3314,2556,0,-54182,138656,144662,96267,66676,69379,-0.13892820512820514,0.35552820512820515,0.3709282051282051,0.24683846153846153,0.17096410256410258,0.1778948717948718,0
7180,180000,1,1,1,42,1,-2,-2,-2,-2,-2,0,0,0,0,0,1031,0,0,0,0,1031,0,1,0,0,0,0,-1031,1031,0.0,0.0,0.0,0.0,-0.005727777777777778,0.005727777777777778,-9
7181,30000,1,3,2,49,0,0,2,0,0,0,27838,30715,29322,28015,28610,28884,3330,0,1148,1195,910,1000,0,24508,30715,28174,26820,27700,27884,0.8169333333333333,1.0238333333333334,0.9391333333333334,0.894,0.9233333333333333,0.9294666666666667,2
7182,340000,1,1,2,26,-1,0,0,0,0,-1,58363,106270,159464,155685,137838,6556,56270,59503,3330,40,6556,16390,0,2093,46767,156134,155645,131282,-9834,0.006155882352941177,0.13755,0.4592176470588235,0.4577794117647059,0.3861235294117647,-0.028923529411764706,-2
7183,160000,0,1,1,58,1,-2,-2,-2,-1,-1,0,0,0,0,4816,0,0,0,0,4816,0,0,1,0,0,0,-4816,4816,0,0.0,0.0,0.0,-0.0301,0.0301,0.0,-7
7184,100000,0,1,2,25,-1,-1,-1,-1,-1,-1,1522,291,1791,2367,4589,291,291,1791,2367,4613,291,291,0,1231,-1500,-576,-2246,4298,0,0.01231,-0.015,-0.00576,-0.02246,0.04298,0.0,-6
7185,200000,0,2,2,33,0,0,0,0,0,0,6195,2645,3416,3916,4248,5068,1300,1000,500,500,1000,1000,0,4895,1645,2916,3416,3248,4068,0.024475,0.008225,0.01458,0.01708,0.01624,0.02034,0
7186,700000,0,1,2,35,-1,0,-1,0,0,0,8277,18282,130130,105055,70896,41509,17599,130370,3381,145,4639,12235,0,-9322,-112088,126749,104910,66257,29274,-0.013317142857142857,-0.1601257142857143,0.18107,0.14987142857142857,0.09465285714285715,0.04182,-2
7187,30000,0,1,2,41,0,0,0,2,2,0,16098,17130,18621,19017,18571,19264,1597,2088,1000,0,1001,380,0,14501,15042,17621,19017,17570,18884,0.48336666666666667,0.5014,0.5873666666666667,0.6339,0.5856666666666667,0.6294666666666666,4
7188,110000,1,2,1,34,0,0,0,0,0,0,24147,25750,27012,27762,32126,37779,2000,2000,1500,5000,6400,0,1,22147,23750,25512,22762,25726,37779,0.20133636363636365,0.2159090909090909,0.23192727272727273,0.20692727272727274,0.23387272727272726,0.34344545454545455,0
7189,50000,1,3,1,50,1,2,2,-2,-2,-2,4446,4166,0,0,0,0,0,0,0,0,0,0,1,4446,4166,0,0,0,0,0.08892,0.08332,0.0,0.0,0.0,0.0,-1
7190,60000,1,1,2,25,0,0,0,0,0,0,16313,10253,7735,6923,7035,9175,5000,3000,2000,2000,4000,800,0,11313,7253,5735,4923,3035,8375,0.18855,0.12088333333333333,0.09558333333333334,0.08205,0.050583333333333334,0.13958333333333334,0
7191,20000,0,2,1,47,1,2,2,0,0,0,8198,6465,5450,4427,2661,895,300,1000,1000,0,0,3386,1,7898,5465,4450,4427,2661,-2491,0.3949,0.27325,0.2225,0.22135,0.13305,-0.12455,5
7192,200000,0,2,1,42,1,2,0,0,2,2,38187,35827,19208,20023,19572,19652,44,1303,1522,0,1099,1339,1,38143,34524,17686,20023,18473,18313,0.190715,0.17262,0.08843,0.100115,0.092365,0.091565,7
7193,50000,1,2,1,22,0,0,0,0,0,2,39843,40662,41971,43020,46150,45288,1762,2000,2020,3800,0,2000,1,38081,38662,39951,39220,46150,43288,0.76162,0.77324,0.79902,0.7844,0.923,0.86576,2
7194,60000,1,2,2,23,0,0,0,0,0,0,48413,52587,54733,55618,56827,58040,5000,3000,1888,2000,2000,3000,0,43413,49587,52845,53618,54827,55040,0.72355,0.82645,0.88075,0.8936333333333333,0.9137833333333333,0.9173333333333333,0
7195,50000,0,4,2,22,0,0,0,0,0,0,6514,7513,9981,10442,10496,10933,1500,3000,1000,600,1000,404,0,5014,4513,8981,9842,9496,10529,0.10028,0.09026,0.17962,0.19684,0.18992,0.21058,0
7196,350000,1,1,1,41,-2,-2,-2,-2,-2,-2,5037,14994,3101,17321,-22,4443,15069,3116,17414,0,4465,9434,1,-10032,11878,-14313,17321,-4487,-4991,-0.028662857142857143,0.03393714285714286,-0.040894285714285716,0.04948857142857143,-0.01282,-0.01426,-12
7197,70000,1,2,2,26,2,2,2,0,0,0,71862,73594,71851,68539,49027,48969,3500,0,3100,1900,2000,1865,0,68362,73594,68751,66639,47027,47104,0.9766,1.0513428571428571,0.9821571428571428,0.9519857142857143,0.6718142857142857,0.6729142857142857,6
7198,50000,0,1,2,34,0,0,2,0,0,2,33499,36742,35875,36501,21764,1723,3800,0,1500,300,0,150,0,29699,36742,34375,36201,21764,1573,0.59398,0.73484,0.6875,0.72402,0.43528,0.03146,4
7199,30000,1,2,1,49,0,0,0,2,0,0,2273,2127,2552,1992,1583,1320,2000,1300,0,0,150,0,1,273,827,2552,1992,1433,1320,0.0091,0.027566666666666666,0.08506666666666667,0.0664,0.047766666666666666,0.044,2
7200,60000,0,1,2,26,-1,-1,0,0,0,0,1870,32603,32432,27976,25862,24571,32607,2119,3008,1006,1042,1001,0,-30737,30484,29424,26970,24820,23570,-0.5122833333333333,0.5080666666666667,0.4904,0.4495,0.4136666666666667,0.3928333333333333,-2
7201,400000,0,1,1,35,-2,-2,-2,-2,-2,-2,0,2720,98,44321,1699,0,2720,98,45869,1699,0,2024,1,-2720,2622,-45771,42622,1699,-2024,-0.0068,0.006555,-0.1144275,0.106555,0.0042475,-0.00506,-12
7202,60000,1,1,2,27,-1,-1,-1,-1,-1,2,3136,1286,1047,-239,1475,1289,1286,1047,0,3000,0,0,0,1850,239,1047,-3239,1475,1289,0.030833333333333334,0.0039833333333333335,0.01745,-0.053983333333333335,0.024583333333333332,0.021483333333333333,-3
7203,260000,0,2,1,44,2,-1,2,-1,0,0,802,4541,3896,119498,109399,111203,4541,0,119498,3500,3983,3579,1,-3739,4541,-115602,115998,105416,107624,-0.01438076923076923,0.017465384615384615,-0.4446230769230769,0.44614615384615386,0.40544615384615385,0.41393846153846153,2
7204,160000,0,1,2,31,1,2,0,0,0,0,56432,55371,56316,59331,60227,61778,0,2000,3500,2000,2200,3000,0,56432,53371,52816,57331,58027,58778,0.3527,0.33356875,0.3301,0.35831875,0.36266875,0.3673625,3
7205,50000,1,2,1,54,0,0,0,0,0,0,50566,49717,49661,49581,49550,48871,2102,2013,1747,2012,2000,5900,1,48464,47704,47914,47569,47550,42971,0.96928,0.95408,0.95828,0.95138,0.951,0.85942,0
7206,30000,1,2,2,26,0,0,2,2,-1,2,8009,10181,10064,150,1150,1000,2316,199,0,1150,0,0,0,5693,9982,10064,-1000,1150,1000,0.18976666666666667,0.3327333333333333,0.3354666666666667,-0.03333333333333333,0.03833333333333333,0.03333333333333333,5
7207,280000,0,2,1,25,-1,-1,0,0,0,0,3863,84601,67765,63628,60860,60316,89295,2192,1899,1673,2125,1511,1,-85432,82409,65866,61955,58735,58805,-0.3051142857142857,0.29431785714285713,0.2352357142857143,0.22126785714285716,0.20976785714285714,0.21001785714285715,-2
7208,50000,1,3,1,46,0,0,0,0,0,2,51207,47915,49073,47889,51139,49000,2162,2284,2100,4200,0,4200,1,49045,45631,46973,43689,51139,44800,0.9809,0.91262,0.93946,0.87378,1.02278,0.896,2
7209,130000,0,2,2,31,0,0,0,0,0,0,5551,6953,8176,8884,9737,11404,1500,1500,1000,1000,2000,2000,0,4051,5453,7176,7884,7737,9404,0.031161538461538463,0.04194615384615385,0.0552,0.06064615384615384,0.059515384615384616,0.07233846153846153,0
7210,80000,1,2,2,26,0,0,-1,-1,-2,-2,24986,23000,1000,0,0,0,2000,1000,0,0,0,0,0,22986,22000,1000,0,0,0,0.287325,0.275,0.0125,0.0,0.0,0.0,-6
7211,150000,1,2,1,51,0,0,0,0,0,0,146018,147598,148393,149709,107862,108623,7000,7600,6000,4000,4100,4300,1,139018,139998,142393,145709,103762,104323,0.9267866666666666,0.93332,0.9492866666666666,0.9713933333333333,0.6917466666666666,0.6954866666666667,0
7212,180000,1,2,2,31,0,0,0,-1,-1,-1,6903,11489,5488,1635,1680,782,8000,3003,1635,1680,782,4374,0,-1097,8486,3853,-45,898,-3592,-0.006094444444444445,0.04714444444444445,0.021405555555555556,-0.00025,0.004988888888888889,-0.019955555555555556,-3
7213,360000,0,1,2,33,-1,-1,-1,-1,-1,-1,845,-4,831,899,1172,820,0,835,899,1172,820,670,0,845,-839,-68,-273,352,150,0.0023472222222222223,-0.0023305555555555558,-0.00018888888888888888,-0.0007583333333333333,0.0009777777777777777,0.0004166666666666667,-6
7214,360000,1,2,1,31,-2,-2,-2,-2,-2,-2,990,990,990,990,990,990,990,990,990,990,990,4970,1,0,0,0,0,0,-3980,0.0,0.0,0.0,0.0,0.0,-0.011055555555555556,-12
7215,120000,1,3,1,49,0,0,0,0,0,0,44244,44075,44823,44683,45537,50293,2000,3000,2000,3000,7000,3000,1,42244,41075,42823,41683,38537,47293,0.3520333333333333,0.34229166666666666,0.35685833333333333,0.3473583333333333,0.32114166666666666,0.39410833333333334,0
7216,270000,1,2,1,38,0,0,0,0,0,0,62263,60654,59464,54715,51796,53256,3000,3000,3019,5000,5000,10000,1,59263,57654,56445,49715,46796,43256,0.2194925925925926,0.21353333333333332,0.20905555555555555,0.18412962962962964,0.1733185185185185,0.1602074074074074,0
7217,90000,0,1,2,23,0,0,0,-1,0,0,4744,7070,0,5398,6360,8292,5757,0,5398,1200,2045,2000,0,-1013,7070,-5398,4198,4315,6292,-0.011255555555555555,0.07855555555555556,-0.059977777777777776,0.04664444444444445,0.04794444444444444,0.0699111111111111,-1
7218,80000,1,1,2,24,-1,-1,-1,-1,0,-1,3940,4115,84,8708,8728,2793,4117,84,8708,20,2795,0,0,-177,4031,-8624,8688,5933,2793,-0.0022125,0.0503875,-0.1078,0.1086,0.0741625,0.0349125,-5
7219,20000,1,1,2,22,0,0,0,0,0,0,18390,19760,18570,17604,11973,9517,2000,1376,1383,1000,455,1500,0,16390,18384,17187,16604,11518,8017,0.8195,0.9192,0.85935,0.8302,0.5759,0.40085,0
7220,260000,1,2,1,36,0,0,0,0,0,0,200593,206178,208601,213025,214931,219001,8500,7000,7508,7500,7595,7000,1,192093,199178,201093,205525,207336,212001,0.7388192307692307,0.7660692307692307,0.7734346153846153,0.7904807692307693,0.7974461538461538,0.8153884615384616,0
7221,80000,1,3,1,54,0,0,0,0,0,0,55498,56368,42486,24500,28900,29400,2000,2000,1600,5000,1000,600,1,53498,54368,40886,19500,27900,28800,0.668725,0.6796,0.511075,0.24375,0.34875,0.36,0
7222,210000,1,1,2,48,1,-2,-2,-1,-1,0,0,0,0,486,836,836,0,0,486,836,0,0,0,0,0,-486,-350,836,836,0.0,0.0,-0.0023142857142857145,-0.0016666666666666668,0.003980952380952381,0.003980952380952381,-5
7223,120000,1,2,1,30,0,0,0,0,0,0,84094,85804,86212,87003,88833,92348,3081,4001,3114,3232,5000,4000,1,81013,81803,83098,83771,83833,88348,0.6751083333333333,0.6816916666666667,0.6924833333333333,0.6980916666666667,0.6986083333333334,0.7362333333333333,0
7224,110000,1,2,2,24,0,0,0,2,0,0,6470,8610,15123,9761,9717,8046,2654,7230,0,463,393,151,0,3816,1380,15123,9298,9324,7895,0.03469090909090909,0.012545454545454545,0.13748181818181818,0.08452727272727273,0.08476363636363636,0.07177272727272727,2
7225,60000,0,2,1,44,0,0,0,0,0,0,58216,60193,57815,50054,27535,22962,3000,2488,2000,1000,2000,3000,1,55216,57705,55815,49054,25535,19962,0.9202666666666667,0.96175,0.93025,0.8175666666666667,0.4255833333333333,0.3327,0
7226,50000,1,3,1,37,0,0,0,0,0,0,39804,41106,41843,42839,43690,44232,1964,1701,1697,1548,1620,1774,1,37840,39405,40146,41291,42070,42458,0.7568,0.7881,0.80292,0.82582,0.8414,0.84916,0
7227,30000,1,3,1,56,0,0,0,0,0,0,29261,29960,28316,28966,29542,30163,1500,1790,1440,1016,1055,1188,1,27761,28170,26876,27950,28487,28975,0.9253666666666667,0.939,0.8958666666666667,0.9316666666666666,0.9495666666666667,0.9658333333333333,0
7228,220000,0,2,1,41,-1,-1,-1,-1,-1,-1,8840,1369,5924,1759,1824,7022,6643,5924,1759,1824,7022,2515,1,2197,-4555,4165,-65,-5198,4507,0.009986363636363637,-0.020704545454545455,0.01893181818181818,-0.00029545454545454547,-0.023627272727272726,0.020486363636363636,-6
7229,20000,1,1,2,25,1,-1,-1,-1,-1,-1,0,891,789,0,728,169,891,789,0,728,169,0,0,-891,102,789,-728,559,169,-0.04455,0.0051,0.03945,-0.0364,0.02795,0.00845,-4
7230,240000,0,4,1,50,0,0,0,0,0,0,236470,242059,235353,240001,190904,193710,9560,9000,8790,8013,8125,8000,1,226910,233059,226563,231988,182779,185710,0.9454583333333333,0.9710791666666667,0.9440125,0.9666166666666667,0.7615791666666667,0.7737916666666667,0
7231,50000,0,3,1,26,1,2,2,0,0,0,14655,15688,13400,13596,13861,14255,1600,0,2000,2000,2000,2000,1,13055,15688,11400,11596,11861,12255,0.2611,0.31376,0.228,0.23192,0.23722,0.2451,5
7232,80000,1,2,2,23,-1,0,0,0,0,0,57314,58489,50452,51573,49061,33931,2145,2000,2012,2049,2008,1217,0,55169,56489,48440,49524,47053,32714,0.6896125,0.7061125,0.6055,0.61905,0.5881625,0.408925,-1
7233,250000,1,3,1,39,0,0,0,0,0,0,18376,20070,21428,22757,24382,28768,2000,2000,2000,2000,5000,4000,1,16376,18070,19428,20757,19382,24768,0.065504,0.07228,0.077712,0.083028,0.077528,0.099072,0
7234,10000,0,2,2,25,-1,-1,-1,-1,-1,-1,1261,1261,390,390,390,0,1261,390,390,390,0,780,0,0,871,0,0,390,-780,0.0,0.0871,0.0,0.0,0.039,-0.078,-6
7235,30000,1,2,2,42,3,2,2,0,-1,-1,2231,3048,2845,1630,12037,12933,1000,12,0,12037,1100,0,0,1231,3036,2845,-10407,10937,12933,0.04103333333333333,0.1012,0.09483333333333334,-0.3469,0.36456666666666665,0.4311,5
7236,210000,0,1,1,42,0,0,0,0,0,0,103772,95228,87678,79254,71836,63675,4000,4000,3000,4000,3000,3000,1,99772,91228,84678,75254,68836,60675,0.4751047619047619,0.4344190476190476,0.40322857142857144,0.358352380952381,0.3277904761904762,0.2889285714285714,0
7237,50000,0,2,2,48,0,0,0,0,0,0,44385,45637,46815,16927,17263,17628,1992,2170,1282,618,643,1000,0,42393,43467,45533,16309,16620,16628,0.84786,0.86934,0.91066,0.32618,0.3324,0.33256,0
7238,180000,1,2,1,28,-1,-1,-1,-1,-1,-1,1206,661,1503,1379,1216,1440,661,1512,1379,1216,1440,316,1,545,-851,124,163,-224,1124,0.0030277777777777777,-0.004727777777777778,0.0006888888888888888,0.0009055555555555556,-0.0012444444444444445,0.006244444444444445,-6
7239,90000,1,2,1,51,0,0,0,0,0,0,12822,10944,12255,12192,12448,12895,1188,1499,436,452,654,455,1,11634,9445,11819,11740,11794,12440,0.12926666666666667,0.10494444444444445,0.13132222222222223,0.13044444444444445,0.13104444444444444,0.13822222222222222,0
7240,280000,1,2,1,45,0,0,0,0,0,0,159633,149747,138933,128216,216598,103119,7000,6500,6500,3994,4000,3500,1,152633,143247,132433,124222,212598,99619,0.5451178571428571,0.5115964285714286,0.472975,0.44365,0.7592785714285715,0.3557821428571429,0
7241,160000,0,1,1,42,2,2,0,0,2,2,14137,13613,14634,16532,15969,17701,0,1247,2145,0,2000,0,1,14137,12366,12489,16532,13969,17701,0.08835625,0.0772875,0.07805625,0.103325,0.08730625,0.11063125,8
7242,240000,1,1,2,27,0,0,-2,-2,-2,-2,118175,0,0,0,0,0,0,0,0,0,0,0,0,118175,0,0,0,0,0,0.4923958333333333,0.0,0.0,0.0,0.0,0.0,-8
7243,190000,0,3,2,26,0,0,0,2,0,0,124896,100078,102801,98753,98727,99484,4633,8858,12,3588,3543,3700,0,120263,91220,102789,95165,95184,95784,0.6329631578947369,0.48010526315789476,0.5409947368421053,0.5008684210526316,0.5009684210526316,0.5041263157894736,2
7244,100000,0,2,1,35,4,4,3,2,2,2,82348,82156,83318,81380,83710,88057,1700,3100,0,3800,5900,3200,1,80648,79056,83318,77580,77810,84857,0.80648,0.79056,0.83318,0.7758,0.7781,0.84857,17
7245,150000,1,1,1,37,1,-1,2,2,-2,-1,0,1505,1333,0,0,1930,1505,0,0,0,1930,0,1,-1505,1505,1333,0,-1930,1930,-0.010033333333333333,0.010033333333333333,0.008886666666666666,0.0,-0.012866666666666667,0.012866666666666667,1
7246,130000,1,2,2,26,0,0,0,0,-1,0,130318,131351,131352,121931,61755,61453,4700,5108,3860,82367,3041,2000,0,125618,126243,127492,39564,58714,59453,0.9662923076923077,0.9711,0.9807076923076923,0.30433846153846156,0.45164615384615386,0.4573307692307692,-1
7247,470000,0,2,1,31,0,0,0,0,0,0,12281,13323,13149,15824,19424,27522,2014,3000,3000,4000,8098,3000,1,10267,10323,10149,11824,11326,24522,0.02184468085106383,0.021963829787234043,0.021593617021276594,0.025157446808510637,0.02409787234042553,0.05217446808510638,0
7248,20000,0,2,1,42,0,0,2,0,0,2,16070,19107,18506,18802,20199,19394,3300,0,900,1700,0,253,1,12770,19107,17606,17102,20199,19141,0.6385,0.95535,0.8803,0.8551,1.00995,0.95705,4
7249,50000,0,3,2,54,-2,-2,-2,-2,-2,-2,0,0,0,0,0,0,0,0,0,0,0,0,0,0,0,0,0,0,0,0.0,0.0,0.0,0.0,0.0,0.0,-12
7250,60000,0,2,2,30,0,0,0,0,0,0,57041,58268,59568,61298,29587,27267,2148,2303,2669,1032,1000,1300,0,54893,55965,56899,60266,28587,25967,0.9148833333333334,0.93275,0.9483166666666667,1.0044333333333333,0.47645,0.43278333333333335,0
7251,10000,1,2,1,49,0,0,0,0,0,0,3100,4116,5280,5543,5605,5717,1073,1237,500,300,205,300,1,2027,2879,4780,5243,5400,5417,0.2027,0.2879,0.478,0.5243,0.54,0.5417,0
7252,270000,1,2,2,42,-1,-1,-1,-2,-2,-2,12263,10025,0,0,0,0,10025,0,0,0,0,0,0,2238,10025,0,0,0,0,0.008288888888888889,0.03712962962962963,0.0,0.0,0.0,0.0,-9
7253,90000,0,1,2,27,1,-2,-2,-2,-2,-2,0,0,0,0,0,0,0,0,0,0,0,0,0,0,0,0,0,0,0,0.0,0.0,0.0,0.0,0.0,0.0,-9
7254,70000,1,3,2,25,2,0,0,0,0,0,70963,71056,70850,70823,71006,70828,2527,2615,2500,3000,2600,3000,0,68436,68441,68350,67823,68406,67828,0.9776571428571429,0.9777285714285714,0.9764285714285714,0.9689,0.9772285714285714,0.9689714285714286,2
7255,90000,1,1,1,50,0,0,0,0,0,0,58979,64004,65298,65233,66717,67562,6000,3000,2300,2500,3000,2500,1,52979,61004,62998,62733,63717,65062,0.5886555555555556,0.6778222222222222,0.6999777777777778,0.6970333333333333,0.7079666666666666,0.7229111111111111,0
7256,320000,0,1,2,30,-2,-2,-2,-2,-2,-2,5562,6061,3829,933,5446,8523,6091,3848,937,5473,8565,0,0,-529,2213,2892,-4540,-3119,8523,-0.001653125,0.006915625,0.0090375,-0.0141875,-0.009746875,0.026634375,-12
7257,80000,0,2,2,23,0,-1,2,-1,-1,-2,25992,904,68,232,-604,-440,1000,0,1000,0,1000,0,0,24992,904,-932,232,-1604,-440,0.3124,0.0113,-0.01165,0.0029,-0.02005,-0.0055,-3
7258,220000,1,2,2,32,0,0,0,0,0,0,150393,48060,30490,44071,55405,63422,2349,3008,20000,20004,20000,2000,0,148044,45052,10490,24067,35405,61422,0.6729272727272727,0.20478181818181818,0.04768181818181818,0.10939545454545455,0.16093181818181818,0.2791909090909091,0
7259,70000,1,1,2,36,0,0,0,0,0,0,75021,71101,73831,46898,48686,47171,2893,4231,8000,2500,1675,2000,0,72128,66870,65831,44398,47011,45171,1.0304,0.9552857142857143,0.9404428571428571,0.6342571428571429,0.6715857142857142,0.6453,0
7260,50000,0,1,2,24,2,0,0,2,0,0,5524,6474,8896,7088,7109,6898,1500,2700,0,500,500,500,0,4024,3774,8896,6588,6609,6398,0.08048,0.07548,0.17792,0.13176,0.13218,0.12796,4
7261,280000,1,2,1,36,-2,-2,-2,-2,-2,-2,2874,2874,2874,2874,2874,2854,2888,2888,2888,2888,2868,7029,1,-14,-14,-14,-14,6,-4175,-5e-05,-5e-05,-5e-05,-5e-05,2.1428571428571428e-05,-0.014910714285714286,-12
7262,360000,1,1,1,40,-1,-1,-2,-1,-1,-1,10210,-1814,-11035,12319,6050,2125,0,0,32319,6050,2125,35860,1,10210,-1814,-43354,6269,3925,-33735,0.02836111111111111,-0.005038888888888889,-0.12042777777777777,0.01741388888888889,0.010902777777777779,-0.09370833333333334,-7
7263,240000,0,3,1,45,0,0,0,0,0,0,135367,135091,133047,132264,130372,133170,6300,4800,4737,4667,4900,4849,1,129067,130291,128310,127597,125472,128321,0.5377791666666667,0.5428791666666667,0.534625,0.5316541666666666,0.5228,0.5346708333333333,0
7264,170000,1,2,1,45,0,0,0,0,0,2,130668,121100,123414,114180,122332,120270,5900,5800,6000,11600,0,9400,1,124768,115300,117414,102580,122332,110870,0.7339294117647058,0.678235294117647,0.6906705882352941,0.6034117647058823,0.7196,0.6521764705882352,2
7265,30000,0,2,2,39,1,2,2,0,0,0,1623,2441,3244,4034,4812,6210,1000,1000,1000,1000,1500,0,0,623,1441,2244,3034,3312,6210,0.020766666666666666,0.04803333333333333,0.0748,0.10113333333333334,0.1104,0.207,5
7266,60000,0,3,1,57,0,0,0,0,0,0,20865,16590,10816,6956,2489,0,1262,1003,0,1050,0,0,1,19603,15587,10816,5906,2489,0,0.32671666666666666,0.2597833333333333,0.18026666666666666,0.09843333333333333,0.04148333333333333,0.0,0
7267,500000,1,2,1,37,0,0,0,0,0,0,58448,60182,67153,64079,64120,61295,5000,10000,5169,2322,5174,0,1,53448,50182,61984,61757,58946,61295,0.106896,0.100364,0.123968,0.123514,0.117892,0.12259,0
7268,50000,1,2,2,36,2,2,2,2,0,0,50817,50523,51921,50767,48488,49503,2000,2500,0,1721,1782,1806,0,48817,48023,51921,49046,46706,47697,0.97634,0.96046,1.03842,0.98092,0.93412,0.95394,8
7269,120000,1,1,2,29,0,0,0,0,0,0,111625,110488,107488,97021,86283,87345,4012,4000,5000,3000,3300,3010,0,107613,106488,102488,94021,82983,84335,0.896775,0.8874,0.8540666666666666,0.7835083333333334,0.691525,0.7027916666666667,0
7270,50000,1,3,2,25,0,0,0,0,0,0,6954,6032,6529,7533,7857,4424,2161,1000,1004,3004,1005,2006,0,4793,5032,5525,4529,6852,2418,0.09586,0.10064,0.1105,0.09058,0.13704,0.04836,0
7271,470000,1,1,1,39,-1,0,0,0,0,0,235490,125853,143646,113422,96921,94405,25853,20745,13422,6921,5645,6114,1,209637,105108,130224,106501,91276,88291,0.446036170212766,0.2236340425531915,0.2770723404255319,0.22659787234042553,0.19420425531914895,0.1878531914893617,-1
7272,130000,1,1,1,38,0,0,0,-2,-2,-2,64942,66775,0,0,0,0,4000,0,0,0,0,0,1,60942,66775,0,0,0,0,0.4687846153846154,0.5136538461538461,0.0,0.0,0.0,0.0,-6
7273,160000,0,3,1,51,0,0,0,-2,-1,-1,4042,4338,-1801,-5513,743,1012,1000,0,0,6256,1050,1000,1,3042,4338,-1801,-11769,-307,12,0.0190125,0.0271125,-0.01125625,-0.07355625,-0.00191875,7.5e-05,-4
7274,230000,1,1,1,39,-2,-2,-2,-2,-2,-2,970,1475,1636,1149,334,459,1483,1640,1152,335,460,553,1,-513,-165,484,814,-126,-94,-0.0022304347826086956,-0.0007173913043478261,0.0021043478260869566,0.0035391304347826085,-0.0005478260869565217,-0.00040869565217391306,-12
7275,200000,1,1,1,29,-1,-1,-1,-1,-1,-1,188,2210,2451,3043,1542,0,2215,2451,3043,1542,0,0,1,-2027,-241,-592,1501,1542,0,-0.010135,-0.001205,-0.00296,0.007505,0.00771,0.0,-6
7276,300000,0,1,1,33,0,0,0,0,0,0,31808,22743,22396,21055,14714,7323,1514,1216,3127,3046,2011,142,1,30294,21527,19269,18009,12703,7181,0.10098,0.07175666666666666,0.06423,0.06003,0.04234333333333333,0.023936666666666665,0
7277,30000,1,2,2,22,0,0,0,0,0,0,30190,28985,28724,29357,30188,26316,1532,2169,1000,1200,2000,1500,0,28658,26816,27724,28157,28188,24816,0.9552666666666667,0.8938666666666667,0.9241333333333334,0.9385666666666667,0.9396,0.8272,0
7278,160000,1,3,1,36,-2,-2,-2,-2,-2,-2,170,1062,0,0,0,0,1062,0,0,0,0,0,1,-892,1062,0,0,0,0,-0.005575,0.0066375,0.0,0.0,0.0,0.0,-12
7279,120000,1,2,2,40,0,0,0,-2,-2,-2,4180,5100,0,0,0,0,1000,0,0,0,0,0,0,3180,5100,0,0,0,0,0.0265,0.0425,0.0,0.0,0.0,0.0,-6
7280,100000,0,2,2,34,2,2,2,2,2,2,32685,36546,37152,36258,38512,37741,4400,1500,0,3000,0,4000,0,28285,35046,37152,33258,38512,33741,0.28285,0.35046,0.37152,0.33258,0.38512,0.33741,12
7281,20000,0,3,1,52,2,0,0,0,0,0,16290,17301,19012,19959,19962,19988,1289,2000,1300,658,680,1000,1,15001,15301,17712,19301,19282,18988,0.75005,0.76505,0.8856,0.96505,0.9641,0.9494,2
7282,20000,1,2,2,46,-1,-1,-1,0,0,-2,189,2249,3551,6180,0,0,2249,3551,5000,0,0,0,0,-2060,-1302,-1449,6180,0,0,-0.103,-0.0651,-0.07245,0.309,0.0,0.0,-5
7283,30000,0,2,1,32,0,0,0,2,0,0,22503,24802,29367,28108,26717,11693,3000,5000,0,1003,1000,1000,1,19503,19802,29367,27105,25717,10693,0.6501,0.6600666666666667,0.9789,0.9035,0.8572333333333333,0.3564333333333333,2
7284,150000,1,2,1,39,-1,0,0,0,0,-1,12365,58266,40921,24053,25856,77913,53444,20144,14182,16819,78287,15679,1,-41079,38122,26739,7234,-52431,62234,-0.27386,0.2541466666666667,0.17826,0.04822666666666667,-0.34954,0.41489333333333334,-2
7285,200000,1,2,3,57,0,0,0,0,0,0,79761,79515,80592,86216,88071,90842,3500,3000,7000,3400,4400,6500,0,76261,76515,73592,82816,83671,84342,0.381305,0.382575,0.36796,0.41408,0.418355,0.42171,0
7286,100000,0,1,2,34,-1,-1,-1,-1,0,0,43128,6164,3775,22690,21288,9289,6200,3775,22690,0,0,62588,0,36928,2389,-18915,22690,21288,-53299,0.36928,0.02389,-0.18915,0.2269,0.21288,-0.53299,-4
7287,500000,1,1,1,49,-2,-2,-2,-2,-2,-2,27936,2305,9073,5714,31868,3663,2305,9083,6105,31868,3663,8110,1,25631,-6778,2968,-26154,28205,-4447,0.051262,-0.013556,0.005936,-0.052308,0.05641,-0.008894,-12
7288,30000,1,2,1,51,1,2,3,2,2,0,16490,18908,18321,19618,19008,19301,3000,0,1900,0,750,750,1,13490,18908,16421,19618,18258,18551,0.44966666666666666,0.6302666666666666,0.5473666666666667,0.6539333333333334,0.6086,0.6183666666666666,10
7289,350000,0,2,1,38,1,2,0,0,2,0,70845,69318,71301,75129,71313,68046,0,3500,5500,0,2500,2000,1,70845,65818,65801,75129,68813,66046,0.2024142857142857,0.18805142857142856,0.18800285714285714,0.21465428571428571,0.19660857142857144,0.18870285714285714,5
7290,50000,1,2,2,23,0,0,0,2,0,0,32206,65339,33329,20935,15809,16133,1630,6348,0,420,593,500,0,30576,58991,33329,20515,15216,15633,0.61152,1.17982,0.66658,0.4103,0.30432,0.31266,2
7291,190000,1,2,1,33,1,-2,-2,-2,-2,-2,-2500,-3000,-3000,-3000,-3000,-3000,0,0,0,0,0,0,1,-2500,-3000,-3000,-3000,-3000,-3000,-0.013157894736842105,-0.015789473684210527,-0.015789473684210527,-0.015789473684210527,-0.015789473684210527,-0.015789473684210527,-9
7292,10000,0,2,2,29,0,0,0,-1,0,0,9363,9990,-10,6390,6682,7271,1000,0,6400,400,700,500,0,8363,9990,-6410,5990,5982,6771,0.8363,0.999,-0.641,0.599,0.5982,0.6771,-1
7293,150000,1,3,1,49,-1,-1,-1,-1,0,-1,3114,23946,7838,7642,8009,10800,23979,7838,7642,367,10800,5068,1,-20865,16108,196,7275,-2791,5732,-0.1391,0.10738666666666667,0.0013066666666666667,0.0485,-0.018606666666666667,0.038213333333333335,-5
7294,430000,0,1,1,42,-2,-2,-2,-2,-2,-2,11362,11461,5741,8897,1350,10184,11461,5745,8935,1350,10184,4190,1,-99,5716,-3194,7547,-8834,5994,-0.0002302325581395349,0.013293023255813953,-0.007427906976744186,0.017551162790697676,-0.020544186046511627,0.01393953488372093,-12
7295,160000,1,3,1,46,-2,-2,-2,-2,-2,-2,-510,-520,0,-390,780,0,380,2000,0,101170,0,0,1,-890,-2520,0,-101560,780,0,-0.0055625,-0.01575,0.0,-0.63475,0.004875,0.0,-12
7296,230000,1,2,1,43,0,0,0,0,0,0,7806,8392,8967,8729,10816,15893,1295,1300,468,2816,5893,5977,1,6511,7092,8499,5913,4923,9916,0.028308695652173914,0.03083478260869565,0.03695217391304348,0.025708695652173912,0.021404347826086956,0.04311304347826087,0
7297,130000,1,2,1,43,-1,-1,-1,-1,-1,-1,2292,6776,2811,3589,11151,1543,6776,2811,3589,11351,1543,1109,1,-4484,3965,-778,-7762,9608,434,-0.03449230769230769,0.0305,-0.005984615384615384,-0.05970769230769231,0.07390769230769231,0.0033384615384615384,-6
7298,50000,0,4,2,26,1,-2,-2,-2,-2,-2,0,0,0,0,0,0,0,0,0,0,0,0,0,0,0,0,0,0,0,0.0,0.0,0.0,0.0,0.0,0.0,-9
7299,170000,0,3,1,29,0,0,0,0,0,0,165027,168990,172307,35234,32869,33862,7200,7500,1200,1200,1500,1300,1,157827,161490,171107,34034,31369,32562,0.9283941176470588,0.9499411764705883,1.0065117647058823,0.2002,0.1845235294117647,0.19154117647058824,0
7300,100000,1,3,1,42,0,0,0,0,0,0,58543,54902,54590,53037,54100,53889,2004,1966,1884,1903,1940,2000,1,56539,52936,52706,51134,52160,51889,0.56539,0.52936,0.52706,0.51134,0.5216,0.51889,0
7301,350000,1,3,1,38,-2,-2,-1,0,0,0,362,792,3015,6980,8762,7532,792,3019,4580,4000,284,1000,1,-430,-2227,-1565,2980,8478,6532,-0.0012285714285714285,-0.006362857142857143,-0.0044714285714285715,0.008514285714285714,0.024222857142857143,0.018662857142857144,-5
7302,90000,1,1,2,27,0,0,0,0,0,0,85822,83206,74030,70198,71330,65479,3327,3471,3199,2964,2718,2087,0,82495,79735,70831,67234,68612,63392,0.9166111111111112,0.8859444444444444,0.7870111111111111,0.7470444444444444,0.7623555555555556,0.7043555555555555,0
7303,110000,0,1,2,26,0,0,0,0,0,0,64767,67724,49104,51202,50289,50528,6000,2000,3000,2000,2000,3000,0,58767,65724,46104,49202,48289,47528,0.5342454545454546,0.5974909090909091,0.41912727272727274,0.4472909090909091,0.4389909090909091,0.4320727272727273,0
7304,290000,1,1,2,26,-1,-1,-2,-1,-1,-1,32126,10823,5248,32307,28492,1799,10884,5275,32563,29143,1809,11384,0,21242,5548,-27315,3164,26683,-9585,0.07324827586206896,0.01913103448275862,-0.09418965517241379,0.010910344827586207,0.0920103448275862,-0.03305172413793103,-7
7305,170000,1,2,2,26,0,0,0,0,0,0,30005,30621,30308,30163,29999,29973,1842,1708,1163,1199,1173,952,0,28163,28913,29145,28964,28826,29021,0.16566470588235294,0.1700764705882353,0.17144117647058824,0.1703764705882353,0.16956470588235295,0.17071176470588234,0
7306,10000,1,2,1,43,0,0,0,0,0,0,4834,1803,2819,3828,3905,4023,1038,1054,1063,140,181,80,1,3796,749,1756,3688,3724,3943,0.3796,0.0749,0.1756,0.3688,0.3724,0.3943,0
7307,30000,1,3,3,52,1,2,2,2,-1,-1,10033,6486,7064,2890,2500,3280,0,3192,0,2500,3280,0,0,10033,3294,7064,390,-780,3280,0.33443333333333336,0.1098,0.23546666666666666,0.013,-0.026,0.10933333333333334,5
7308,50000,0,2,2,23,0,0,0,0,0,0,49798,50795,50150,9658,10011,9345,2193,2040,330,492,332,500,0,47605,48755,49820,9166,9679,8845,0.9521,0.9751,0.9964,0.18332,0.19358,0.1769,0
7309,20000,1,1,1,30,2,2,2,0,0,0,5766,7511,7678,7318,7458,7598,2000,500,0,500,500,0,1,3766,7011,7678,6818,6958,7598,0.1883,0.35055,0.3839,0.3409,0.3479,0.3799,6
7310,310000,1,1,1,37,-2,-2,-2,-2,-2,-2,123,123,0,123,0,0,123,0,123,0,0,0,1,0,123,-123,123,0,0,0.0,0.0003967741935483871,-0.0003967741935483871,0.0003967741935483871,0.0,0.0,-12
7311,80000,1,2,2,31,0,0,0,0,-1,-1,15633,17536,17495,13198,10287,3275,2302,1774,1000,10287,3295,4122,0,13331,15762,16495,2911,6992,-847,0.1666375,0.197025,0.2061875,0.0363875,0.0874,-0.0105875,-2
7312,250000,0,3,1,46,0,0,0,0,-1,0,55891,59152,20615,13896,79740,70097,21343,1238,1235,79788,2148,18253,1,34548,57914,19380,-65892,77592,51844,0.138192,0.231656,0.07752,-0.263568,0.310368,0.207376,-1
7313,360000,0,2,1,49,1,2,-1,-1,0,-1,3295,1645,1656,1866,1473,1080,0,1656,1866,1080,1080,0,1,3295,-11,-210,786,393,1080,0.009152777777777777,-3.0555555555555554e-05,-0.0005833333333333334,0.002183333333333333,0.0010916666666666666,0.003,0
7314,500000,0,1,1,30,-1,-1,-1,-2,-2,-2,6049,2500,0,0,0,0,2500,0,0,0,0,0,1,3549,2500,0,0,0,0,0.007098,0.005,0.0,0.0,0.0,0.0,-9
7315,180000,0,2,1,40,1,2,0,0,0,0,172584,167622,130083,64398,62277,58216,1000,4052,2293,2295,2400,2110,1,171584,163570,127790,62103,59877,56106,0.9532444444444444,0.9087222222222222,0.7099444444444445,0.3450166666666667,0.33265,0.3117,3
7316,50000,1,2,1,45,0,0,0,0,0,0,49375,45390,46210,46549,20084,20264,1721,2321,1660,3000,1004,1003,1,47654,43069,44550,43549,19080,19261,0.95308,0.86138,0.891,0.87098,0.3816,0.38522,0
7317,90000,1,2,1,42,-1,-1,-2,-2,-1,-1,390,0,-390,-780,780,0,0,0,0,1560,0,0,1,390,0,-390,-2340,780,0,0.004333333333333333,0.0,-0.004333333333333333,-0.026,0.008666666666666666,0.0,-8
7318,180000,1,2,2,31,0,0,0,0,0,0,69502,69878,71866,72140,60885,32397,2500,3300,2140,1885,4000,95000,0,67002,66578,69726,70255,56885,-62603,0.37223333333333336,0.3698777777777778,0.3873666666666667,0.39030555555555557,0.3160277777777778,-0.34779444444444446,0
7319,200000,0,1,2,26,-2,-2,-2,-2,-2,-2,-4,909,6737,6012,5167,3132,913,6737,6031,5167,3132,2290,0,-917,-5828,706,845,2035,842,-0.004585,-0.02914,0.00353,0.004225,0.010175,0.00421,-12
7320,490000,1,1,1,53,-2,-2,-2,-2,-2,-2,1700,8913,0,400,4186,6205,8913,0,400,4186,6205,2025,1,-7213,8913,-400,-3786,-2019,4180,-0.014720408163265307,0.018189795918367346,-0.0008163265306122449,-0.007726530612244898,-0.0041204081632653065,0.00853061224489796,-12
7321,300000,1,1,2,30,-1,-1,-1,-1,-1,-1,6045,7151,4790,3145,4274,0,7157,4790,3145,4274,0,2215,0,-1112,2361,1645,-1129,4274,-2215,-0.0037066666666666667,0.00787,0.005483333333333333,-0.0037633333333333334,0.014246666666666666,-0.007383333333333334,-6
7322,210000,0,2,1,47,1,-1,-1,-2,-2,-2,0,296,-204,-204,-204,-204,296,0,0,0,0,0,1,-296,296,-204,-204,-204,-204,-0.0014095238095238095,0.0014095238095238095,-0.0009714285714285714,-0.0009714285714285714,-0.0009714285714285714,-0.0009714285714285714,-7
7323,130000,0,1,2,36,1,2,2,2,0,0,128190,131094,132549,128646,100845,101545,6500,5000,0,3512,3606,3699,0,121690,126094,132549,125134,97239,97846,0.936076923076923,0.9699538461538462,1.0196076923076922,0.9625692307692307,0.7479923076923077,0.7526615384615385,7
7324,320000,1,1,2,30,0,0,0,0,0,0,60947,62660,22693,23705,24012,24703,2868,1681,1693,1000,1077,1336,0,58079,60979,21000,22705,22935,23367,0.181496875,0.190559375,0.065625,0.070953125,0.071671875,0.073021875,0
7325,100000,1,2,2,23,0,-1,-1,0,0,-1,11876,380,601,221,-159,567,380,601,0,581,1687,1542,0,11496,-221,601,-360,-1846,-975,0.11496,-0.00221,0.00601,-0.0036,-0.01846,-0.00975,-3
7326,310000,1,2,2,33,0,0,0,0,0,0,110786,115540,117674,108103,114721,105624,6555,6000,3272,15874,4182,15694,0,104231,109540,114402,92229,110539,89930,0.3362290322580645,0.35335483870967743,0.36903870967741936,0.2975129032258064,0.3565774193548387,0.2900967741935484,0
7327,500000,1,1,1,39,0,0,0,0,0,-1,39823,61597,52210,27843,28926,11931,30006,23016,566,22323,11931,10683,1,9817,38581,51644,5520,16995,1248,0.019634,0.077162,0.103288,0.01104,0.03399,0.002496,-1
7328,480000,0,4,2,49,-2,-2,-2,-2,-2,-2,7174,0,0,0,0,0,0,0,0,0,0,0,0,7174,0,0,0,0,0,0.014945833333333334,0.0,0.0,0.0,0.0,0.0,-12
7329,150000,1,1,1,39,1,2,2,2,2,2,80762,77506,75239,71245,69214,24036,0,3700,0,2000,0,2000,1,80762,73806,75239,69245,69214,22036,0.5384133333333333,0.49204,0.5015933333333333,0.46163333333333334,0.46142666666666665,0.14690666666666666,11
7330,150000,0,2,2,37,0,0,0,0,0,0,71341,62432,56091,58919,60363,40448,4117,4002,5000,1925,5316,5000,0,67224,58430,51091,56994,55047,35448,0.44816,0.38953333333333334,0.34060666666666667,0.37996,0.36698,0.23632,0
7331,80000,0,2,2,38,0,0,0,0,0,0,73171,76815,64814,66796,41622,46002,5000,4000,4000,2000,5000,1588,0,68171,72815,60814,64796,36622,44414,0.8521375,0.9101875,0.760175,0.80995,0.457775,0.555175,0
7332,210000,0,1,1,31,0,0,0,0,0,0,140994,140224,141553,143811,144587,146802,5100,5201,5160,5200,5300,6150,1,135894,135023,136393,138611,139287,140652,0.6471142857142858,0.6429666666666667,0.6494904761904762,0.660052380952381,0.6632714285714286,0.6697714285714286,0
7333,300000,1,3,2,48,1,3,2,-1,0,-1,-2,779,390,769,772,1722,781,1,769,3,1730,0,0,-783,778,-379,766,-958,1722,-0.00261,0.0025933333333333333,-0.0012633333333333333,0.0025533333333333332,-0.003193333333333333,0.00574,4
7334,50000,1,2,1,31,1,2,0,0,0,0,34644,33669,19124,18117,18496,18880,0,1597,649,671,691,700,1,34644,32072,18475,17446,17805,18180,0.69288,0.64144,0.3695,0.34892,0.3561,0.3636,3
7335,250000,1,1,1,37,0,0,0,0,0,0,13504,13486,14261,7019,7062,7242,1267,1310,232,238,279,122,1,12237,12176,14029,6781,6783,7120,0.048948,0.048704,0.056116,0.027124,0.027132,0.02848,0
7336,420000,1,1,1,32,0,0,0,0,0,0,45465,46232,31233,22768,22588,22172,1706,1401,804,852,0,8100,1,43759,44831,30429,21916,22588,14072,0.10418809523809523,0.10674047619047619,0.07245,0.05218095238095238,0.05378095238095238,0.033504761904761905,0
7337,50000,1,2,2,23,0,0,0,2,2,-2,26001,16982,19313,18700,0,0,1282,2613,0,0,0,0,0,24719,14369,19313,18700,0,0,0.49438,0.28738,0.38626,0.374,0.0,0.0,2
7338,280000,0,1,2,33,-1,-1,0,0,0,0,8814,151643,153190,147589,149291,151357,151650,5546,6007,5507,6007,4184,0,-142836,146097,147183,142082,143284,147173,-0.5101285714285714,0.521775,0.5256535714285714,0.5074357142857143,0.5117285714285714,0.5256178571428571,-2
7339,20000,1,3,2,27,0,0,0,0,0,0,20288,20293,20196,19777,20130,19350,1500,1400,2000,3000,1000,1000,0,18788,18893,18196,16777,19130,18350,0.9394,0.94465,0.9098,0.83885,0.9565,0.9175,0
7340,180000,0,1,2,34,-2,-2,-2,-2,-2,-2,0,0,0,0,0,0,0,0,0,0,0,0,0,0,0,0,0,0,0,0.0,0.0,0.0,0.0,0.0,0.0,-12
7341,350000,1,2,2,27,0,0,0,0,0,0,16022,17059,17772,18127,18536,19224,1600,1300,650,700,1000,750,0,14422,15759,17122,17427,17536,18474,0.04120571428571428,0.04502571428571429,0.04892,0.04979142857142857,0.05010285714285714,0.052782857142857145,0
7342,60000,1,3,1,32,0,0,0,0,0,0,63354,65299,67087,27121,26316,26476,3000,3490,1794,1311,953,1390,1,60354,61809,65293,25810,25363,25086,1.0059,1.03015,1.0882166666666666,0.43016666666666664,0.4227166666666667,0.4181,0
7343,20000,0,1,2,37,2,2,2,2,2,0,14688,16827,17251,17672,17250,18305,2700,1000,1000,0,1500,1500,0,11988,15827,16251,17672,15750,16805,0.5994,0.79135,0.81255,0.8836,0.7875,0.84025,10
7344,340000,1,2,1,30,0,0,0,0,0,0,338624,338272,339191,325675,285417,284834,15000,15000,15000,15000,12000,12500,1,323624,323272,324191,310675,273417,272334,0.9518352941176471,0.9508,0.9535029411764706,0.91375,0.8041676470588235,0.8009823529411765,0
7345,260000,1,1,2,36,-2,-2,-2,-2,-1,-1,1891,2438,2280,746,1989,1668,2637,2280,746,1989,1668,2605,0,-746,158,1534,-1243,321,-937,-0.0028692307692307693,0.0006076923076923077,0.0059,-0.004780769230769231,0.0012346153846153846,-0.0036038461538461537,-10
7346,200000,0,2,1,34,-1,-1,-1,-1,-1,0,170,1512,-15,1067,2176,3378,1525,0,1082,2179,2013,165,1,-1355,1512,-1097,-1112,163,3213,-0.006775,0.00756,-0.005485,-0.00556,0.000815,0.016065,-5
7347,140000,1,1,2,27,0,0,0,0,0,0,135249,138577,141555,110852,113639,95052,5500,5700,4200,4700,3800,4000,0,129749,132877,137355,106152,109839,91052,0.9267785714285715,0.9491214285714286,0.9811071428571428,0.7582285714285715,0.7845642857142857,0.6503714285714286,0
7348,150000,1,3,1,45,2,2,2,0,0,0,179441,169947,153522,150779,49198,50277,7333,4,4104,15000,2000,2200,1,172108,169943,149418,135779,47198,48077,1.1473866666666668,1.1329533333333333,0.99612,0.9051933333333333,0.31465333333333334,0.3205133333333333,6
7349,260000,1,1,1,31,-1,-1,0,0,0,0,555,8078,27201,27879,28420,39206,8078,20000,2000,2000,12000,0,1,-7523,-11922,25201,25879,16420,39206,-0.028934615384615385,-0.045853846153846155,0.09692692307692308,0.09953461538461539,0.06315384615384616,0.1507923076923077,-2
7350,20000,0,2,1,45,1,2,0,0,0,-2,20011,10753,10853,10670,-120,-120,0,10600,800,0,0,0,1,20011,153,10053,10670,-120,-120,1.00055,0.00765,0.50265,0.5335,-0.006,-0.006,1
7351,60000,1,1,2,27,2,2,0,0,0,2,19341,19625,20347,21669,23005,22499,900,1342,1664,2000,0,900,0,18441,18283,18683,19669,23005,21599,0.30735,0.3047166666666667,0.31138333333333335,0.32781666666666665,0.3834166666666667,0.3599833333333333,6
7352,280000,1,2,2,46,0,0,2,2,0,0,29523,154398,151984,47851,49374,50198,126000,3000,0,3000,2000,2000,0,-96477,151398,151984,44851,47374,48198,-0.3445607142857143,0.5407071428571428,0.5428,0.16018214285714286,0.16919285714285714,0.17213571428571428,4
7353,80000,1,2,1,45,3,2,2,0,0,0,34282,35006,34144,34820,35553,36258,1567,0,1243,1291,1297,1500,1,32715,35006,32901,33529,34256,34758,0.4089375,0.437575,0.4112625,0.4191125,0.4282,0.434475,7
7354,210000,1,2,1,34,0,0,0,0,0,0,14724,16465,17694,18892,20566,23226,2000,1500,1500,2000,3000,2000,1,12724,14965,16194,16892,17566,21226,0.06059047619047619,0.07126190476190476,0.07711428571428572,0.08043809523809524,0.08364761904761905,0.10107619047619047,0
7355,70000,1,2,2,23,0,0,0,0,0,0,22658,31647,24487,25125,26651,26125,9397,1487,1039,2073,1045,1231,0,13261,30160,23448,23052,25606,24894,0.18944285714285714,0.4308571428571429,0.3349714285714286,0.3293142857142857,0.3658,0.3556285714285714,0
7356,120000,0,2,1,37,2,2,0,0,0,0,45902,44868,45943,46976,47891,51036,0,2100,2100,2000,4100,3000,1,45902,42768,43843,44976,43791,48036,0.38251666666666667,0.3564,0.36535833333333334,0.3748,0.364925,0.4003,4
7357,80000,0,1,2,38,0,0,0,0,0,0,32562,23346,18361,10434,7387,3300,1482,1011,8,111,3509,0,0,31080,22335,18353,10323,3878,3300,0.3885,0.2791875,0.2294125,0.1290375,0.048475,0.04125,0
7358,320000,1,2,2,30,0,0,0,0,0,0,71305,71151,72029,72849,74374,74610,2589,2568,2570,2661,2781,2500,0,68716,68583,69459,70188,71593,72110,0.2147375,0.214321875,0.217059375,0.2193375,0.223728125,0.22534375,0
7359,200000,1,4,2,48,0,0,-2,-2,-2,-2,198540,0,0,0,0,0,0,0,0,0,0,0,0,198540,0,0,0,0,0,0.9927,0.0,0.0,0.0,0.0,0.0,-8
7360,150000,0,2,2,34,0,0,0,0,0,0,135587,138473,141297,144605,148420,150500,4000,4000,4500,5000,3500,0,0,131587,134473,136797,139605,144920,150500,0.8772466666666666,0.8964866666666667,0.91198,0.9307,0.9661333333333333,1.0033333333333334,0
7361,300000,0,2,2,27,-1,-1,-1,-1,0,-1,1386,25051,9505,91527,80780,2694,25125,9565,91559,252,2694,1000,0,-23739,15486,-82054,91275,78086,1694,-0.07913,0.05162,-0.27351333333333333,0.30425,0.26028666666666667,0.005646666666666667,-5
7362,170000,1,3,1,23,0,0,0,0,0,0,28615,26410,27654,25211,22682,21787,1446,1690,1208,462,1787,497,1,27169,24720,26446,24749,20895,21290,0.15981764705882354,0.14541176470588235,0.15556470588235294,0.14558235294117647,0.12291176470588236,0.12523529411764706,0
7363,70000,1,1,2,25,0,0,0,0,0,0,31680,28410,24046,19194,16621,10797,2000,2000,2000,3000,2500,900,0,29680,26410,22046,16194,14121,9897,0.424,0.3772857142857143,0.31494285714285714,0.23134285714285716,0.20172857142857142,0.14138571428571428,0
7364,20000,0,2,1,51,0,0,0,0,0,0,18673,17572,18584,19097,19328,37576,1297,1309,822,682,0,1558,1,17376,16263,17762,18415,19328,36018,0.8688,0.81315,0.8881,0.92075,0.9664,1.8009,0
7365,500000,0,2,1,31,0,0,0,0,0,-2,12988,7289,3823,4444,-232,-2701,1122,1077,3023,54,13,168816,1,11866,6212,800,4390,-245,-171517,0.023732,0.012424,0.0016,0.00878,-0.00049,-0.343034,-2
7366,200000,1,1,2,24,-2,-2,-2,-2,-2,-2,675,1053,0,500,2057,23322,1053,0,500,2057,23322,4299,0,-378,1053,-500,-1557,-21265,19023,-0.00189,0.005265,-0.0025,-0.007785,-0.106325,0.095115,-12
7367,50000,1,3,1,44,0,0,0,0,0,0,47569,48768,49234,21067,15007,31043,1986,1452,1200,300,27000,1412,1,45583,47316,48034,20767,-11993,29631,0.91166,0.94632,0.96068,0.41534,-0.23986,0.59262,0
7368,500000,0,1,2,39,-1,-1,-1,-1,-1,0,22204,83528,-24702,23804,92715,6655,83643,472,113935,108041,33,3984,0,-61439,83056,-138637,-84237,92682,2671,-0.122878,0.166112,-0.277274,-0.168474,0.185364,0.005342,-5
7369,230000,1,2,2,28,1,-2,-1,2,-1,-1,0,0,233,233,20,0,0,233,0,20,0,0,0,0,-233,233,213,20,0,0.0,-0.0010130434782608696,0.0010130434782608696,0.0009260869565217391,8.695652173913044e-05,0.0,-2
7370,240000,0,1,1,39,-1,-1,-1,-1,-1,-1,14719,3192,4389,10179,5413,1899,3192,4397,10179,5413,1899,21986,1,11527,-1205,-5790,4766,3514,-20087,0.048029166666666664,-0.005020833333333334,-0.024125,0.019858333333333332,0.014641666666666667,-0.08369583333333333,-6
7371,60000,0,3,1,50,-2,-2,-2,-1,-1,-2,1400,373,1299,1170,600,510,373,1299,1172,600,510,600,1,1027,-926,127,570,90,-90,0.017116666666666665,-0.015433333333333334,0.002116666666666667,0.0095,0.0015,-0.0015,-10
7372,360000,0,2,1,37,-2,-1,-1,0,0,-2,-5,3584,2280,2280,0,0,3589,2280,0,0,0,0,1,-3594,1304,2280,2280,0,0,-0.009983333333333334,0.0036222222222222224,0.006333333333333333,0.006333333333333333,0.0,0.0,-6
7373,50000,1,1,2,27,0,0,0,0,-2,-2,45190,45277,44941,0,0,0,5277,4941,0,0,0,0,0,39913,40336,44941,0,0,0,0.79826,0.80672,0.89882,0.0,0.0,0.0,-4
7374,150000,1,1,2,29,1,-2,-2,-2,-2,-2,0,0,0,0,0,0,0,0,0,0,0,0,0,0,0,0,0,0,0,0.0,0.0,0.0,0.0,0.0,0.0,-9
7375,500000,1,2,1,40,0,0,0,0,0,0,215508,214460,220047,217920,159393,149626,10004,10025,10294,6046,5076,5000,1,205504,204435,209753,211874,154317,144626,0.411008,0.40887,0.419506,0.423748,0.308634,0.289252,0
7376,30000,1,2,2,27,0,0,0,0,0,-2,11228,11814,5240,400,0,0,1104,1400,0,0,0,0,0,10124,10414,5240,400,0,0,0.3374666666666667,0.34713333333333335,0.17466666666666666,0.013333333333333334,0.0,0.0,-2
7377,440000,1,2,1,42,1,-2,-2,-2,-2,-2,22597,7288,5683,-20,-20,9881,7324,5683,20,0,9901,121971,1,15273,1605,5663,-20,-9921,-112090,0.03471136363636364,0.0036477272727272725,0.012870454545454546,-4.545454545454545e-05,-0.02254772727272727,-0.25475,-9
7378,80000,0,2,1,28,-1,-1,-1,-1,-1,-1,390,390,390,540,540,540,390,390,540,540,540,390,1,0,0,-150,0,0,150,0.0,0.0,-0.001875,0.0,0.0,0.001875,-6
7379,170000,1,2,1,50,0,0,0,0,0,0,177956,176155,171665,65479,61234,42484,7262,5586,2272,2998,39321,1390,1,170694,170569,169393,62481,21913,41094,1.0040823529411764,1.0033470588235294,0.9964294117647059,0.36753529411764707,0.1289,0.2417294117647059,0
7380,30000,1,2,2,22,0,0,0,0,0,0,28452,26145,26712,25350,17603,-780,2000,1400,0,500,0,1560,0,26452,24745,26712,24850,17603,-2340,0.8817333333333334,0.8248333333333333,0.8904,0.8283333333333334,0.5867666666666667,-0.078,0
7381,280000,1,1,2,29,-1,-1,-1,-1,-1,-1,2187,1461,53603,976,20825,1159,1469,53871,981,20929,1164,0,0,718,-52410,52622,-19953,19661,1159,0.0025642857142857143,-0.18717857142857142,0.1879357142857143,-0.07126071428571429,0.07021785714285714,0.004139285714285714,-6
7382,70000,0,1,2,30,0,0,0,2,0,0,2329,55664,59529,57571,57871,60872,55000,5800,0,2250,4500,0,0,-52671,49864,59529,55321,53371,60872,-0.7524428571428572,0.7123428571428572,0.8504142857142857,0.7903,0.7624428571428571,0.8696,2
7383,180000,1,2,2,27,0,0,0,0,0,0,28978,25271,19917,22659,16114,15587,5029,12000,12659,10000,9000,9000,0,23949,13271,7258,12659,7114,6587,0.13305,0.07372777777777778,0.040322222222222225,0.07032777777777778,0.03952222222222222,0.03659444444444444,0
7384,150000,1,1,2,28,1,-2,-2,-2,-2,-2,0,0,0,0,0,0,0,0,0,0,0,0,0,0,0,0,0,0,0,0.0,0.0,0.0,0.0,0.0,0.0,-9
7385,70000,0,2,2,26,2,2,2,2,0,0,46599,45578,48505,47427,48447,45145,0,4000,0,2000,1700,3000,0,46599,41578,48505,45427,46747,42145,0.6657,0.5939714285714286,0.6929285714285714,0.6489571428571429,0.6678142857142857,0.6020714285714286,8
7386,50000,0,3,1,47,0,0,2,0,0,0,13244,14722,15181,15928,16671,17393,2000,1000,1000,1000,1000,1000,1,11244,13722,14181,14928,15671,16393,0.22488,0.27444,0.28362,0.29856,0.31342,0.32786,2
7387,200000,0,1,2,24,-1,-1,-1,-1,0,0,9167,200,198,18154,13677,2018,200,198,18156,0,1150,0,0,8967,2,-17958,18154,12527,2018,0.044835,1e-05,-0.08979,0.09077,0.062635,0.01009,-4
7388,50000,1,2,1,31,1,3,2,0,0,0,50701,49147,21163,19894,19758,19324,0,507,1300,1000,700,771,1,50701,48640,19863,18894,19058,18553,1.01402,0.9728,0.39726,0.37788,0.38116,0.37106,6
7389,100000,1,2,1,42,-1,0,0,0,0,0,976,5476,10303,11007,11254,5934,4500,5000,1000,5200,1052,4000,1,-3524,476,9303,5807,10202,1934,-0.03524,0.00476,0.09303,0.05807,0.10202,0.01934,-1
7390,140000,0,2,1,37,0,-1,0,0,0,0,34661,5309,51293,56740,59455,57532,5334,50006,9460,9461,2507,10007,1,29327,-44697,41833,47279,56948,47525,0.20947857142857143,-0.3192642857142857,0.2988071428571429,0.3377071428571429,0.40677142857142856,0.3394642857142857,-1
7391,50000,1,1,2,31,2,2,3,2,0,0,48903,53997,52298,50778,48055,45704,6500,0,0,3130,2532,1700,0,42403,53997,52298,47648,45523,44004,0.84806,1.07994,1.04596,0.95296,0.91046,0.88008,9
7392,200000,1,2,2,24,0,0,0,0,0,-2,19326,20330,21362,22000,2000,950,1330,1362,1000,2000,950,0,0,17996,18968,20362,20000,1050,950,0.08998,0.09484,0.10181,0.1,0.00525,0.00475,-2
7393,340000,1,1,1,34,0,0,0,0,0,0,76786,57803,68670,20299,27816,43637,39749,15000,12000,10000,20000,5400,1,37037,42803,56670,10299,7816,38237,0.10893235294117647,0.12589117647058823,0.1666764705882353,0.030291176470588235,0.022988235294117646,0.11246176470588236,0
7394,180000,0,4,2,29,1,-2,-2,-2,-2,-1,92245,64364,5527,1600,2600,390,11400,1000,340,1000,390,390,0,80845,63364,5187,600,2210,0,0.44913888888888887,0.35202222222222224,0.028816666666666668,0.0033333333333333335,0.012277777777777778,0.0,-8
7395,180000,0,3,1,39,0,0,0,0,0,0,24068,25071,26103,27113,27495,27914,1706,1738,1748,1130,1011,1016,1,22362,23333,24355,25983,26484,26898,0.12423333333333333,0.1296277777777778,0.13530555555555557,0.14435,0.14713333333333334,0.14943333333333333,0
7396,50000,1,1,2,29,-1,-1,-2,-1,-1,-1,2463,0,0,536,326,652,0,0,536,326,652,0,0,2463,0,-536,210,-326,652,0.04926,0.0,-0.01072,0.0042,-0.00652,0.01304,-7
7397,280000,0,2,1,36,1,2,2,2,0,0,168708,172528,174328,170028,174281,185348,8000,6100,0,7000,14000,7000,1,160708,166428,174328,163028,160281,178348,0.5739571428571428,0.5943857142857143,0.6226,0.5822428571428572,0.5724321428571428,0.6369571428571429,7
7398,140000,0,1,1,43,-1,-1,-1,-1,-1,-1,1453,1872,1249,1872,1453,1453,1872,1249,1872,1453,1453,1034,1,-419,623,-623,419,0,419,-0.002992857142857143,0.00445,-0.00445,0.002992857142857143,0.0,0.002992857142857143,-6
7399,50000,1,1,2,32,1,2,2,2,0,0,20091,20175,22718,22057,23044,24990,700,3200,0,1500,2340,924,0,19391,16975,22718,20557,20704,24066,0.38782,0.3395,0.45436,0.41114,0.41408,0.48132,7
7400,150000,0,2,1,35,2,2,2,2,2,2,144194,145889,146189,146838,148754,150746,6600,5300,5600,5500,5700,5500,1,137594,140589,140589,141338,143054,145246,0.9172933333333333,0.93726,0.93726,0.9422533333333334,0.9536933333333333,0.9683066666666666,12
7401,40000,1,3,2,23,2,2,2,0,0,0,34415,35170,34305,34985,35719,36428,1600,0,1250,1296,1302,1348,0,32815,35170,33055,33689,34417,35080,0.820375,0.87925,0.826375,0.842225,0.860425,0.877,6
7402,150000,1,1,1,30,0,0,0,0,0,0,40046,47317,48849,35920,37433,10791,7995,5849,1196,2000,1000,1000,1,32051,41468,47653,33920,36433,9791,0.21367333333333333,0.27645333333333333,0.3176866666666667,0.22613333333333333,0.24288666666666667,0.06527333333333334,0
7403,120000,0,1,2,27,0,0,0,0,0,0,21812,20874,21930,22165,20502,19030,1700,1700,1500,700,1000,1000,0,20112,19174,20430,21465,19502,18030,0.1676,0.15978333333333333,0.17025,0.178875,0.16251666666666667,0.15025,0
7404,350000,1,2,1,31,0,0,0,0,0,0,67648,68557,63179,57987,53948,39965,3039,2047,1750,1703,1721,784,1,64609,66510,61429,56284,52227,39181,0.18459714285714285,0.19002857142857144,0.17551142857142857,0.16081142857142858,0.14922,0.11194571428571429,0
7405,90000,1,2,1,35,0,0,0,0,0,0,21093,14418,17217,16486,17390,19021,1256,3445,1099,1393,3045,1003,1,19837,10973,16118,15093,14345,18018,0.2204111111111111,0.12192222222222222,0.17908888888888888,0.1677,0.15938888888888889,0.2002,0
7406,160000,1,1,2,35,-1,-1,-1,-1,-1,-2,3027,1116,2179,5468,80,1314,1116,2183,5468,80,1314,0,0,1911,-1067,-3289,5388,-1234,1314,0.01194375,-0.00666875,-0.02055625,0.033675,-0.0077125,0.0082125,-7
7407,270000,1,2,1,32,-2,-2,-1,0,0,-2,3979,511,10069,9214,199,0,511,10069,186,199,0,0,1,3468,-9558,9883,9015,199,0,0.012844444444444445,-0.0354,0.0366037037037037,0.03338888888888889,0.000737037037037037,0.0,-7
7408,70000,1,2,2,22,0,-1,0,0,0,0,9232,68209,66087,50716,48862,49850,68209,2081,2000,2000,1828,1518,0,-58977,66128,64087,48716,47034,48332,-0.8425285714285714,0.9446857142857142,0.9155285714285715,0.6959428571428572,0.6719142857142857,0.6904571428571429,-1
7409,30000,1,2,2,22,1,-1,0,0,0,0,-802,19786,20517,13167,10686,10074,21286,1154,413,372,500,1225,0,-22088,18632,20104,12795,10186,8849,-0.7362666666666666,0.6210666666666667,0.6701333333333334,0.4265,0.33953333333333335,0.29496666666666665,0
7410,170000,1,1,2,27,-1,0,0,0,0,0,41977,38895,39698,38330,39602,39922,1650,4500,4000,4000,3000,3000,0,40327,34395,35698,34330,36602,36922,0.23721764705882353,0.2023235294117647,0.20998823529411764,0.20194117647058824,0.21530588235294118,0.21718823529411765,-1
7411,50000,1,3,1,49,0,0,-2,-2,-2,-2,36325,0,0,0,0,0,0,0,0,0,0,0,1,36325,0,0,0,0,0,0.7265,0.0,0.0,0.0,0.0,0.0,-8
7412,290000,1,1,2,26,-1,0,0,-1,0,0,55758,7970,7106,8901,16813,15723,5029,5035,8925,11030,5077,3425,0,50729,2935,-1819,-2129,11736,12298,0.17492758620689655,0.010120689655172413,-0.0062724137931034485,-0.007341379310344827,0.04046896551724138,0.04240689655172414,-2
7413,130000,1,2,1,38,0,0,0,0,0,0,127626,128136,88423,90235,92154,85510,5400,3100,3100,3200,3000,3100,1,122226,125036,85323,87035,89154,82410,0.9402,0.9618153846153846,0.6563307692307693,0.6695,0.6858,0.6339230769230769,0
7414,50000,1,2,3,46,0,0,0,0,0,0,44076,44406,45320,38446,36748,36827,1810,2500,2000,2000,1465,2000,0,42266,41906,43320,36446,35283,34827,0.84532,0.83812,0.8664,0.72892,0.70566,0.69654,0
7415,50000,1,2,1,44,0,0,2,0,0,0,43596,46320,43976,44287,38113,30778,5000,0,2500,1500,2000,1000,1,38596,46320,41476,42787,36113,29778,0.77192,0.9264,0.82952,0.85574,0.72226,0.59556,2
7416,50000,1,3,2,22,0,0,0,0,0,0,50089,41382,36995,17726,13623,13781,1798,1117,4749,500,508,250,0,48291,40265,32246,17226,13115,13531,0.96582,0.8053,0.64492,0.34452,0.2623,0.27062,0
7417,130000,1,1,2,27,-2,-2,-2,-2,-2,-2,8508,27049,0,0,0,0,27049,0,0,0,0,0,0,-18541,27049,0,0,0,0,-0.14262307692307694,0.20806923076923076,0.0,0.0,0.0,0.0,-12
7418,70000,1,2,2,24,0,0,0,0,0,0,27431,27163,18987,20170,15900,0,5006,1400,2013,370,0,0,0,22425,25763,16974,19800,15900,0,0.32035714285714284,0.3680428571428571,0.24248571428571428,0.28285714285714286,0.22714285714285715,0.0,0
7419,230000,1,1,2,26,-1,0,-1,-1,-1,-1,17532,13033,2688,2688,2688,6393,10000,2688,2688,2688,6393,6504,0,7532,10345,0,0,-3705,-111,0.03274782608695652,0.04497826086956522,0.0,0.0,-0.01610869565217391,-0.0004826086956521739,-5
7420,240000,0,1,1,65,0,0,0,0,0,0,146696,149707,151780,152373,145763,148276,6930,6000,6000,6000,5500,6000,1,139766,143707,145780,146373,140263,142276,0.5823583333333333,0.5987791666666666,0.6074166666666667,0.6098875,0.5844291666666667,0.5928166666666667,0
7421,70000,1,3,1,53,2,2,2,2,2,2,54251,55402,53925,56814,58053,59246,2600,0,4400,2300,2300,2100,1,51651,55402,49525,54514,55753,57146,0.7378714285714286,0.7914571428571429,0.7075,0.7787714285714286,0.7964714285714286,0.8163714285714285,12
7422,360000,0,1,1,43,0,-1,-1,-1,0,0,30769,13532,840,68110,55905,42239,13952,864,124037,1679,1163,1126,1,16817,12668,-123197,66431,54742,41113,0.04671388888888889,0.03518888888888889,-0.3422138888888889,0.18453055555555556,0.15206111111111112,0.11420277777777778,-3
7423,230000,0,2,2,30,0,0,0,0,0,0,115141,101832,92396,84297,49681,46224,5028,5000,4000,2029,2000,2500,0,110113,96832,88396,82268,47681,43724,0.4787521739130435,0.4210086956521739,0.3843304347826087,0.35768695652173915,0.2073086956521739,0.19010434782608696,0
7424,30000,1,1,2,25,0,0,0,0,0,0,27396,27994,28631,28935,28954,29155,1753,1786,1486,1170,1200,1205,0,25643,26208,27145,27765,27754,27950,0.8547666666666667,0.8736,0.9048333333333334,0.9255,0.9251333333333334,0.9316666666666666,0
7425,140000,1,1,2,37,1,-2,-2,-2,-2,-2,-18,-18,-18,-18,-18,-18,0,0,0,0,0,0,0,-18,-18,-18,-18,-18,-18,-0.00012857142857142858,-0.00012857142857142858,-0.00012857142857142858,-0.00012857142857142858,-0.00012857142857142858,-0.00012857142857142858,-9
7426,180000,1,1,1,40,0,-1,0,0,0,0,34483,21142,11279,5698,5993,-73895,22864,1133,1000,1000,0,159000,1,11619,20009,10279,4698,5993,-232895,0.06455,0.11116111111111111,0.057105555555555555,0.0261,0.033294444444444446,-1.2938611111111111,-1
7427,400000,0,3,1,33,0,0,2,0,0,0,2487,4708,2192,11111,5675,5071,4009,6,10248,4721,4114,1855,1,-1522,4702,-8056,6390,1561,3216,-0.003805,0.011755,-0.02014,0.015975,0.0039025,0.00804,2
7428,90000,1,2,2,35,2,2,2,2,2,2,89282,91247,68552,67324,39573,28610,6201,0,25000,0,2235,0,0,83081,91247,43552,67324,37338,28610,0.9231222222222222,1.0138555555555555,0.4839111111111111,0.7480444444444444,0.41486666666666666,0.3178888888888889,12
7429,200000,1,3,1,46,-1,-1,-1,-1,-1,-1,14617,1261,8187,1261,1261,1261,1261,8187,1261,1261,1261,1261,1,13356,-6926,6926,0,0,0,0.06678,-0.03463,0.03463,0.0,0.0,0.0,-6
7430,360000,0,2,2,28,0,0,-1,0,0,0,19390,22726,12148,12885,12994,15320,7113,12163,3787,714,5369,10026,0,12277,10563,8361,12171,7625,5294,0.03410277777777778,0.029341666666666665,0.023225,0.033808333333333336,0.021180555555555557,0.014705555555555555,-1
7431,290000,0,3,1,41,-1,-1,-1,-1,0,0,7488,5795,9562,21312,16875,13881,5807,9569,21336,5020,3013,12278,1,1681,-3774,-11774,16292,13862,1603,0.005796551724137931,-0.013013793103448275,-0.0406,0.056179310344827586,0.0478,0.005527586206896552,-4
7432,200000,1,1,2,47,-1,0,-1,-1,-1,-1,8172,20004,7737,8586,4291,52605,20003,9189,8586,4291,52605,21,0,-11831,10815,-849,4295,-48314,52584,-0.059155,0.054075,-0.004245,0.021475,-0.24157,0.26292,-5
7433,110000,1,2,1,42,2,2,2,2,2,0,28383,27653,29003,29447,27701,28285,0,2000,1000,0,1000,1000,1,28383,25653,28003,29447,26701,27285,0.2580272727272727,0.23320909090909092,0.2545727272727273,0.2677,0.24273636363636364,0.24804545454545454,10
7434,480000,1,3,1,36,-1,0,0,-1,-1,-1,19311,13368,7000,7331,7000,7000,1368,1000,7331,7000,7000,7000,1,17943,12368,-331,331,0,0,0.03738125,0.025766666666666667,-0.0006895833333333333,0.0006895833333333333,0.0,0.0,-4
7435,280000,0,1,2,32,0,0,0,0,0,-1,32068,31915,34433,31236,0,500,5000,5000,5000,0,500,4800,0,27068,26915,29433,31236,-500,-4300,0.09667142857142857,0.096125,0.10511785714285714,0.11155714285714285,-0.0017857142857142857,-0.015357142857142857,-1
7436,140000,1,1,2,25,0,0,0,0,0,0,23409,24725,26006,26771,28179,29746,2000,2000,1500,2000,2200,2000,0,21409,22725,24506,24771,25979,27746,0.15292142857142857,0.16232142857142856,0.17504285714285714,0.17693571428571428,0.1855642857142857,0.1981857142857143,0
7437,300000,1,1,1,36,-1,-1,-2,-2,-2,-2,8385,-27,-27,-27,-27,-27,27,0,0,0,0,0,1,8358,-27,-27,-27,-27,-27,0.02786,-9e-05,-9e-05,-9e-05,-9e-05,-9e-05,-10
7438,160000,0,2,1,35,2,2,2,0,0,0,155327,159293,154957,157788,160282,100213,8000,0,7300,7000,4400,1200,1,147327,159293,147657,150788,155882,99013,0.92079375,0.99558125,0.92285625,0.942425,0.9742625,0.61883125,6
7439,50000,1,1,2,39,0,0,0,0,0,0,47381,48697,48322,45353,19426,19857,2116,2320,1300,1000,700,600,0,45265,46377,47022,44353,18726,19257,0.9053,0.92754,0.94044,0.88706,0.37452,0.38514,0
7440,150000,1,3,2,35,1,-1,-1,-1,-1,-2,0,200,708,1201,0,0,200,708,1201,0,0,0,0,-200,-508,-493,1201,0,0,-0.0013333333333333333,-0.0033866666666666667,-0.0032866666666666665,0.008006666666666667,0.0,0.0,-5
7441,90000,1,1,2,33,0,0,0,0,0,0,55937,57107,59753,61755,63629,54423,2100,4000,3000,3000,2323,2000,0,53837,53107,56753,58755,61306,52423,0.5981888888888889,0.5900777777777778,0.6305888888888889,0.6528333333333334,0.6811777777777778,0.5824777777777778,0
7442,30000,1,3,1,42,1,2,0,0,0,0,30607,29849,30653,28410,29068,30383,10,2000,2000,2000,2000,3000,1,30597,27849,28653,26410,27068,27383,1.0199,0.9283,0.9551,0.8803333333333333,0.9022666666666667,0.9127666666666666,3
7443,60000,0,2,2,24,0,0,0,0,0,2,60753,54892,59268,17967,20309,17867,2800,6100,621,2609,0,756,0,57953,48792,58647,15358,20309,17111,0.9658833333333333,0.8132,0.97745,0.2559666666666667,0.33848333333333336,0.28518333333333334,2
7444,20000,0,2,1,29,0,0,0,0,0,0,14275,15335,16223,15594,15920,15338,1297,1185,492,510,557,324,1,12978,14150,15731,15084,15363,15014,0.6489,0.7075,0.78655,0.7542,0.76815,0.7507,0
7445,100000,1,3,1,50,0,0,0,0,0,2,36925,38324,39680,41687,43607,43739,2000,2000,2680,2600,1000,5261,1,34925,36324,37000,39087,42607,38478,0.34925,0.36324,0.37,0.39087,0.42607,0.38478,2
7446,460000,0,1,2,31,0,0,2,0,0,0,4533,9023,8317,12338,12744,12397,5002,1,5002,1001,3,733,0,-469,9022,3315,11337,12741,11664,-0.0010195652173913044,0.01961304347826087,0.007206521739130434,0.024645652173913044,0.02769782608695652,0.025356521739130434,2
7447,150000,1,1,1,36,-1,-1,-1,-1,-1,-1,13447,17877,25172,4694,6292,13943,17914,25349,4694,6324,14433,17378,1,-4467,-7472,20478,-1630,-8141,-3435,-0.02978,-0.049813333333333334,0.13652,-0.010866666666666667,-0.05427333333333333,-0.0229,-6
7448,50000,1,2,1,29,0,0,0,0,0,0,20103,21466,23122,24654,26365,25844,2000,2000,2000,2000,2000,2000,1,18103,19466,21122,22654,24365,23844,0.36206,0.38932,0.42244,0.45308,0.4873,0.47688,0
7449,290000,0,2,1,49,-2,-2,-2,-2,-2,-2,4040,5438,3116,13459,2685,2532,5457,3131,13526,2698,2544,1988,1,-1417,2307,-10410,10761,141,544,-0.004886206896551724,0.007955172413793104,-0.03589655172413793,0.03710689655172414,0.0004862068965517241,0.0018758620689655172,-12
7450,200000,1,1,1,34,-1,-1,-1,-1,0,0,3987,1631,21698,12657,11349,9006,1631,21698,12657,569,3000,25000,1,2356,-20067,9041,12088,8349,-15994,0.01178,-0.100335,0.045205,0.06044,0.041745,-0.07997,-4
7451,50000,0,1,2,33,-1,2,2,2,0,0,36363,35483,48256,47098,46898,150,0,13500,0,0,0,0,0,36363,21983,48256,47098,46898,150,0.72726,0.43966,0.96512,0.94196,0.93796,0.003,5
7452,380000,1,2,1,30,2,0,0,0,0,0,225995,231382,224420,136324,137929,114249,10382,8420,46777,4929,4249,5528,1,215613,222962,177643,131395,133680,108721,0.5674026315789473,0.5867421052631578,0.4674815789473684,0.3457763157894737,0.35178947368421054,0.2861078947368421,2
7453,330000,1,1,1,37,-1,-1,-1,-1,0,-1,4785,3403,0,5882,5882,1013,3523,0,5882,0,1013,0,1,1262,3403,-5882,5882,4869,1013,0.0038242424242424244,0.010312121212121212,-0.017824242424242423,0.017824242424242423,0.014754545454545454,0.0030696969696969697,-5
7454,300000,1,3,1,32,-2,-2,-2,-2,-2,-2,0,0,0,0,0,0,0,0,0,0,0,0,1,0,0,0,0,0,0,0.0,0.0,0.0,0.0,0.0,0.0,-12
7455,170000,0,1,2,26,0,0,0,0,0,0,118084,112312,107396,96064,96984,93711,3800,13000,3593,3020,3090,2916,0,114284,99312,103803,93044,93894,90795,0.6722588235294118,0.5841882352941177,0.6106058823529412,0.5473176470588236,0.5523176470588236,0.5340882352941176,0
7456,20000,0,2,2,24,2,3,2,2,3,2,21034,19839,18663,20394,19228,19615,0,0,2616,0,1400,0,0,21034,19839,16047,20394,17828,19615,1.0517,0.99195,0.80235,1.0197,0.8914,0.98075,14
7457,280000,1,1,2,26,0,0,0,0,0,0,146130,120750,105492,104061,105202,107143,5042,4000,4000,4000,4368,4000,0,141088,116750,101492,100061,100834,103143,0.5038857142857143,0.41696428571428573,0.36247142857142856,0.3573607142857143,0.3601214285714286,0.36836785714285714,0
7458,250000,1,2,1,39,-1,-1,-1,-1,-1,-1,9690,0,1222,7337,0,2752,0,1222,7409,0,2752,1549,1,9690,-1222,-6187,7337,-2752,1203,0.03876,-0.004888,-0.024748,0.029348,-0.011008,0.004812,-6
7459,230000,1,3,1,41,-2,-2,-2,-2,-2,-2,34578,495,502,944,5814,965,495,502,950,5820,965,1028,1,34083,-7,-448,-4876,4849,-63,0.14818695652173913,-3.0434782608695653e-05,-0.0019478260869565218,-0.0212,0.021082608695652174,-0.00027391304347826085,-12
7460,20000,1,3,1,49,1,2,3,2,0,0,18769,21349,20732,19946,19546,19546,3186,0,0,0,0,0,1,15583,21349,20732,19946,19546,19546,0.77915,1.06745,1.0366,0.9973,0.9773,0.9773,8
7461,90000,1,2,2,24,1,2,0,0,0,0,88550,78892,75808,63362,65300,67248,3000,3500,3000,3000,3000,5000,0,85550,75392,72808,60362,62300,62248,0.9505555555555556,0.8376888888888889,0.8089777777777778,0.6706888888888889,0.6922222222222222,0.6916444444444444,3
7462,60000,1,1,2,25,0,0,0,0,0,0,31493,32634,30312,22999,23484,24438,2000,2000,1000,1005,1500,2000,0,29493,30634,29312,21994,21984,22438,0.49155,0.5105666666666666,0.4885333333333333,0.36656666666666665,0.3664,0.37396666666666667,0
7463,120000,0,3,2,44,4,3,2,0,0,0,149229,138487,127516,124530,120937,67711,0,0,6000,5067,1548,120862,0,149229,138487,121516,119463,119389,-53151,1.243575,1.1540583333333334,1.0126333333333333,0.995525,0.9949083333333333,-0.442925,9
7464,220000,1,2,1,35,0,0,0,0,0,0,41259,37465,39494,16842,0,8419,2000,3000,1160,1000,0,1000,1,39259,34465,38334,15842,0,7419,0.17845,0.15665909090909091,0.17424545454545454,0.07200909090909091,0.0,0.03372272727272727,0
7465,200000,0,2,2,36,0,0,0,0,0,0,175353,150969,153856,156401,159300,160571,25001,5701,5576,6009,5811,6156,0,150352,145268,148280,150392,153489,154415,0.75176,0.72634,0.7414,0.75196,0.767445,0.772075,0
7466,330000,1,2,2,29,0,0,0,0,-1,-1,49549,133957,128212,79407,8875,49880,90000,3000,5000,8875,49880,519,0,-40451,130957,123212,70532,-41005,49361,-0.12257878787878788,0.39683939393939394,0.37336969696969696,0.21373333333333333,-0.12425757575757576,0.14957878787878787,-2
7467,250000,0,1,1,40,-1,-1,-1,-1,-1,-1,396,396,396,396,396,109,396,396,396,396,109,0,1,0,0,0,0,287,109,0.0,0.0,0.0,0.0,0.001148,0.000436,-6
7468,210000,1,2,2,53,-1,-1,-1,-1,-1,-1,390,390,390,390,390,390,390,390,390,390,390,390,0,0,0,0,0,0,0,0.0,0.0,0.0,0.0,0.0,0.0,-6
7469,150000,0,4,2,29,0,0,0,0,0,0,200442,206334,206221,69995,60000,0,8500,8000,2500,1500,0,0,0,191942,198334,203721,68495,60000,0,1.2796133333333333,1.3222266666666667,1.35814,0.45663333333333334,0.4,0.0,0
7470,50000,1,2,3,33,0,0,0,0,0,0,48111,47583,38897,20190,19633,19035,2100,1690,11700,1200,1200,1000,0,46011,45893,27197,18990,18433,18035,0.92022,0.91786,0.54394,0.3798,0.36866,0.3607,0
7471,50000,0,3,2,30,2,0,0,0,0,0,50110,50322,27078,19107,19506,20024,1500,1620,1000,707,841,657,0,48610,48702,26078,18400,18665,19367,0.9722,0.97404,0.52156,0.368,0.3733,0.38734,2
7472,130000,1,2,2,42,0,0,0,0,0,0,42946,43969,44975,45723,46515,47450,1676,1682,1430,1318,1331,1525,0,41270,42287,43545,44405,45184,45925,0.31746153846153846,0.3252846153846154,0.3349615384615385,0.34157692307692306,0.3475692307692308,0.3532692307692308,0
7473,50000,0,1,2,26,-1,0,0,0,0,0,15448,16392,18096,18425,18619,19060,1500,2000,1500,1200,900,1000,0,13948,14392,16596,17225,17719,18060,0.27896,0.28784,0.33192,0.3445,0.35438,0.3612,-1
7474,230000,1,1,1,46,-2,-2,-2,-2,-2,-2,266,0,0,0,0,300,0,0,0,0,300,0,1,266,0,0,0,-300,300,0.0011565217391304348,0.0,0.0,0.0,-0.0013043478260869566,0.0013043478260869566,-12
7475,300000,0,1,2,34,1,-2,-2,-2,-2,-2,0,0,0,0,0,0,0,0,0,0,0,0,0,0,0,0,0,0,0,0.0,0.0,0.0,0.0,0.0,0.0,-9
7476,180000,1,1,2,41,0,0,-1,0,-1,-1,37353,24797,5549,22349,2974,0,1012,5549,17000,3322,0,2633,0,36341,19248,-11451,19027,2974,-2633,0.20189444444444443,0.10693333333333334,-0.06361666666666667,0.10570555555555555,0.016522222222222223,-0.014627777777777778,-3
7477,80000,0,1,2,26,0,0,0,0,0,0,76436,75437,58309,59217,59955,57100,5990,2500,3000,2500,3000,1500,0,70446,72937,55309,56717,56955,55600,0.880575,0.9117125,0.6913625,0.7089625,0.7119375,0.695,0
7478,150000,0,2,1,36,2,2,0,0,0,0,88655,86333,88931,92441,102903,105240,0,4000,5000,12000,4000,6000,1,88655,82333,83931,80441,98903,99240,0.5910333333333333,0.5488866666666666,0.55954,0.5362733333333334,0.6593533333333333,0.6616,4
7479,450000,0,1,1,45,0,0,0,0,0,0,201015,177028,136434,126121,115050,105901,10000,6000,5087,5000,5000,5000,1,191015,171028,131347,121121,110050,100901,0.4244777777777778,0.38006222222222225,0.2918822222222222,0.2691577777777778,0.24455555555555555,0.22422444444444445,0
7480,210000,0,1,2,31,0,0,0,0,0,0,36042,37141,38179,39243,39740,40574,2000,1936,2000,1450,1472,3500,0,34042,35205,36179,37793,38268,37074,0.16210476190476192,0.16764285714285715,0.17228095238095237,0.17996666666666666,0.18222857142857143,0.17654285714285714,0
7481,30000,1,3,1,49,0,0,0,0,0,0,24885,25886,26901,27907,28469,29058,1215,1230,1236,798,822,1079,1,23670,24656,25665,27109,27647,27979,0.789,0.8218666666666666,0.8555,0.9036333333333333,0.9215666666666666,0.9326333333333333,0
7482,100000,1,1,2,28,-1,-1,-1,-1,-1,-1,557,1033,3667,2300,1132,2072,1033,3667,2300,1132,2072,2692,0,-476,-2634,1367,1168,-940,-620,-0.00476,-0.02634,0.01367,0.01168,-0.0094,-0.0062,-6
7483,360000,0,3,1,58,-1,-1,-1,-1,0,-1,1351,554,1090,780,390,388,554,1096,780,0,388,887,1,797,-542,310,780,2,-499,0.002213888888888889,-0.0015055555555555556,0.0008611111111111111,0.0021666666666666666,5.555555555555556e-06,-0.0013861111111111112,-5
7484,240000,1,2,2,25,-2,-2,-2,-2,-2,-2,0,0,0,0,0,0,0,0,0,0,0,0,0,0,0,0,0,0,0,0.0,0.0,0.0,0.0,0.0,0.0,-12
7485,200000,0,2,2,35,0,0,0,0,0,0,27784,33877,35420,26609,25392,23367,10000,10000,2000,5000,5000,1000,0,17784,23877,33420,21609,20392,22367,0.08892,0.119385,0.1671,0.108045,0.10196,0.111835,0
7486,330000,0,2,1,48,-1,-1,-1,-1,0,0,933,12663,10151,60841,41945,21183,12701,10183,62619,1945,1183,115647,1,-11768,2480,-52468,58896,40762,-94464,-0.03566060606060606,0.0075151515151515155,-0.15899393939393938,0.17847272727272728,0.12352121212121212,-0.28625454545454543,-4
7487,330000,1,3,1,40,0,0,0,0,0,0,81084,82838,84470,80923,82580,84330,3100,3026,3000,3000,3078,3238,1,77984,79812,81470,77923,79502,81092,0.2363151515151515,0.24185454545454546,0.2468787878787879,0.23613030303030302,0.24091515151515153,0.24573333333333333,0
7488,190000,1,2,2,31,-1,-1,-1,-1,-2,-1,771,0,4251,0,0,6732,0,4251,0,0,6732,11306,0,771,-4251,4251,0,-6732,-4574,0.004057894736842105,-0.022373684210526316,0.022373684210526316,0.0,-0.03543157894736842,-0.024073684210526317,-7
7489,380000,0,1,1,49,2,0,0,0,0,0,380933,380703,356474,308948,547880,309322,14651,12238,13479,13532,12015,11525,1,366282,368465,342995,295416,535865,297797,0.9639,0.9696447368421053,0.9026184210526316,0.7774105263157894,1.410171052631579,0.7836763157894737,2
7490,50000,1,2,2,26,2,0,0,0,0,0,47510,32952,22289,22752,9325,9270,1744,1537,1000,187,185,0,0,45766,31415,21289,22565,9140,9270,0.91532,0.6283,0.42578,0.4513,0.1828,0.1854,2
7491,640000,1,1,2,41,0,0,0,0,0,0,55645,56656,60185,59218,58963,58992,3000,5000,2300,2128,2125,2222,0,52645,51656,57885,57090,56838,56770,0.0822578125,0.0807125,0.0904453125,0.089203125,0.088809375,0.088703125,0
7492,80000,1,2,1,29,2,2,2,2,2,2,72674,74192,72464,76613,77908,76034,3300,0,6000,3100,0,4200,1,69374,74192,66464,73513,77908,71834,0.867175,0.9274,0.8308,0.9189125,0.97385,0.897925,12
7493,50000,0,2,1,33,0,0,0,0,0,0,21460,12570,13530,14876,14157,18888,1300,1200,5000,1000,5000,8000,1,20160,11370,8530,13876,9157,10888,0.4032,0.2274,0.1706,0.27752,0.18314,0.21776,0
7494,130000,1,2,1,46,0,0,0,-2,-2,-2,125557,124900,0,0,0,0,2498,0,0,0,0,0,1,123059,124900,0,0,0,0,0.9466076923076923,0.9607692307692308,0.0,0.0,0.0,0.0,-6
7495,310000,0,1,2,32,0,0,0,0,0,0,217464,217951,222465,142935,147857,150442,8500,9100,5200,7300,7000,3939,0,208964,208851,217265,135635,140857,146503,0.6740774193548387,0.6737129032258065,0.7008548387096775,0.4375322580645161,0.4543774193548387,0.47259032258064515,0
7496,90000,1,2,1,34,-2,-2,-2,-2,-2,-2,1905,1924,11855,665,0,665,1924,11855,10655,0,665,0,1,-19,-9931,1200,665,-665,665,-0.0002111111111111111,-0.11034444444444444,0.013333333333333334,0.007388888888888889,-0.007388888888888889,0.007388888888888889,-12
7497,180000,1,2,2,28,0,0,0,0,0,0,103203,108032,109741,112907,115924,118832,6500,5000,5000,5000,5000,5000,0,96703,103032,104741,107907,110924,113832,0.5372388888888889,0.5724,0.5818944444444445,0.5994833333333334,0.6162444444444445,0.6324,0
7498,360000,0,2,1,37,1,-2,-2,-2,-2,-2,0,0,0,0,0,0,0,0,0,0,0,0,1,0,0,0,0,0,0,0.0,0.0,0.0,0.0,0.0,0.0,-9
7499,50000,1,2,2,23,-1,0,0,2,0,0,9101,10446,12595,11449,9914,9875,1502,2651,500,500,500,500,0,7599,7795,12095,10949,9414,9375,0.15198,0.1559,0.2419,0.21898,0.18828,0.1875,1
7500,240000,1,2,1,47,1,-2,-2,-2,-2,-2,0,0,0,0,0,0,0,0,0,0,0,0,1,0,0,0,0,0,0,0.0,0.0,0.0,0.0,0.0,0.0,-9
